,blueGoldDiff,blueExperienceDiff,blueGoldPerMin,blueTotalGold,blueTotalExperience,blueAvgLevel,blueKills,redDeaths,blueAssists,blueTotalMinionsKilled,blueCSPerMin,blueEliteMonsters,blueDragons,blueFirstBlood,redFirstBlood,redDragons,redTotalMinionsKilled,redCSPerMin,redEliteMonsters,redAssists,blueDeaths,redKills,redAvgLevel,redTotalExperience,redTotalGold,redGoldPerMin,redExperienceDiff,redGoldDiff,blueWins
0,643,-8,1721.0,17210,17039,6.6,9,9,11,195,19.5,0,0,1,0,0,197,19.7,0,8,6,6,6.8,17047,16567,1656.7,8,-643,0
1,-2908,-1173,1471.2,14712,16265,6.6,5,5,5,174,17.4,0,0,0,1,1,240,24.0,2,2,5,5,6.8,17438,17620,1762.0,1173,2908,0
2,-1172,-1033,1611.3,16113,16221,6.4,7,7,4,186,18.6,1,1,0,1,0,203,20.3,0,14,11,11,6.8,17254,17285,1728.5,1033,1172,0
3,-1321,-7,1515.7,15157,17954,7.0,4,4,5,201,20.1,1,0,0,1,0,235,23.5,0,10,5,5,7.0,17961,16478,1647.8,7,1321,0
4,-1004,230,1640.0,16400,18543,7.0,6,6,6,210,21.0,0,0,0,1,1,225,22.5,1,7,6,6,7.0,18313,17404,1740.4,-230,1004,0
5,698,101,1589.9,15899,18161,7.0,5,5,6,225,22.5,1,1,0,1,0,221,22.1,0,2,3,3,7.0,18060,15201,1520.1,-101,-698,1
6,2411,1563,1687.4,16874,16967,6.8,7,7,7,225,22.5,1,1,1,0,0,164,16.4,0,9,6,6,6.4,15404,14463,1446.3,-1563,-2411,1
7,-2615,-800,1530.5,15305,16138,6.4,5,5,3,209,20.9,0,0,0,1,1,157,15.7,1,11,13,13,6.6,16938,17920,1792.0,800,2615,0
8,-1979,-771,1640.1,16401,18527,7.2,7,7,8,189,18.9,0,0,0,1,1,240,24.0,2,5,7,7,7.2,19298,18380,1838.0,771,1979,0
9,-1548,-1574,1505.7,15057,16805,6.8,4,4,5,220,22.0,1,1,1,0,0,247,24.7,0,4,5,5,6.8,18379,16605,1660.5,1574,1548,1
10,331,-1585,1547.4,15474,16611,6.6,4,4,6,231,23.1,0,0,1,0,1,216,21.6,1,5,4,4,7.2,18196,15143,1514.3,1585,-331,0
11,-1505,-635,1669.5,16695,18507,7.0,11,11,7,157,15.7,1,0,1,0,0,188,18.8,0,9,11,11,7.0,19142,18200,1820.0,635,1505,0
12,3274,1659,1786.5,17865,19102,7.4,7,7,11,238,23.8,1,1,1,0,0,240,24.0,0,1,1,1,6.8,17443,14591,1459.1,-1659,-3274,1
13,-3414,-1141,1497.9,14979,17213,6.6,4,4,1,210,21.0,1,0,0,1,0,229,22.9,0,11,9,9,7.2,18354,18393,1839.3,1141,3414,0
14,-470,-187,1572.2,15722,17896,6.8,4,4,4,224,22.4,0,0,1,0,0,242,24.2,0,3,4,4,7.0,18083,16192,1619.2,187,470,1
15,-1996,-1804,1501.5,15015,16974,6.8,3,3,3,209,20.9,0,0,0,1,0,237,23.7,0,13,7,7,7.2,18778,17011,1701.1,1804,1996,0
16,5228,3378,1973.3,19733,20862,7.6,10,10,8,263,26.3,0,0,1,0,1,210,21.0,1,2,2,2,6.8,17484,14505,1450.5,-3378,-5228,1
17,-1975,-1345,1485.2,14852,16888,6.8,3,3,3,203,20.3,1,0,0,1,0,218,21.8,0,6,7,7,6.8,18233,16827,1682.7,1345,1975,0
18,882,512,1628.2,16282,17378,6.8,5,5,11,213,21.3,0,0,1,0,1,228,22.8,2,3,4,4,6.6,16866,15400,1540.0,-512,-882,1
19,-3155,-2773,1499.4,14994,17924,7.0,5,5,5,188,18.8,0,0,0,1,0,219,21.9,0,9,9,9,7.4,20697,18149,1814.9,2773,3155,0
20,2526,1625,1860.6,18606,19254,7.2,11,11,15,214,21.4,1,1,1,0,0,225,22.5,0,4,6,6,7.0,17629,16080,1608.0,-1625,-2526,1
21,-2835,-2821,1587.8,15878,16945,6.8,4,4,5,203,20.3,0,0,0,1,1,209,20.9,1,14,13,13,7.2,19766,18713,1871.3,2821,2835,0
22,-1254,-567,1577.3,15773,17562,7.0,4,4,3,238,23.8,0,0,0,1,1,231,23.1,1,10,6,6,7.0,18129,17027,1702.7,567,1254,0
23,406,1283,1590.6,15906,19219,6.8,4,4,4,238,23.8,2,1,0,1,0,220,22.0,0,3,3,3,7.0,17936,15500,1550.0,-1283,-406,0
24,-1020,493,1651.5,16515,17223,6.8,6,6,10,208,20.8,0,0,0,1,0,197,19.7,0,13,9,9,6.6,16730,17535,1753.5,-493,1020,1
25,-2472,-1067,1541.5,15415,16047,6.2,4,4,4,204,20.4,0,0,0,1,1,221,22.1,1,13,8,8,7.0,17114,17887,1788.7,1067,2472,0
26,1260,-55,1717.8,17178,17854,7.0,8,8,9,209,20.9,1,1,0,1,0,233,23.3,0,3,6,6,6.8,17909,15918,1591.8,55,-1260,1
27,1857,2015,1722.6,17226,18982,7.0,7,7,9,228,22.8,0,0,1,0,1,202,20.2,1,2,4,4,6.6,16967,15369,1536.9,-2015,-1857,0
28,1320,-413,1747.4,17474,17436,6.8,8,8,13,217,21.7,1,1,1,0,0,223,22.3,0,11,6,6,6.8,17849,16154,1615.4,413,-1320,0
29,-3282,-1647,1490.5,14905,17974,6.8,3,3,2,233,23.3,1,1,0,1,0,225,22.5,0,12,8,8,7.4,19621,18187,1818.7,1647,3282,0
30,2883,2111,1813.2,18132,18076,7.0,9,9,10,228,22.8,1,1,1,0,0,227,22.7,0,2,4,4,6.2,15965,15249,1524.9,-2111,-2883,1
31,1703,1696,1605.3,16053,17406,6.8,5,5,6,218,21.8,2,1,1,0,0,206,20.6,0,2,2,2,6.4,15710,14350,1435.0,-1696,-1703,1
32,608,-85,1643.8,16438,16989,6.8,6,6,7,203,20.3,0,0,0,1,1,206,20.6,1,4,4,4,6.8,17074,15830,1583.0,85,-608,0
33,71,-359,1563.4,15634,16355,6.8,5,5,4,201,20.1,0,0,1,0,1,222,22.2,1,4,4,4,6.8,16714,15563,1556.3,359,-71,0
34,275,872,1608.5,16085,19076,7.4,6,6,4,204,20.4,0,0,0,1,1,223,22.3,1,5,4,4,7.2,18204,15810,1581.0,-872,-275,1
35,-809,638,1498.1,14981,17082,6.8,3,3,6,235,23.5,0,0,0,1,1,218,21.8,2,7,4,4,6.8,16444,15790,1579.0,-638,809,0
36,-2771,-1125,1542.1,15421,19276,7.2,2,2,2,217,21.7,1,1,0,1,0,234,23.4,0,5,8,8,7.4,20401,18192,1819.2,1125,2771,0
37,-1730,-1236,1566.5,15665,17716,6.8,5,5,4,203,20.3,1,0,1,0,1,214,21.4,1,6,6,6,7.0,18952,17395,1739.5,1236,1730,0
38,-904,1377,1752.8,17528,19609,7.2,7,7,5,234,23.4,1,0,0,1,1,227,22.7,1,9,9,9,7.0,18232,18432,1843.2,-1377,904,0
39,-1683,-1363,1503.2,15032,16832,6.6,3,3,3,213,21.3,1,0,0,1,1,236,23.6,1,6,6,6,7.0,18195,16715,1671.5,1363,1683,0
40,-3025,-1833,1548.3,15483,17362,6.8,4,4,3,222,22.2,0,0,0,1,1,213,21.3,1,16,11,11,7.2,19195,18508,1850.8,1833,3025,0
41,3004,2300,1922.6,19226,20118,7.4,10,10,12,231,23.1,0,0,0,1,0,185,18.5,0,7,6,6,7.0,17818,16222,1622.2,-2300,-3004,1
42,1574,761,1694.5,16945,17806,6.8,9,9,14,204,20.4,1,1,0,1,0,194,19.4,0,6,6,6,6.8,17045,15371,1537.1,-761,-1574,1
43,-1036,-1423,1500.0,15000,16493,6.6,5,5,3,233,23.3,0,0,1,0,0,221,22.1,0,4,5,5,7.0,17916,16036,1603.6,1423,1036,1
44,16,433,1588.8,15888,19090,7.4,3,3,2,252,25.2,1,0,1,0,1,243,24.3,1,2,4,4,7.0,18657,15872,1587.2,-433,-16,0
45,-6386,-4210,1292.5,12925,15498,6.4,1,1,0,187,18.7,0,0,0,1,0,247,24.7,1,6,10,10,7.2,19708,19311,1931.1,4210,6386,0
46,5096,3310,1925.0,19250,19703,7.6,11,11,9,251,25.1,0,0,1,0,0,196,19.6,0,2,2,2,6.4,16393,14154,1415.4,-3310,-5096,1
47,2756,1683,1835.5,18355,18790,7.0,8,8,5,218,21.8,1,1,1,0,0,200,20.0,0,5,4,4,6.8,17107,15599,1559.9,-1683,-2756,1
48,-977,-1025,1397.8,13978,16429,6.6,2,2,2,180,18.0,1,0,0,1,0,218,21.8,0,1,3,3,6.8,17454,14955,1495.5,1025,977,1
49,-808,-1655,1585.1,15851,17366,6.8,5,5,8,206,20.6,0,0,0,1,0,241,24.1,0,6,5,5,7.2,19021,16659,1665.9,1655,808,0
50,-1559,-407,1647.4,16474,17408,6.6,7,7,5,209,20.9,0,0,0,1,1,206,20.6,1,13,9,9,6.8,17815,18033,1803.3,407,1559,0
51,544,75,1659.0,16590,18284,7.0,6,6,6,213,21.3,0,0,0,1,0,182,18.2,0,7,8,8,7.0,18209,16046,1604.6,-75,-544,1
52,1381,1017,1573.7,15737,18634,7.0,5,5,2,217,21.7,2,1,1,0,0,212,21.2,0,1,2,2,7.0,17617,14356,1435.6,-1017,-1381,1
53,2031,1449,1699.0,16990,19634,7.4,5,5,5,248,24.8,0,0,1,0,1,210,21.0,1,5,3,3,7.0,18185,14959,1495.9,-1449,-2031,1
54,131,370,1529.7,15297,19210,7.0,3,3,2,246,24.6,1,1,0,1,0,227,22.7,0,1,3,3,7.2,18840,15166,1516.6,-370,-131,0
55,-2699,-2749,1565.1,15651,17696,7.0,4,4,4,224,22.4,1,0,0,1,1,201,20.1,1,11,10,10,7.4,20445,18350,1835.0,2749,2699,0
56,-1672,-2698,1558.7,15587,16746,6.8,5,5,7,181,18.1,1,1,1,0,0,218,21.8,0,6,7,7,7.4,19444,17259,1725.9,2698,1672,0
57,1201,316,1777.7,17777,18131,7.2,10,10,11,213,21.3,1,1,1,0,0,234,23.4,0,5,6,6,6.8,17815,16576,1657.6,-316,-1201,1
58,-108,59,1642.6,16426,18407,7.0,7,7,5,222,22.2,2,1,1,0,0,247,24.7,0,4,5,5,6.8,18348,16534,1653.4,-59,108,1
59,4633,2269,2027.8,20278,19575,7.2,10,10,11,236,23.6,0,0,0,1,1,182,18.2,1,6,7,7,6.6,17306,15645,1564.5,-2269,-4633,0
60,-2262,-1391,1379.1,13791,16437,6.6,2,2,0,191,19.1,0,0,0,1,1,218,21.8,1,4,7,7,6.8,17828,16053,1605.3,1391,2262,0
61,-49,500,1650.5,16505,17667,7.0,6,6,5,208,20.8,0,0,0,1,1,207,20.7,1,10,7,7,6.8,17167,16554,1655.4,-500,49,0
62,1687,1089,1727.7,17277,19610,7.2,6,6,4,229,22.9,1,1,1,0,0,232,23.2,1,5,4,4,7.2,18521,15590,1559.0,-1089,-1687,1
63,3933,2922,1826.9,18269,19659,7.2,9,9,10,229,22.9,2,1,1,0,0,233,23.3,0,1,1,1,6.4,16737,14336,1433.6,-2922,-3933,1
64,-4061,-4397,1416.6,14166,15959,6.6,4,4,3,203,20.3,1,1,0,1,0,224,22.4,0,6,10,10,7.4,20356,18227,1822.7,4397,4061,0
65,-4920,-3280,1545.6,15456,16280,6.6,6,6,7,188,18.8,0,0,0,1,0,240,24.0,1,11,12,12,7.4,19560,20376,2037.6,3280,4920,0
66,-1705,-1839,1518.0,15180,17773,7.0,4,4,2,210,21.0,0,0,0,1,0,227,22.7,0,1,5,5,7.2,19612,16885,1688.5,1839,1705,0
67,105,-1547,1617.9,16179,16814,6.8,7,7,8,212,21.2,1,1,1,0,0,200,20.0,1,5,8,8,7.0,18361,16074,1607.4,1547,-105,0
68,-554,521,1602.6,16026,18490,7.0,3,3,3,233,23.3,0,0,0,1,1,234,23.4,1,6,5,5,6.8,17969,16580,1658.0,-521,554,1
69,-1037,-1577,1485.0,14850,17145,6.8,4,4,4,198,19.8,0,0,1,0,1,241,24.1,1,5,5,5,7.0,18722,15887,1588.7,1577,1037,0
70,-1144,480,1734.7,17347,18573,7.0,9,9,7,202,20.2,1,0,1,0,1,199,19.9,1,11,8,8,7.0,18093,18491,1849.1,-480,1144,0
71,1173,953,1588.7,15887,17591,6.8,5,5,6,200,20.0,0,0,1,0,1,186,18.6,1,3,4,4,6.6,16638,14714,1471.4,-953,-1173,1
72,3194,2534,1739.9,17399,19449,7.0,8,8,11,232,23.2,0,0,1,0,1,208,20.8,1,2,2,2,6.6,16915,14205,1420.5,-2534,-3194,0
73,-2622,-1136,1382.8,13828,16629,6.6,2,2,1,204,20.4,1,1,1,0,0,192,19.2,0,7,7,7,6.8,17765,16450,1645.0,1136,2622,0
74,1151,470,1664.5,16645,19110,7.2,6,6,4,242,24.2,1,1,1,0,0,205,20.5,1,3,4,4,7.0,18640,15494,1549.4,-470,-1151,1
75,1463,1490,1624.8,16248,17200,6.8,6,6,8,200,20.0,2,1,1,0,0,169,16.9,0,8,4,4,6.6,15710,14785,1478.5,-1490,-1463,1
76,-1038,-1307,1531.0,15310,18337,7.0,4,4,1,221,22.1,0,0,0,1,1,226,22.6,2,5,6,6,7.2,19644,16348,1634.8,1307,1038,0
77,1424,1060,1678.4,16784,17242,6.6,8,8,7,212,21.2,1,0,1,0,0,180,18.0,0,5,4,4,6.4,16182,15360,1536.0,-1060,-1424,1
78,527,721,1903.2,19032,18951,7.4,13,13,18,232,23.2,1,1,0,1,0,216,21.6,0,5,9,9,7.0,18230,18505,1850.5,-721,-527,1
79,1807,932,1751.8,17518,18342,7.2,7,7,12,242,24.2,0,0,0,1,1,198,19.8,2,9,6,6,6.8,17410,15711,1571.1,-932,-1807,0
80,2856,1262,1897.6,18976,20326,7.4,11,11,12,256,25.6,1,0,1,0,1,210,21.0,1,6,4,4,7.2,19064,16120,1612.0,-1262,-2856,0
81,-964,-2454,1614.3,16143,16617,6.6,6,6,10,204,20.4,1,1,0,1,0,241,24.1,1,3,6,6,7.0,19071,17107,1710.7,2454,964,0
82,-178,524,1586.8,15868,17111,7.0,7,7,6,199,19.9,1,0,0,1,1,178,17.8,1,6,8,8,6.8,16587,16046,1604.6,-524,178,0
83,705,192,1797.7,17977,18162,7.0,9,9,7,235,23.5,1,1,0,1,0,207,20.7,0,8,8,8,7.0,17970,17272,1727.2,-192,-705,1
84,908,306,1813.8,18138,18159,7.0,10,10,14,208,20.8,1,1,0,1,0,210,21.0,0,16,10,10,7.0,17853,17230,1723.0,-306,-908,1
85,3558,3243,1802.5,18025,19864,7.2,7,7,12,261,26.1,2,1,0,1,0,220,22.0,0,3,2,2,6.8,16621,14467,1446.7,-3243,-3558,1
86,-1299,-49,1462.5,14625,17769,6.8,1,1,0,241,24.1,0,0,0,1,1,218,21.8,1,3,6,6,7.0,17818,15924,1592.4,49,1299,0
87,-1763,-1864,1575.2,15752,17113,6.6,5,5,7,201,20.1,1,1,0,1,0,248,24.8,0,6,8,8,7.2,18977,17515,1751.5,1864,1763,1
88,2547,2189,1848.0,18480,19565,7.4,10,10,12,232,23.2,0,0,0,1,0,247,24.7,0,4,4,4,6.6,17376,15933,1593.3,-2189,-2547,1
89,-3685,-3119,1499.5,14995,16206,6.6,3,3,2,210,21.0,1,1,0,1,0,200,20.0,1,13,10,10,7.4,19325,18680,1868.0,3119,3685,0
90,-3689,-4682,1565.5,15655,15827,6.4,7,7,3,194,19.4,0,0,1,0,1,216,21.6,1,7,11,11,7.2,20509,19344,1934.4,4682,3689,0
91,-764,803,1556.2,15562,18590,7.2,3,3,2,236,23.6,0,0,1,0,1,233,23.3,2,6,5,5,6.8,17787,16326,1632.6,-803,764,0
92,3037,2694,1713.9,17139,19137,7.2,9,9,5,223,22.3,0,0,1,0,1,213,21.3,1,2,2,2,6.6,16443,14102,1410.2,-2694,-3037,1
93,3545,2162,1922.9,19229,18820,7.2,7,7,6,257,25.7,0,0,1,0,1,145,14.5,1,10,7,7,6.6,16658,15684,1568.4,-2162,-3545,1
94,-1031,-394,1697.2,16972,19060,7.2,7,7,10,209,20.9,1,1,0,1,0,255,25.5,0,7,7,7,7.4,19454,18003,1800.3,394,1031,0
95,-1796,-749,1624.9,16249,18383,7.0,5,5,6,213,21.3,0,0,0,1,1,214,21.4,1,15,10,10,7.0,19132,18045,1804.5,749,1796,0
96,1626,747,1641.5,16415,17645,6.8,5,5,9,247,24.7,0,0,1,0,1,203,20.3,1,5,4,4,7.0,16898,14789,1478.9,-747,-1626,1
97,832,1330,1801.2,18012,19837,7.2,6,6,10,250,25.0,1,0,0,1,1,186,18.6,1,11,8,8,7.0,18507,17180,1718.0,-1330,-832,1
98,2750,2647,1929.4,19294,20668,7.4,11,11,11,242,24.2,2,1,0,1,0,203,20.3,0,9,6,6,7.0,18021,16544,1654.4,-2647,-2750,1
99,-1524,-827,1538.3,15383,17243,6.8,5,5,4,227,22.7,1,0,0,1,0,186,18.6,0,11,8,8,7.0,18070,16907,1690.7,827,1524,0
100,-1370,-875,1577.7,15777,17401,6.6,6,6,2,224,22.4,1,1,1,0,0,210,21.0,0,9,8,8,7.0,18276,17147,1714.7,875,1370,0
101,-1506,-412,1480.5,14805,17323,6.6,4,4,4,209,20.9,0,0,0,1,1,231,23.1,1,7,6,6,7.0,17735,16311,1631.1,412,1506,0
102,-1101,-718,1524.4,15244,16787,6.6,6,6,2,199,19.9,0,0,0,1,1,212,21.2,2,5,7,7,7.0,17505,16345,1634.5,718,1101,0
103,2774,2207,1757.4,17574,19195,7.2,8,8,7,252,25.2,1,0,0,1,1,225,22.5,1,2,3,3,6.6,16988,14800,1480.0,-2207,-2774,0
104,-1806,-588,1665.5,16655,17831,7.0,8,8,9,222,22.2,0,0,0,1,1,215,21.5,2,13,11,11,7.0,18419,18461,1846.1,588,1806,0
105,1265,1248,1685.5,16855,18370,7.0,6,6,8,248,24.8,1,1,0,1,0,207,20.7,1,4,4,4,6.8,17122,15590,1559.0,-1248,-1265,0
106,-4443,-4140,1578.6,15786,16995,6.6,6,6,4,200,20.0,0,0,0,1,1,227,22.7,1,9,14,14,7.6,21135,20229,2022.9,4140,4443,1
107,-927,967,1514.3,15143,19080,7.2,3,3,1,233,23.3,0,0,0,1,1,216,21.6,1,7,5,5,7.0,18113,16070,1607.0,-967,927,0
108,1425,728,1730.9,17309,18904,7.0,9,9,9,221,22.1,0,0,1,0,1,208,20.8,2,3,5,5,6.8,18176,15884,1588.4,-728,-1425,1
109,1177,1161,1641.6,16416,19684,7.4,6,6,6,211,21.1,1,1,0,1,0,204,20.4,0,2,4,4,7.0,18523,15239,1523.9,-1161,-1177,1
110,-1586,410,1522.2,15222,17812,7.0,2,2,2,231,23.1,1,1,1,0,0,211,21.1,1,14,7,7,6.8,17402,16808,1680.8,-410,1586,1
111,-2896,-2081,1552.6,15526,17629,6.8,5,5,3,232,23.2,2,1,0,1,0,236,23.6,0,6,10,10,7.4,19710,18422,1842.2,2081,2896,0
112,905,1054,1759.7,17597,15938,6.4,12,12,10,143,14.3,0,0,0,1,0,181,18.1,0,9,9,9,6.2,14884,16692,1669.2,-1054,-905,1
113,-3887,-3392,1683.4,16834,14815,6.2,9,9,17,187,18.7,0,0,1,0,0,211,21.1,0,21,17,17,7.0,18207,20721,2072.1,3392,3887,0
114,3413,2984,1905.8,19058,19575,7.2,12,12,12,202,20.2,1,1,1,0,0,210,21.0,0,7,6,6,6.6,16591,15645,1564.5,-2984,-3413,1
115,-256,-1580,1680.6,16806,18034,7.0,7,7,5,228,22.8,2,1,1,0,0,230,23.0,0,7,9,9,7.4,19614,17062,1706.2,1580,256,0
116,-1820,-1412,1664.3,16643,17554,6.8,7,7,7,227,22.7,0,0,1,0,0,231,23.1,0,11,10,10,7.2,18966,18463,1846.3,1412,1820,1
117,625,-534,1618.9,16189,17737,6.8,6,6,12,224,22.4,1,1,1,0,0,217,21.7,0,4,4,4,7.0,18271,15564,1556.4,534,-625,1
118,-3628,-2009,1409.5,14095,17286,6.8,2,2,1,196,19.6,0,0,0,1,1,266,26.6,1,4,6,6,7.0,19295,17723,1772.3,2009,3628,0
119,769,480,1680.4,16804,17544,6.8,5,5,7,217,21.7,1,0,1,0,1,233,23.3,1,6,5,5,6.4,17064,16035,1603.5,-480,-769,0
120,-576,-682,1730.5,17305,18192,7.0,8,8,8,229,22.9,1,1,0,1,0,198,19.8,1,6,8,8,7.0,18874,17881,1788.1,682,576,0
121,-3900,-3550,1453.9,14539,16806,6.4,3,3,2,213,21.3,0,0,0,1,1,255,25.5,1,8,9,9,7.6,20356,18439,1843.9,3550,3900,0
122,-7,-231,1753.0,17530,18299,7.0,9,9,10,192,19.2,1,1,0,1,0,209,20.9,1,8,8,8,7.2,18530,17537,1753.7,231,7,1
123,1683,1433,1843.1,18431,19562,7.2,10,10,10,207,20.7,0,0,1,0,1,231,23.1,1,5,7,7,7.0,18129,16748,1674.8,-1433,-1683,1
124,-4782,-3408,1403.2,14032,16550,6.8,3,3,2,193,19.3,0,0,0,1,1,245,24.5,1,11,10,10,7.4,19958,18814,1881.4,3408,4782,0
125,636,-214,1786.9,17869,17810,7.0,9,9,11,205,20.5,1,1,1,0,0,215,21.5,0,9,7,7,6.8,18024,17233,1723.3,214,-636,1
126,-3421,-2624,1597.4,15974,16174,6.2,7,7,6,183,18.3,1,1,0,1,0,219,21.9,0,12,14,14,7.2,18798,19395,1939.5,2624,3421,1
127,976,1599,1610.8,16108,18920,7.2,5,5,6,240,24.0,1,1,0,1,0,230,23.0,0,5,3,3,6.8,17321,15132,1513.2,-1599,-976,1
128,-211,-1305,1630.2,16302,17297,6.8,6,6,6,212,21.2,0,0,0,1,0,211,21.1,1,7,7,7,7.2,18602,16513,1651.3,1305,211,0
129,1221,462,1675.0,16750,17603,6.8,7,7,6,215,21.5,0,0,0,1,0,197,19.7,0,5,5,5,6.8,17141,15529,1552.9,-462,-1221,1
130,2037,1291,1650.6,16506,18669,7.2,7,7,8,226,22.6,0,0,0,1,1,217,21.7,1,0,1,1,6.6,17378,14469,1446.9,-1291,-2037,1
131,817,-94,1638.9,16389,17937,7.0,6,6,11,241,24.1,1,1,1,0,0,229,22.9,0,3,3,3,6.8,18031,15572,1557.2,94,-817,1
132,-137,-351,1576.0,15760,18295,7.0,4,4,4,215,21.5,0,0,1,0,1,227,22.7,1,1,4,4,7.0,18646,15897,1589.7,351,137,1
133,-1539,-1497,1517.6,15176,16820,6.4,4,4,4,226,22.6,1,1,1,0,0,205,20.5,0,12,7,7,7.2,18317,16715,1671.5,1497,1539,1
134,-1707,-1286,1519.6,15196,16908,6.4,5,5,4,191,19.1,0,0,0,1,1,216,21.6,1,10,7,7,7.0,18194,16903,1690.3,1286,1707,0
135,-556,-235,1625.0,16250,17537,7.0,6,6,2,228,22.8,1,1,0,1,0,143,14.3,0,13,9,9,6.8,17772,16806,1680.6,235,556,1
136,-146,-717,1654.1,16541,16779,6.6,9,9,15,199,19.9,1,1,1,0,0,225,22.5,1,8,7,7,6.8,17496,16687,1668.7,717,146,1
137,4083,2884,1865.7,18657,19205,7.2,12,12,9,227,22.7,1,0,1,0,1,191,19.1,1,1,4,4,6.6,16321,14574,1457.4,-2884,-4083,1
138,1389,1418,1687.3,16873,19105,7.2,5,5,6,223,22.3,0,0,0,1,1,226,22.6,1,7,5,5,6.8,17687,15484,1548.4,-1418,-1389,1
139,-890,-528,1438.3,14383,15898,6.4,3,3,3,211,21.1,1,1,0,1,0,208,20.8,1,5,4,4,6.4,16426,15273,1527.3,528,890,0
140,-2519,-1095,1442.0,14420,15196,6.4,4,4,5,192,19.2,0,0,1,0,0,194,19.4,0,15,9,9,6.4,16291,16939,1693.9,1095,2519,0
141,-4440,-4020,1472.0,14720,15031,6.2,4,4,4,183,18.3,0,0,0,1,0,201,20.1,0,14,15,15,7.4,19051,19160,1916.0,4020,4440,0
142,1140,705,1740.6,17406,19761,7.2,7,7,7,251,25.1,0,0,1,0,1,190,19.0,2,4,6,6,7.2,19056,16266,1626.6,-705,-1140,1
143,-1656,-1832,1521.0,15210,15974,6.4,5,5,2,172,17.2,0,0,1,0,0,219,21.9,0,3,7,7,6.8,17806,16866,1686.6,1832,1656,0
144,2171,-261,1727.2,17272,15840,6.4,10,10,16,192,19.2,0,0,0,1,1,199,19.9,2,6,5,5,6.6,16101,15101,1510.1,261,-2171,1
145,3841,2484,1935.8,19358,19257,7.2,12,12,15,206,20.6,0,0,1,0,0,216,21.6,0,3,4,4,6.8,16773,15517,1551.7,-2484,-3841,1
146,-885,-2172,1685.5,16855,16360,6.6,4,4,5,232,23.2,1,0,0,1,1,216,21.6,1,15,11,11,7.2,18532,17740,1774.0,2172,885,1
147,-2752,-2286,1520.9,15209,16256,6.6,3,3,4,191,19.1,2,1,0,1,0,241,24.1,0,9,8,8,7.2,18542,17961,1796.1,2286,2752,0
148,2081,466,1954.2,19542,17935,7.0,13,13,22,207,20.7,0,0,1,0,0,200,20.0,0,11,9,9,7.0,17469,17461,1746.1,-466,-2081,1
149,453,-19,1526.7,15267,17321,6.6,4,4,4,232,23.2,0,0,1,0,0,209,20.9,0,3,3,3,6.8,17340,14814,1481.4,19,-453,0
150,830,-1002,1524.3,15243,17194,6.6,3,3,3,224,22.4,1,1,1,0,0,220,22.0,1,1,1,1,6.8,18196,14413,1441.3,1002,-830,0
151,94,-445,1621.4,16214,17234,6.8,8,8,3,203,20.3,0,0,0,1,0,168,16.8,0,6,8,8,7.0,17679,16120,1612.0,445,-94,0
152,-722,891,1597.6,15976,18227,7.0,8,8,12,178,17.8,2,1,0,1,0,232,23.2,0,6,6,6,6.6,17336,16698,1669.8,-891,722,0
153,-1491,-799,1655.7,16557,17632,6.8,6,6,10,230,23.0,1,0,0,1,1,222,22.2,1,11,7,7,7.0,18431,18048,1804.8,799,1491,0
154,-3109,-1745,1614.2,16142,16953,6.8,6,6,3,198,19.8,0,0,0,1,1,201,20.1,2,16,14,14,7.0,18698,19251,1925.1,1745,3109,0
155,537,-477,1798.4,17984,18708,7.2,7,7,9,230,23.0,0,0,1,0,1,178,17.8,1,11,11,11,7.2,19185,17447,1744.7,477,-537,0
156,4079,5568,2003.8,20038,21588,7.8,13,13,10,222,22.2,2,1,0,1,0,208,20.8,0,6,5,5,6.6,16020,15959,1595.9,-5568,-4079,1
157,4006,2081,1957.1,19571,18463,7.2,10,10,13,213,21.3,0,0,0,1,0,210,21.0,0,6,5,5,6.6,16382,15565,1556.5,-2081,-4006,1
158,-3582,-5395,1455.7,14557,15128,6.4,3,3,4,200,20.0,0,0,1,0,1,246,24.6,2,10,10,10,7.6,20523,18139,1813.9,5395,3582,0
159,-355,233,1602.9,16029,18567,7.0,6,6,5,205,20.5,0,0,0,1,1,224,22.4,1,5,6,6,7.0,18334,16384,1638.4,-233,355,1
160,3464,994,1805.3,18053,16741,6.6,7,7,8,207,20.7,0,0,1,0,0,178,17.8,0,6,6,6,6.4,15747,14589,1458.9,-994,-3464,1
161,2217,2183,1809.8,18098,18905,7.0,9,9,9,225,22.5,1,1,1,0,0,229,22.9,1,3,5,5,6.6,16722,15881,1588.1,-2183,-2217,1
162,3049,1511,1834.3,18343,19519,7.2,8,8,9,235,23.5,2,1,1,0,0,234,23.4,0,2,3,3,7.0,18008,15294,1529.4,-1511,-3049,1
163,-305,-474,1559.6,15596,17998,7.0,5,5,4,198,19.8,1,1,0,1,0,199,19.9,0,7,6,6,7.0,18472,15901,1590.1,474,305,1
164,1325,479,1581.2,15812,17882,7.0,4,4,6,229,22.9,1,1,0,1,0,218,21.8,1,1,2,2,7.0,17403,14487,1448.7,-479,-1325,0
165,-53,87,1594.7,15947,16477,6.4,6,6,10,221,22.1,0,0,1,0,1,203,20.3,1,9,6,6,6.4,16390,16000,1600.0,-87,53,1
166,-2865,-1441,1499.7,14997,16532,6.6,5,5,5,196,19.6,0,0,0,1,1,237,23.7,1,7,9,9,6.8,17973,17862,1786.2,1441,2865,0
167,-93,-561,1646.3,16463,17576,6.8,7,7,5,215,21.5,0,0,1,0,1,217,21.7,1,8,7,7,7.0,18137,16556,1655.6,561,93,0
168,-420,-1185,1607.2,16072,17054,6.6,6,6,7,225,22.5,0,0,1,0,1,212,21.2,1,10,7,7,7.2,18239,16492,1649.2,1185,420,0
169,5008,2355,1914.0,19140,19579,7.4,7,7,6,253,25.3,1,1,1,0,0,179,17.9,1,3,3,3,6.8,17224,14132,1413.2,-2355,-5008,1
170,-2074,-1795,1454.7,14547,15883,6.4,4,4,1,188,18.8,0,0,1,0,1,196,19.6,2,5,6,6,6.8,17678,16621,1662.1,1795,2074,0
171,-3,1013,1564.4,15644,17717,6.8,5,5,7,188,18.8,1,0,0,1,0,190,19.0,0,7,4,4,6.6,16704,15647,1564.7,-1013,3,1
172,-837,-660,1573.4,15734,17911,7.0,5,5,5,213,21.3,0,0,1,0,1,249,24.9,2,7,5,5,7.0,18571,16571,1657.1,660,837,0
173,510,-747,1679.4,16794,17320,6.8,5,5,6,229,22.9,1,1,1,0,0,216,21.6,1,6,5,5,7.2,18067,16284,1628.4,747,-510,1
174,-3549,-2407,1593.0,15930,17257,6.8,6,6,8,200,20.0,1,1,0,1,0,214,21.4,0,12,11,11,7.4,19664,19479,1947.9,2407,3549,0
175,272,359,1693.6,16936,18646,7.2,6,6,6,240,24.0,0,0,0,1,1,199,19.9,1,7,6,6,6.8,18287,16664,1666.4,-359,-272,1
176,2187,2189,1794.1,17941,19379,7.2,9,9,9,230,23.0,0,0,1,0,0,206,20.6,0,5,5,5,7.0,17190,15754,1575.4,-2189,-2187,1
177,-4907,-2556,1369.8,13698,15671,6.2,2,2,4,222,22.2,0,0,0,1,0,242,24.2,1,11,8,8,7.0,18227,18605,1860.5,2556,4907,0
178,63,648,1594.3,15943,19262,7.4,5,5,3,238,23.8,1,1,1,0,0,210,21.0,0,5,4,4,7.0,18614,15880,1588.0,-648,-63,1
179,-2132,-484,1589.1,15891,18304,7.0,4,4,6,222,22.2,1,0,0,1,1,230,23.0,1,13,8,8,7.0,18788,18023,1802.3,484,2132,1
180,-976,-964,1621.6,16216,19002,7.0,5,5,5,211,21.1,1,0,0,1,1,222,22.2,1,8,6,6,7.6,19966,17192,1719.2,964,976,0
181,-1342,-1966,1475.4,14754,17158,6.6,3,3,3,186,18.6,0,0,1,0,1,218,21.8,1,6,5,5,7.2,19124,16096,1609.6,1966,1342,0
182,2304,2532,1690.9,16909,18318,7.2,8,8,5,229,22.9,1,1,1,0,0,208,20.8,0,2,2,2,6.2,15786,14605,1460.5,-2532,-2304,1
183,4219,3379,1885.8,18858,19691,7.2,10,10,11,218,21.8,0,0,0,1,1,219,21.9,1,1,2,2,6.6,16312,14639,1463.9,-3379,-4219,1
184,-2049,-2340,1595.2,15952,17112,6.8,6,6,7,180,18.0,0,0,1,0,0,243,24.3,0,9,7,7,7.2,19452,18001,1800.1,2340,2049,0
185,-4179,-3823,1328.6,13286,15085,6.2,1,1,2,187,18.7,0,0,0,1,1,236,23.6,1,4,5,5,7.0,18908,17465,1746.5,3823,4179,0
186,-66,-1073,1681.2,16812,18466,7.2,6,6,9,269,26.9,0,0,0,1,1,245,24.5,1,3,6,6,7.0,19539,16878,1687.8,1073,66,0
187,510,142,1790.6,17906,18001,6.8,9,9,13,178,17.8,2,1,0,1,0,215,21.5,0,4,7,7,6.8,17859,17396,1739.6,-142,-510,1
188,2591,1567,1640.8,16408,19181,7.2,4,4,2,263,26.3,1,0,1,0,1,208,20.8,1,1,3,3,6.8,17614,13817,1381.7,-1567,-2591,0
189,-3772,-3034,1505.6,15056,16369,6.4,4,4,5,198,19.8,0,0,1,0,1,177,17.7,1,20,12,12,7.4,19403,18828,1882.8,3034,3772,0
190,965,-878,1783.1,17831,18269,6.8,6,6,11,240,24.0,1,1,1,0,0,233,23.3,0,7,6,6,7.0,19147,16866,1686.6,878,-965,0
191,-3468,-2158,1373.8,13738,16678,6.6,1,1,1,223,22.3,0,0,0,1,1,259,25.9,2,7,5,5,7.4,18836,17206,1720.6,2158,3468,0
192,6153,3916,2031.7,20317,20330,7.4,14,14,15,212,21.2,0,0,1,0,0,196,19.6,0,4,3,3,6.4,16414,14164,1416.4,-3916,-6153,1
193,-2216,-2730,1409.1,14091,16184,6.4,0,0,0,233,23.3,0,0,0,1,1,229,22.9,1,8,5,5,7.0,18914,16307,1630.7,2730,2216,0
194,-2308,-1767,1603.6,16036,16916,6.6,6,6,4,191,19.1,1,1,0,1,0,206,20.6,0,14,11,11,7.2,18683,18344,1834.4,1767,2308,0
195,1917,-179,1705.2,17052,17392,6.6,6,6,5,210,21.0,1,0,1,0,1,194,19.4,1,3,6,6,7.0,17571,15135,1513.5,179,-1917,1
196,-1676,-1759,1635.4,16354,18778,7.0,4,4,6,268,26.8,0,0,0,1,1,244,24.4,1,8,7,7,7.4,20537,18030,1803.0,1759,1676,0
197,2709,1259,1829.7,18297,19476,7.2,10,10,8,242,24.2,1,1,1,0,0,214,21.4,0,7,5,5,6.8,18217,15588,1558.8,-1259,-2709,1
198,-1304,-552,1574.8,15748,16524,6.6,6,6,5,222,22.2,0,0,0,1,1,216,21.6,1,12,8,8,6.8,17076,17052,1705.2,552,1304,0
199,1824,1409,1788.6,17886,20099,7.4,8,8,10,229,22.9,1,1,1,0,0,222,22.2,0,5,5,5,7.2,18690,16062,1606.2,-1409,-1824,1
200,229,-45,1706.9,17069,16703,6.6,11,11,15,174,17.4,0,0,0,1,1,212,21.2,2,9,8,8,6.8,16748,16840,1684.0,45,-229,0
201,1507,1667,1663.1,16631,19310,7.2,4,4,4,252,25.2,1,0,0,1,0,214,21.4,0,1,4,4,7.0,17643,15124,1512.4,-1667,-1507,1
202,-1787,-1135,1476.6,14766,18364,7.0,1,1,3,231,23.1,1,1,0,1,0,235,23.5,0,4,5,5,7.0,19499,16553,1655.3,1135,1787,0
203,815,1397,1711.3,17113,19396,7.2,8,8,3,234,23.4,0,0,0,1,0,182,18.2,0,4,7,7,6.8,17999,16298,1629.8,-1397,-815,0
204,-4767,-5061,1512.0,15120,16713,6.6,5,5,6,167,16.7,1,1,0,1,0,238,23.8,0,9,14,14,7.8,21774,19887,1988.7,5061,4767,0
205,-1861,-2532,1533.9,15339,16302,6.6,4,4,6,221,22.1,0,0,0,1,1,262,26.2,1,10,6,6,7.0,18834,17200,1720.0,2532,1861,0
206,-7655,-4485,1343.8,13438,14164,5.8,1,1,1,174,17.4,1,1,0,1,0,234,23.4,0,18,14,14,7.0,18649,21093,2109.3,4485,7655,0
207,-2058,-2051,1558.2,15582,17281,6.8,4,4,3,212,21.2,0,0,0,1,0,224,22.4,0,11,9,9,7.2,19332,17640,1764.0,2051,2058,1
208,-575,-208,1544.1,15441,17550,6.6,5,5,7,201,20.1,1,1,0,1,0,213,21.3,0,3,5,5,6.8,17758,16016,1601.6,208,575,1
209,1765,701,1600.2,16002,18467,7.2,4,4,2,245,24.5,1,0,1,0,0,212,21.2,0,1,2,2,6.8,17766,14237,1423.7,-701,-1765,0
210,540,269,1600.9,16009,18033,6.8,5,5,8,220,22.0,1,0,1,0,1,185,18.5,1,8,5,5,6.8,17764,15469,1546.9,-269,-540,0
211,862,-442,1810.6,18106,16668,6.6,12,12,15,186,18.6,0,0,0,1,1,204,20.4,1,11,9,9,6.8,17110,17244,1724.4,442,-862,1
212,2761,1659,1650.1,16501,18428,6.6,6,6,9,221,22.1,1,1,1,0,0,201,20.1,0,1,2,2,6.6,16769,13740,1374.0,-1659,-2761,1
213,-1249,-853,1550.5,15505,17721,6.8,3,3,3,227,22.7,0,0,0,1,1,214,21.4,1,5,8,8,7.2,18574,16754,1675.4,853,1249,0
214,-75,655,1619.5,16195,19145,7.0,5,5,3,244,24.4,0,0,0,1,1,217,21.7,1,5,5,5,7.0,18490,16270,1627.0,-655,75,1
215,5805,4777,2029.4,20294,18459,6.8,14,14,12,230,23.0,1,1,1,0,0,178,17.8,0,6,5,5,5.8,13682,14489,1448.9,-4777,-5805,1
216,-810,-305,1547.5,15475,18145,7.0,5,5,3,198,19.8,1,0,0,1,1,212,21.2,1,11,7,7,7.0,18450,16285,1628.5,305,810,0
217,1034,706,1624.3,16243,18154,7.0,5,5,6,225,22.5,1,0,1,0,0,227,22.7,0,2,4,4,6.8,17448,15209,1520.9,-706,-1034,0
218,-2595,-2856,1506.5,15065,17137,6.6,3,3,2,231,23.1,0,0,1,0,0,260,26.0,1,6,7,7,7.4,19993,17660,1766.0,2856,2595,1
219,-334,-73,1435.9,14359,17258,6.8,1,1,3,228,22.8,0,0,0,1,1,223,22.3,1,1,2,2,6.6,17331,14693,1469.3,73,334,1
220,3806,2161,1937.7,19377,20008,7.4,11,11,8,233,23.3,2,1,1,0,0,231,23.1,0,4,4,4,7.0,17847,15571,1557.1,-2161,-3806,1
221,-2711,-2547,1413.5,14135,17185,6.8,2,2,2,220,22.0,0,0,0,1,0,230,23.0,0,7,7,7,7.2,19732,16846,1684.6,2547,2711,0
222,2551,1754,1744.8,17448,18315,6.8,8,8,8,242,24.2,0,0,1,0,0,195,19.5,0,7,4,4,6.6,16561,14897,1489.7,-1754,-2551,1
223,66,-446,1595.8,15958,17693,6.6,6,6,9,213,21.3,1,1,1,0,0,254,25.4,0,3,3,3,6.8,18139,15892,1589.2,446,-66,0
224,2242,727,1828.7,18287,18402,7.2,10,10,13,213,21.3,1,1,0,1,0,225,22.5,0,3,5,5,6.8,17675,16045,1604.5,-727,-2242,0
225,-893,-213,1553.4,15534,17975,7.0,2,2,2,252,25.2,1,0,0,1,0,231,23.1,0,8,5,5,7.0,18188,16427,1642.7,213,893,0
226,-1208,-152,1493.5,14935,17703,7.0,2,2,2,230,23.0,0,0,0,1,1,248,24.8,1,8,5,5,7.0,17855,16143,1614.3,152,1208,0
227,4003,2566,1933.1,19331,19387,7.2,12,12,11,255,25.5,0,0,0,1,1,215,21.5,1,5,4,4,6.8,16821,15328,1532.8,-2566,-4003,1
228,819,2149,1713.1,17131,19719,7.4,8,8,7,240,24.0,1,1,0,1,0,206,20.6,0,9,6,6,7.0,17570,16312,1631.2,-2149,-819,1
229,4009,1935,1798.3,17983,18340,7.0,9,9,10,230,23.0,0,0,1,0,0,183,18.3,1,1,3,3,6.6,16405,13974,1397.4,-1935,-4009,1
230,-259,-1001,1684.2,16842,18443,7.0,5,5,5,221,22.1,1,1,0,1,0,247,24.7,0,6,6,6,7.4,19444,17101,1710.1,1001,259,0
231,1728,-738,1756.9,17569,17101,6.8,9,9,13,212,21.2,0,0,1,0,0,180,18.0,0,7,6,6,7.0,17839,15841,1584.1,738,-1728,0
232,474,393,1588.2,15882,16956,6.8,5,5,3,241,24.1,1,0,0,1,1,207,20.7,1,6,5,5,6.4,16563,15408,1540.8,-393,-474,0
233,1863,328,1704.9,17049,17241,6.8,9,9,8,202,20.2,0,0,1,0,0,204,20.4,0,5,3,3,6.8,16913,15186,1518.6,-328,-1863,0
234,-3846,-2306,1355.6,13556,16451,6.8,1,1,1,200,20.0,0,0,0,1,1,253,25.3,1,7,7,7,7.2,18757,17402,1740.2,2306,3846,0
235,-2373,-1592,1469.2,14692,18342,7.0,1,1,1,227,22.7,0,0,0,1,1,250,25.0,1,5,3,3,7.2,19934,17065,1706.5,1592,2373,0
236,218,-204,1700.0,17000,16417,6.6,8,8,10,204,20.4,1,1,0,1,0,209,20.9,0,5,7,7,6.8,16621,16782,1678.2,204,-218,1
237,2208,1929,1720.0,17200,18984,7.2,6,6,7,235,23.5,0,0,1,0,0,215,21.5,0,5,4,4,6.6,17055,14992,1499.2,-1929,-2208,1
238,-1440,-373,1540.9,15409,18408,7.2,5,5,2,217,21.7,1,1,0,1,0,241,24.1,0,9,7,7,7.2,18781,16849,1684.9,373,1440,0
239,-845,-1743,1728.3,17283,16235,6.4,10,10,13,184,18.4,1,1,0,1,0,208,20.8,0,7,12,12,6.8,17978,18128,1812.8,1743,845,0
240,-2635,-2694,1547.7,15477,15965,6.4,5,5,5,173,17.3,0,0,0,1,1,241,24.1,1,12,9,9,7.0,18659,18112,1811.2,2694,2635,0
241,2817,2414,1676.3,16763,18897,7.0,6,6,8,224,22.4,2,1,0,1,0,207,20.7,0,1,1,1,6.4,16483,13946,1394.6,-2414,-2817,1
242,2812,2497,1843.4,18434,20263,7.4,9,9,4,223,22.3,2,1,0,1,0,226,22.6,0,3,5,5,7.2,17766,15622,1562.2,-2497,-2812,1
243,-3864,-2759,1373.1,13731,16666,6.6,1,1,2,218,21.8,0,0,0,1,1,263,26.3,1,10,6,6,7.2,19425,17595,1759.5,2759,3864,0
244,334,955,1725.1,17251,19984,7.4,5,5,6,233,23.3,1,1,0,1,0,230,23.0,0,5,6,6,7.0,19029,16917,1691.7,-955,-334,1
245,1909,2436,1705.1,17051,18864,7.0,7,7,5,246,24.6,1,1,1,0,0,196,19.6,0,8,6,6,6.4,16428,15142,1514.2,-2436,-1909,1
246,-346,-358,1634.6,16346,18557,7.0,7,7,6,209,20.9,0,0,1,0,0,182,18.2,0,7,7,7,7.2,18915,16692,1669.2,358,346,0
247,5802,5396,2109.5,21095,21242,7.6,14,14,14,249,24.9,0,0,1,0,1,186,18.6,1,5,4,4,6.2,15846,15293,1529.3,-5396,-5802,1
248,1085,1048,1643.4,16434,18641,7.0,6,6,3,228,22.8,1,1,1,0,0,220,22.0,0,2,4,4,6.6,17593,15349,1534.9,-1048,-1085,1
249,-2383,-1807,1583.4,15834,18362,6.8,4,4,2,197,19.7,1,1,1,0,0,182,18.2,0,7,11,11,7.4,20169,18217,1821.7,1807,2383,0
250,306,1895,1696.8,16968,18900,7.0,8,8,9,214,21.4,1,0,0,1,0,208,20.8,0,10,9,9,6.6,17005,16662,1666.2,-1895,-306,1
251,-1568,-1850,1594.9,15949,17005,6.8,5,5,7,209,20.9,0,0,1,0,1,215,21.5,1,8,7,7,7.2,18855,17517,1751.7,1850,1568,0
252,-1419,-1156,1605.6,16056,17578,6.8,5,5,3,234,23.4,1,1,0,1,0,227,22.7,1,13,7,7,7.0,18734,17475,1747.5,1156,1419,1
253,2263,1634,1839.2,18392,18818,6.8,10,10,8,222,22.2,1,0,1,0,1,213,21.3,1,5,6,6,6.4,17184,16129,1612.9,-1634,-2263,1
254,1374,1225,1641.5,16415,18271,7.2,6,6,9,230,23.0,0,0,1,0,1,217,21.7,1,2,2,2,6.8,17046,15041,1504.1,-1225,-1374,1
255,4301,3444,1994.8,19948,20064,7.4,14,14,21,220,22.0,1,1,0,1,0,205,20.5,0,4,4,4,6.6,16620,15647,1564.7,-3444,-4301,1
256,3905,3713,1818.9,18189,19191,7.0,9,9,6,220,22.0,0,0,1,0,0,181,18.1,0,3,4,4,6.2,15478,14284,1428.4,-3713,-3905,1
257,-2919,-2318,1439.8,14398,15990,6.6,3,3,4,194,19.4,0,0,0,1,1,207,20.7,1,9,8,8,7.0,18308,17317,1731.7,2318,2919,1
258,2923,2787,1735.9,17359,20592,7.4,6,6,8,265,26.5,1,1,1,0,0,242,24.2,0,0,0,0,6.8,17805,14436,1443.6,-2787,-2923,1
259,-1059,-951,1581.7,15817,17535,6.8,4,4,3,210,21.0,0,0,0,1,1,214,21.4,2,9,7,7,7.0,18486,16876,1687.6,951,1059,0
260,-406,-14,1586.1,15861,19121,7.0,3,3,3,270,27.0,1,0,0,1,1,235,23.5,1,7,5,5,7.0,19135,16267,1626.7,14,406,0
261,1143,1251,1635.5,16355,18991,7.0,7,7,7,238,23.8,1,1,0,1,0,216,21.6,0,2,3,3,7.0,17740,15212,1521.2,-1251,-1143,1
262,736,266,1833.3,18333,18622,7.0,11,11,13,225,22.5,0,0,0,1,1,205,20.5,1,9,9,9,7.2,18356,17597,1759.7,-266,-736,1
263,-4816,-3750,1456.2,14562,16952,6.8,2,2,3,196,19.6,0,0,1,0,1,259,25.9,1,12,11,11,7.4,20702,19378,1937.8,3750,4816,0
264,3977,3949,1967.7,19677,20488,7.6,11,11,13,236,23.6,2,1,0,1,0,208,20.8,0,12,6,6,6.4,16539,15700,1570.0,-3949,-3977,1
265,3026,3357,1879.3,18793,18395,7.0,11,11,14,217,21.7,0,0,0,1,1,174,17.4,1,8,7,7,6.4,15038,15767,1576.7,-3357,-3026,1
266,-4262,-2426,1427.6,14276,16422,6.8,4,4,0,190,19.0,1,1,0,1,0,224,22.4,0,14,12,12,7.2,18848,18538,1853.8,2426,4262,0
267,2476,772,1680.8,16808,17831,6.8,4,4,4,227,22.7,1,0,1,0,1,248,24.8,1,0,1,1,6.8,17059,14332,1433.2,-772,-2476,0
268,-3545,-3206,1500.2,15002,16448,6.6,3,3,3,217,21.7,0,0,0,1,1,224,22.4,2,10,9,9,7.4,19654,18547,1854.7,3206,3545,0
269,-4324,-2979,1435.4,14354,15677,6.4,4,4,5,173,17.3,1,0,0,1,1,213,21.3,1,13,9,9,7.0,18656,18678,1867.8,2979,4324,0
270,-496,-837,1592.6,15926,19262,7.2,5,5,6,223,22.3,1,1,0,1,0,218,21.8,0,5,6,6,7.4,20099,16422,1642.2,837,496,1
271,-1620,-1442,1474.2,14742,16162,6.6,3,3,5,241,24.1,0,0,0,1,1,226,22.6,1,6,5,5,7.0,17604,16362,1636.2,1442,1620,0
272,-1334,-1607,1648.1,16481,17069,6.8,6,6,8,201,20.1,0,0,1,0,1,198,19.8,1,12,10,10,7.2,18676,17815,1781.5,1607,1334,1
273,-796,-217,1630.7,16307,17660,7.0,9,9,5,194,19.4,0,0,1,0,0,215,21.5,0,10,8,8,6.8,17877,17103,1710.3,217,796,0
274,1398,1804,1656.9,16569,19120,7.2,6,6,3,238,23.8,1,1,1,0,0,233,23.3,0,3,2,2,6.6,17316,15171,1517.1,-1804,-1398,1
275,3005,1938,1732.2,17322,19067,7.0,5,5,5,229,22.9,0,0,1,0,0,197,19.7,0,4,3,3,6.4,17129,14317,1431.7,-1938,-3005,1
276,-3156,-3287,1471.1,14711,16559,6.8,3,3,2,222,22.2,0,0,1,0,0,238,23.8,0,6,8,8,7.2,19846,17867,1786.7,3287,3156,0
277,-473,383,1600.9,16009,18511,7.2,3,3,3,268,26.8,2,1,0,1,0,246,24.6,0,7,5,5,6.8,18128,16482,1648.2,-383,473,1
278,-3397,-2282,1510.2,15102,16437,6.4,5,5,4,196,19.6,0,0,0,1,0,225,22.5,1,12,10,10,7.0,18719,18499,1849.9,2282,3397,0
279,-1937,-1514,1549.9,15499,17298,6.8,6,6,5,222,22.2,0,0,0,1,1,204,20.4,1,12,9,9,7.0,18812,17436,1743.6,1514,1937,0
280,3765,2661,1845.6,18456,19319,7.2,10,10,10,218,21.8,0,0,1,0,0,193,19.3,0,3,4,4,6.8,16658,14691,1469.1,-2661,-3765,1
281,384,-690,1576.7,15767,17413,7.0,5,5,5,224,22.4,1,1,1,0,0,250,25.0,1,3,2,2,7.0,18103,15383,1538.3,690,-384,0
282,2708,682,1889.0,18890,19229,7.2,11,11,12,223,22.3,1,1,1,0,0,230,23.0,0,4,5,5,7.2,18547,16182,1618.2,-682,-2708,1
283,-2427,-1462,1490.1,14901,17696,7.0,4,4,3,209,20.9,0,0,1,0,0,224,22.4,0,7,8,8,7.2,19158,17328,1732.8,1462,2427,0
284,1901,684,1678.5,16785,19346,7.4,6,6,7,245,24.5,1,1,1,0,0,211,21.1,0,2,3,3,7.0,18662,14884,1488.4,-684,-1901,1
285,2480,1699,1878.6,18786,18509,7.2,10,10,15,235,23.5,1,1,0,1,0,221,22.1,1,8,5,5,6.8,16810,16306,1630.6,-1699,-2480,1
286,-3581,-2467,1472.7,14727,16272,6.6,1,1,2,219,21.9,1,0,0,1,1,248,24.8,1,15,10,10,7.0,18739,18308,1830.8,2467,3581,0
287,2911,1378,1800.9,18009,18763,7.2,10,10,14,200,20.0,2,1,1,0,0,212,21.2,0,5,5,5,6.8,17385,15098,1509.8,-1378,-2911,1
288,-1245,-1370,1452.6,14526,17366,6.8,1,1,2,224,22.4,1,0,0,1,1,241,24.1,1,4,4,4,7.0,18736,15771,1577.1,1370,1245,0
289,166,-497,1662.7,16627,17397,6.8,8,8,8,212,21.2,1,1,0,1,0,209,20.9,1,6,6,6,7.0,17894,16461,1646.1,497,-166,0
290,-6309,-3115,1307.5,13075,15488,6.4,1,1,1,169,16.9,0,0,0,1,0,270,27.0,0,5,6,6,7.2,18603,19384,1938.4,3115,6309,0
291,-2047,-2555,1610.5,16105,17502,6.8,5,5,4,214,21.4,0,0,0,1,1,208,20.8,1,5,11,11,7.6,20057,18152,1815.2,2555,2047,0
292,-1464,-1509,1478.2,14782,16677,6.8,3,3,6,213,21.3,0,0,1,0,1,238,23.8,1,4,4,4,7.0,18186,16246,1624.6,1509,1464,0
293,874,-302,1588.9,15889,18189,7.0,5,5,4,217,21.7,2,1,1,0,0,215,21.5,0,4,3,3,7.2,18491,15015,1501.5,302,-874,1
294,-627,183,1515.8,15158,17387,6.8,2,2,3,250,25.0,1,1,1,0,0,243,24.3,0,9,5,5,6.8,17204,15785,1578.5,-183,627,0
295,-334,-292,1507.3,15073,17578,6.8,3,3,4,227,22.7,0,0,0,1,0,251,25.1,0,3,3,3,6.8,17870,15407,1540.7,292,334,0
296,449,1210,1712.5,17125,18785,7.2,7,7,5,240,24.0,1,1,1,0,0,177,17.7,0,13,8,8,7.0,17575,16676,1667.6,-1210,-449,0
297,-780,-73,1637.7,16377,16818,6.6,6,6,6,209,20.9,0,0,0,1,0,200,20.0,0,14,9,9,6.6,16891,17157,1715.7,73,780,0
298,-205,1064,1588.8,15888,18421,7.4,4,4,4,234,23.4,1,0,0,1,0,217,21.7,0,7,6,6,7.0,17357,16093,1609.3,-1064,205,0
299,-1731,-1585,1441.4,14414,17356,6.8,2,2,3,226,22.6,0,0,0,1,0,268,26.8,0,3,3,3,7.0,18941,16145,1614.5,1585,1731,0
300,947,-188,1832.9,18329,18315,7.0,10,10,9,219,21.9,1,1,0,1,0,194,19.4,0,11,9,9,7.2,18503,17382,1738.2,188,-947,0
301,-713,-1111,1624.5,16245,16720,6.8,6,6,10,215,21.5,0,0,1,0,1,207,20.7,1,5,7,7,6.8,17831,16958,1695.8,1111,713,0
302,1171,-1140,1612.0,16120,17683,6.8,3,3,2,223,22.3,1,1,1,0,0,207,20.7,0,3,4,4,7.2,18823,14949,1494.9,1140,-1171,1
303,-459,-307,1554.8,15548,16604,6.4,5,5,8,191,19.1,0,0,1,0,1,196,19.6,1,9,7,7,6.8,16911,16007,1600.7,307,459,0
304,2673,1388,1743.2,17432,18495,7.2,8,8,12,209,20.9,0,0,1,0,1,216,21.6,1,4,2,2,6.6,17107,14759,1475.9,-1388,-2673,1
305,-251,-1675,1692.2,16922,17350,6.8,9,9,10,207,20.7,1,1,1,0,0,221,22.1,0,3,7,7,7.2,19025,17173,1717.3,1675,251,1
306,534,634,1614.2,16142,18818,7.2,5,5,5,245,24.5,0,0,1,0,1,277,27.7,2,2,2,2,6.8,18184,15608,1560.8,-634,-534,0
307,-4005,-2248,1463.0,14630,17694,6.6,2,2,2,211,21.1,1,1,0,1,0,271,27.1,0,7,8,8,7.4,19942,18635,1863.5,2248,4005,0
308,-318,86,1513.1,15131,18134,7.0,2,2,1,239,23.9,2,1,1,0,0,216,21.6,0,5,4,4,6.8,18048,15449,1544.9,-86,318,1
309,2682,2118,1769.7,17697,18512,7.2,8,8,7,203,20.3,1,0,1,0,1,165,16.5,1,5,5,5,6.6,16394,15015,1501.5,-2118,-2682,0
310,2092,1763,1611.6,16116,17653,7.0,4,4,5,244,24.4,1,1,1,0,0,191,19.1,0,2,3,3,6.4,15890,14024,1402.4,-1763,-2092,0
311,2300,2148,1848.5,18485,19949,7.4,10,10,9,228,22.8,0,0,0,1,0,187,18.7,0,6,7,7,7.2,17801,16185,1618.5,-2148,-2300,1
312,2642,1346,1698.0,16980,18593,7.0,6,6,4,241,24.1,1,1,1,0,0,188,18.8,0,5,3,3,6.6,17247,14338,1433.8,-1346,-2642,1
313,2833,220,1706.6,17066,17494,6.8,5,5,6,236,23.6,0,0,1,0,1,172,17.2,1,2,4,4,7.0,17274,14233,1423.3,-220,-2833,1
314,-336,-1059,1720.2,17202,17447,6.6,8,8,9,214,21.4,0,0,1,0,1,214,21.4,1,9,8,8,7.0,18506,17538,1753.8,1059,336,0
315,-5136,-3713,1470.2,14702,16461,6.6,1,1,2,214,21.4,1,1,0,1,0,289,28.9,0,7,8,8,7.6,20174,19838,1983.8,3713,5136,0
316,1872,3579,1869.2,18692,19886,7.4,13,13,11,238,23.8,0,0,0,1,0,215,21.5,0,11,7,7,6.6,16307,16820,1682.0,-3579,-1872,1
317,-1048,-450,1854.9,18549,16837,6.8,11,11,13,182,18.2,1,1,0,1,0,201,20.1,1,17,13,13,6.8,17287,19597,1959.7,450,1048,0
318,-88,-932,1585.9,15859,18390,7.2,4,4,3,242,24.2,1,1,0,1,0,222,22.2,0,10,5,5,7.2,19322,15947,1594.7,932,88,1
319,-1427,-1008,1604.4,16044,18226,7.0,4,4,5,224,22.4,0,0,0,1,0,243,24.3,0,6,9,9,7.2,19234,17471,1747.1,1008,1427,1
320,-2440,-1603,1594.1,15941,16613,6.8,8,8,6,180,18.0,1,0,0,1,0,219,21.9,0,15,11,11,6.8,18216,18381,1838.1,1603,2440,1
321,-1614,-2256,1567.5,15675,16844,6.6,5,5,4,229,22.9,0,0,1,0,1,215,21.5,1,12,9,9,7.2,19100,17289,1728.9,2256,1614,0
322,-1075,73,1568.2,15682,17438,6.8,4,4,2,234,23.4,1,1,0,1,0,213,21.3,0,6,7,7,6.8,17365,16757,1675.7,-73,1075,1
323,-1799,-1304,1584.3,15843,17154,6.8,7,7,7,190,19.0,2,1,1,0,0,196,19.6,0,15,8,8,6.8,18458,17642,1764.2,1304,1799,1
324,3296,3231,1824.8,18248,19855,7.4,12,12,11,201,20.1,1,1,1,0,0,201,20.1,0,3,3,3,6.4,16624,14952,1495.2,-3231,-3296,1
325,-1942,57,1533.3,15333,18073,7.0,4,4,3,201,20.1,0,0,0,1,1,236,23.6,1,5,7,7,6.8,18016,17275,1727.5,-57,1942,1
326,2013,247,1749.6,17496,18253,7.2,8,8,10,246,24.6,1,1,1,0,0,229,22.9,0,3,4,4,7.0,18006,15483,1548.3,-247,-2013,1
327,3574,1210,1980.9,19809,18530,7.0,12,12,15,221,22.1,2,1,1,0,0,166,16.6,0,11,8,8,6.8,17320,16235,1623.5,-1210,-3574,1
328,6000,5033,1932.9,19329,19021,7.0,13,13,9,246,24.6,1,1,1,0,0,142,14.2,1,5,3,3,6.0,13988,13329,1332.9,-5033,-6000,1
329,-3128,-2320,1560.0,15600,14986,6.2,5,5,2,193,19.3,0,0,0,1,0,232,23.2,1,9,9,9,6.8,17306,18728,1872.8,2320,3128,0
330,1229,1059,1629.2,16292,18889,7.2,4,4,1,274,27.4,2,1,0,1,0,220,22.0,0,2,4,4,7.0,17830,15063,1506.3,-1059,-1229,1
331,1285,1300,1767.7,17677,18225,7.0,5,5,6,269,26.9,1,0,1,0,1,173,17.3,1,9,10,10,6.6,16925,16392,1639.2,-1300,-1285,0
332,-3274,-1385,1514.1,15141,17635,6.8,5,5,6,176,17.6,0,0,0,1,1,238,23.8,1,8,10,10,7.2,19020,18415,1841.5,1385,3274,0
333,-1770,325,1489.7,14897,17306,7.0,5,5,1,212,21.2,0,0,0,1,1,191,19.1,1,9,8,8,6.8,16981,16667,1666.7,-325,1770,0
334,1892,890,1752.0,17520,18610,7.0,8,8,14,211,21.1,1,1,1,0,0,250,25.0,0,4,3,3,6.8,17720,15628,1562.8,-890,-1892,1
335,525,902,1716.4,17164,18932,7.0,8,8,9,222,22.2,0,0,1,0,0,215,21.5,0,7,7,7,6.8,18030,16639,1663.9,-902,-525,0
336,-415,-498,1599.9,15999,17033,6.6,5,5,8,234,23.4,1,1,1,0,0,226,22.6,0,8,6,6,7.0,17531,16414,1641.4,498,415,0
337,-1751,-1585,1454.2,14542,17517,6.8,2,2,1,234,23.4,0,0,0,1,1,229,22.9,1,4,6,6,7.0,19102,16293,1629.3,1585,1751,1
338,4453,2458,2022.5,20225,17976,6.6,14,14,10,194,19.4,1,0,1,0,1,189,18.9,1,6,6,6,6.6,15518,15772,1577.2,-2458,-4453,1
339,1393,441,1820.3,18203,18175,7.0,11,11,10,199,19.9,1,1,1,0,0,224,22.4,0,2,6,6,6.8,17734,16810,1681.0,-441,-1393,0
340,534,154,1678.7,16787,18618,7.2,6,6,4,253,25.3,2,1,0,1,0,197,19.7,0,10,5,5,7.2,18464,16253,1625.3,-154,-534,1
341,-3301,-2246,1495.9,14959,16588,6.8,2,2,2,226,22.6,0,0,1,0,1,203,20.3,1,18,11,11,7.4,18834,18260,1826.0,2246,3301,0
342,-2022,-2023,1513.2,15132,16489,6.8,4,4,4,190,19.0,2,1,0,1,0,242,24.2,0,7,7,7,7.2,18512,17154,1715.4,2023,2022,1
343,176,-172,1635.4,16354,17848,7.0,3,3,4,252,25.2,0,0,0,1,1,202,20.2,1,7,6,6,6.8,18020,16178,1617.8,172,-176,0
344,-458,-559,1465.2,14652,17192,6.8,2,2,2,205,20.5,1,0,0,1,1,210,21.0,1,3,5,5,6.8,17751,15110,1511.0,559,458,0
345,676,-576,1533.1,15331,17540,6.8,4,4,7,182,18.2,0,0,1,0,1,216,21.6,1,1,2,2,7.2,18116,14655,1465.5,576,-676,0
346,2536,3339,1700.2,17002,18755,7.2,6,6,5,218,21.8,1,1,0,1,0,210,21.0,1,0,4,4,6.4,15416,14466,1446.6,-3339,-2536,1
347,-1751,-2784,1630.8,16308,16771,6.8,7,7,10,189,18.9,0,0,0,1,0,200,20.0,1,9,11,11,7.4,19555,18059,1805.9,2784,1751,1
348,-1516,-1467,1628.2,16282,16826,6.8,7,7,9,198,19.8,0,0,0,1,1,201,20.1,2,10,10,10,6.8,18293,17798,1779.8,1467,1516,1
349,-2566,-2246,1411.0,14110,15832,6.4,3,3,3,162,16.2,0,0,1,0,0,228,22.8,0,3,7,7,6.8,18078,16676,1667.6,2246,2566,0
350,-2023,-2678,1542.6,15426,17467,7.0,4,4,5,226,22.6,0,0,1,0,1,251,25.1,1,4,8,8,7.4,20145,17449,1744.9,2678,2023,0
351,-276,179,1598.3,15983,17562,6.8,5,5,4,222,22.2,1,0,0,1,0,189,18.9,0,8,6,6,6.8,17383,16259,1625.9,-179,276,0
352,1574,1834,1680.1,16801,18563,7.2,7,7,5,211,21.1,2,1,1,0,0,200,20.0,0,3,4,4,6.8,16729,15227,1522.7,-1834,-1574,1
353,2378,2190,1714.1,17141,19142,7.2,6,6,10,232,23.2,0,0,0,1,1,206,20.6,1,1,3,3,6.8,16952,14763,1476.3,-2190,-2378,1
354,-3223,-2518,1512.2,15122,17694,7.0,4,4,4,195,19.5,0,0,1,0,1,235,23.5,2,10,9,9,7.4,20212,18345,1834.5,2518,3223,0
355,808,1415,1687.8,16878,19372,7.0,5,5,7,238,23.8,0,0,0,1,1,214,21.4,1,8,5,5,7.0,17957,16070,1607.0,-1415,-808,0
356,3803,2825,1827.4,18274,18615,7.0,8,8,8,238,23.8,0,0,1,0,0,201,20.1,0,6,2,2,6.4,15790,14471,1447.1,-2825,-3803,1
357,-3360,-1842,1417.6,14176,17054,6.8,2,2,3,194,19.4,0,0,0,1,1,228,22.8,1,7,8,8,7.2,18896,17536,1753.6,1842,3360,0
358,2397,1405,1754.9,17549,19231,7.2,6,6,9,243,24.3,0,0,0,1,0,248,24.8,1,1,2,2,6.8,17826,15152,1515.2,-1405,-2397,1
359,-883,-1828,1604.9,16049,16758,6.6,5,5,7,217,21.7,0,0,1,0,0,187,18.7,0,9,8,8,7.0,18586,16932,1693.2,1828,883,0
360,-2638,-2478,1401.7,14017,15893,6.4,1,1,1,229,22.9,0,0,1,0,1,231,23.1,2,5,4,4,6.8,18371,16655,1665.5,2478,2638,0
361,5035,5420,2013.9,20139,21898,7.8,14,14,16,218,21.8,0,0,1,0,0,223,22.3,0,5,3,3,6.6,16478,15104,1510.4,-5420,-5035,1
362,-1003,-899,1665.9,16659,17777,7.0,5,5,5,234,23.4,0,0,1,0,1,217,21.7,2,7,8,8,7.0,18676,17662,1766.2,899,1003,0
363,-1963,-1151,1597.5,15975,18165,6.8,5,5,4,227,22.7,0,0,1,0,1,225,22.5,1,10,8,8,7.2,19316,17938,1793.8,1151,1963,0
364,-1071,-1471,1672.8,16728,18284,7.2,6,6,7,221,22.1,0,0,0,1,1,248,24.8,1,8,7,7,7.4,19755,17799,1779.9,1471,1071,0
365,897,1090,1669.3,16693,18761,7.0,6,6,9,227,22.7,0,0,1,0,0,237,23.7,0,7,5,5,7.0,17671,15796,1579.6,-1090,-897,1
366,1946,1292,1592.5,15925,17913,6.8,5,5,4,228,22.8,2,1,1,0,0,213,21.3,0,2,2,2,6.8,16621,13979,1397.9,-1292,-1946,1
367,-219,-1440,1676.3,16763,17433,6.8,8,8,5,193,19.3,1,0,0,1,1,183,18.3,1,6,8,8,7.2,18873,16982,1698.2,1440,219,0
368,1588,1331,1685.2,16852,18660,6.8,6,6,7,239,23.9,0,0,1,0,0,213,21.3,0,7,4,4,6.8,17329,15264,1526.4,-1331,-1588,1
369,-1889,-723,1495.0,14950,18134,7.0,2,2,3,234,23.4,0,0,0,1,1,229,22.9,1,6,6,6,7.0,18857,16839,1683.9,723,1889,0
370,-720,432,1486.3,14863,17436,6.8,2,2,2,195,19.5,1,1,0,1,0,223,22.3,0,4,4,4,6.8,17004,15583,1558.3,-432,720,1
371,-2388,-1978,1585.3,15853,18223,7.0,3,3,2,220,22.0,0,0,1,0,1,205,20.5,2,8,12,12,7.6,20201,18241,1824.1,1978,2388,0
372,-5668,-4786,1342.8,13428,14121,6.0,3,3,1,167,16.7,0,0,0,1,1,218,21.8,1,10,13,13,7.0,18907,19096,1909.6,4786,5668,0
373,527,1493,1757.0,17570,18283,7.0,7,7,8,238,23.8,1,1,0,1,0,176,17.6,0,11,8,8,6.8,16790,17043,1704.3,-1493,-527,1
374,1496,-730,1656.1,16561,17961,7.0,6,6,3,232,23.2,1,0,1,0,1,191,19.1,1,4,4,4,7.0,18691,15065,1506.5,730,-1496,1
375,-4245,-3073,1507.0,15070,15375,6.4,8,8,4,142,14.2,0,0,0,1,1,193,19.3,2,12,14,14,7.0,18448,19315,1931.5,3073,4245,0
376,3386,2410,1919.0,19190,18615,7.2,10,10,17,202,20.2,1,1,1,0,0,224,22.4,1,8,5,5,6.4,16205,15804,1580.4,-2410,-3386,0
377,-3145,-2166,1426.9,14269,16844,6.6,3,3,1,200,20.0,0,0,0,1,1,235,23.5,1,10,8,8,7.2,19010,17414,1741.4,2166,3145,0
378,-1325,-15,1491.6,14916,17511,6.8,1,1,0,239,23.9,1,1,0,1,0,251,25.1,0,8,5,5,6.8,17526,16241,1624.1,15,1325,0
379,-1623,-1144,1625.6,16256,17637,7.0,5,5,7,231,23.1,2,1,0,1,0,243,24.3,0,9,8,8,7.0,18781,17879,1787.9,1144,1623,1
380,1076,759,1523.1,15231,17617,7.0,3,3,3,221,22.1,1,1,0,1,0,223,22.3,0,0,3,3,6.8,16858,14155,1415.5,-759,-1076,1
381,-1156,-667,1607.0,16070,16577,6.6,7,7,9,173,17.3,1,1,0,1,0,211,21.1,0,6,10,10,6.6,17244,17226,1722.6,667,1156,1
382,450,-9,1541.6,15416,17935,6.8,3,3,2,228,22.8,1,0,0,1,0,220,22.0,0,5,3,3,6.8,17944,14966,1496.6,9,-450,0
383,4363,4467,1903.6,19036,18857,7.0,7,7,4,246,24.6,1,0,1,0,0,164,16.4,0,4,5,5,5.8,14390,14673,1467.3,-4467,-4363,1
384,2262,2885,1821.4,18214,19670,7.2,11,11,13,220,22.0,1,1,1,0,0,228,22.8,0,6,6,6,6.6,16785,15952,1595.2,-2885,-2262,1
385,-367,187,1743.0,17430,18068,6.8,6,6,7,212,21.2,0,0,1,0,0,205,20.5,0,9,9,9,7.2,17881,17797,1779.7,-187,367,0
386,1214,2080,1659.0,16590,19041,7.2,6,6,7,228,22.8,0,0,0,1,1,224,22.4,1,2,3,3,6.8,16961,15376,1537.6,-2080,-1214,1
387,1728,-337,1550.8,15508,17062,6.8,4,4,6,217,21.7,1,1,1,0,0,223,22.3,0,0,1,1,6.8,17399,13780,1378.0,337,-1728,1
388,959,917,1678.9,16789,19024,7.0,6,6,4,218,21.8,0,0,1,0,1,213,21.3,1,5,5,5,7.0,18107,15830,1583.0,-917,-959,1
389,924,323,1629.8,16298,18210,7.0,5,5,6,230,23.0,1,0,1,0,1,209,20.9,1,5,5,5,6.8,17887,15374,1537.4,-323,-924,1
390,4544,3126,1932.0,19320,20189,7.4,12,12,13,251,25.1,1,1,1,0,0,206,20.6,0,2,2,2,6.8,17063,14776,1477.6,-3126,-4544,1
391,-4847,-2983,1492.6,14926,16530,6.6,4,4,4,210,21.0,2,1,0,1,0,218,21.8,0,12,11,11,7.4,19513,19773,1977.3,2983,4847,0
392,1849,669,1749.6,17496,18327,7.4,9,9,17,220,22.0,1,1,1,0,0,224,22.4,1,2,3,3,6.8,17658,15647,1564.7,-669,-1849,1
393,-3891,-2689,1517.7,15177,15795,6.4,7,7,7,152,15.2,0,0,0,1,0,218,21.8,0,9,11,11,7.2,18484,19068,1906.8,2689,3891,1
394,-1314,-1942,1702.5,17025,18038,7.0,6,6,8,231,23.1,0,0,1,0,1,232,23.2,1,9,9,9,7.4,19980,18339,1833.9,1942,1314,0
395,2718,91,1820.3,18203,18324,7.2,9,9,14,223,22.3,0,0,1,0,0,216,21.6,0,5,5,5,6.8,18233,15485,1548.5,-91,-2718,1
396,-2174,-1268,1516.0,15160,17505,7.0,3,3,3,217,21.7,0,0,0,1,1,227,22.7,2,12,8,8,7.2,18773,17334,1733.4,1268,2174,0
397,1093,720,1530.4,15304,18188,7.0,4,4,2,228,22.8,1,1,1,0,0,215,21.5,0,1,1,1,6.8,17468,14211,1421.1,-720,-1093,1
398,-215,-438,1750.3,17503,17699,6.8,11,11,8,192,19.2,0,0,0,1,0,210,21.0,0,13,10,10,7.0,18137,17718,1771.8,438,215,1
399,635,-1157,1646.8,16468,15869,6.4,7,7,10,226,22.6,1,0,1,0,1,228,22.8,1,6,6,6,6.8,17026,15833,1583.3,1157,-635,1
400,120,1209,1903.5,19035,18221,7.2,10,10,10,219,21.9,0,0,0,1,0,208,20.8,1,10,10,10,6.6,17012,18915,1891.5,-1209,-120,1
401,194,661,1841.3,18413,18554,7.2,10,10,11,219,21.9,1,1,0,1,0,230,23.0,0,12,9,9,6.8,17893,18219,1821.9,-661,-194,1
402,3581,1578,1847.0,18470,18925,7.2,9,9,21,263,26.3,1,1,1,0,0,238,23.8,0,1,2,2,6.8,17347,14889,1488.9,-1578,-3581,1
403,-3622,-2561,1629.1,16291,16699,6.6,6,6,9,191,19.1,0,0,0,1,0,223,22.3,0,12,13,13,7.0,19260,19913,1991.3,2561,3622,0
404,-303,312,1630.1,16301,17430,6.8,6,6,9,210,21.0,1,1,1,0,0,210,21.0,1,11,6,6,6.8,17118,16604,1660.4,-312,303,1
405,-1295,-305,1718.3,17183,18225,7.0,9,9,7,196,19.6,1,1,0,1,0,247,24.7,0,10,8,8,7.0,18530,18478,1847.8,305,1295,0
406,-3006,-1880,1336.1,13361,16819,6.8,1,1,1,174,17.4,0,0,0,1,1,219,21.9,2,4,5,5,7.0,18699,16367,1636.7,1880,3006,0
407,1090,371,1480.7,14807,17246,6.8,2,2,4,214,21.4,1,0,1,0,1,197,19.7,1,1,1,1,6.6,16875,13717,1371.7,-371,-1090,1
408,324,1794,1519.5,15195,18358,7.0,4,4,1,217,21.7,1,1,0,1,0,228,22.8,0,2,3,3,6.4,16564,14871,1487.1,-1794,-324,1
409,-2025,-2448,1478.8,14788,17345,6.6,3,3,2,215,21.5,0,0,1,0,1,233,23.3,1,6,7,7,7.2,19793,16813,1681.3,2448,2025,1
410,-416,-907,1660.4,16604,17328,6.6,7,7,8,203,20.3,0,0,1,0,1,201,20.1,1,11,8,8,7.0,18235,17020,1702.0,907,416,0
411,62,1154,1566.1,15661,18861,7.2,4,4,2,232,23.2,1,0,1,0,1,202,20.2,1,5,4,4,6.8,17707,15599,1559.9,-1154,-62,0
412,-67,-1341,1625.9,16259,17235,6.6,5,5,3,221,22.1,0,0,1,0,1,200,20.0,1,12,7,7,7.2,18576,16326,1632.6,1341,67,0
413,5163,3968,1971.6,19716,19989,7.2,11,11,13,234,23.4,1,1,0,1,0,182,18.2,0,4,4,4,6.4,16021,14553,1455.3,-3968,-5163,1
414,2728,1957,1861.2,18612,19203,7.2,11,11,18,227,22.7,1,1,1,0,0,225,22.5,0,6,5,5,7.0,17246,15884,1588.4,-1957,-2728,1
415,-3559,-1400,1471.1,14711,18284,6.8,3,3,1,204,20.4,1,1,0,1,0,256,25.6,0,7,9,9,7.2,19684,18270,1827.0,1400,3559,0
416,184,-131,1688.6,16886,18261,6.8,6,6,7,221,22.1,2,1,1,0,0,237,23.7,0,5,4,4,7.0,18392,16702,1670.2,131,-184,1
417,-2040,-1012,1498.0,14980,16983,6.4,4,4,4,206,20.6,1,1,1,0,0,224,22.4,0,6,7,7,7.0,17995,17020,1702.0,1012,2040,0
418,2151,726,1654.4,16544,17551,6.8,6,6,9,208,20.8,1,1,1,0,0,222,22.2,0,3,1,1,6.6,16825,14393,1439.3,-726,-2151,1
419,-2452,-1634,1617.4,16174,16725,6.6,10,10,9,149,14.9,0,0,0,1,0,210,21.0,0,8,12,12,7.0,18359,18626,1862.6,1634,2452,0
420,3255,2259,1804.7,18047,19362,7.2,7,7,7,228,22.8,2,1,1,0,0,197,19.7,0,3,4,4,6.8,17103,14792,1479.2,-2259,-3255,1
421,1128,858,1748.4,17484,20325,7.4,9,9,6,230,23.0,0,0,1,0,1,226,22.6,1,2,3,3,7.4,19467,16356,1635.6,-858,-1128,1
422,1909,979,1782.6,17826,19427,7.4,6,6,7,225,22.5,1,0,1,0,0,220,22.0,0,3,5,5,7.0,18448,15917,1591.7,-979,-1909,1
423,3397,1493,1867.3,18673,18121,6.8,10,10,9,223,22.3,0,0,0,1,0,186,18.6,0,8,6,6,6.6,16628,15276,1527.6,-1493,-3397,1
424,-3563,-1320,1754.0,17540,17368,7.0,8,8,11,182,18.2,0,0,0,1,1,198,19.8,1,22,12,12,7.2,18688,21103,2110.3,1320,3563,0
425,-361,1686,1680.8,16808,17370,6.8,7,7,4,231,23.1,1,1,1,0,0,214,21.4,0,13,9,9,6.4,15684,17169,1716.9,-1686,361,0
426,-513,992,1522.7,15227,18442,7.0,4,4,3,203,20.3,1,0,0,1,0,226,22.6,0,4,3,3,7.0,17450,15740,1574.0,-992,513,1
427,4872,3076,1939.2,19392,18570,7.2,11,11,12,239,23.9,0,0,0,1,0,203,20.3,0,6,4,4,6.2,15494,14520,1452.0,-3076,-4872,1
428,985,2102,1719.4,17194,18397,7.2,6,6,5,234,23.4,1,0,0,1,0,215,21.5,0,7,7,7,6.4,16295,16209,1620.9,-2102,-985,0
429,-1599,-1870,1567.2,15672,17821,7.2,4,4,3,238,23.8,1,1,1,0,0,236,23.6,1,9,8,8,7.4,19691,17271,1727.1,1870,1599,1
430,1719,1703,1856.5,18565,19562,7.4,11,11,15,216,21.6,1,1,0,1,0,242,24.2,0,5,4,4,7.0,17859,16846,1684.6,-1703,-1719,1
431,-2641,-2207,1392.1,13921,16963,6.6,1,1,0,207,20.7,0,0,0,1,0,242,24.2,1,5,6,6,7.0,19170,16562,1656.2,2207,2641,0
432,-2846,-2325,1452.1,14521,16234,6.6,3,3,2,201,20.1,0,0,1,0,1,229,22.9,2,11,9,9,7.2,18559,17367,1736.7,2325,2846,0
433,-3891,-2276,1504.9,15049,17888,6.6,3,3,1,209,20.9,0,0,0,1,1,221,22.1,1,12,10,10,7.4,20164,18940,1894.0,2276,3891,0
434,6202,5368,2012.7,20127,19575,7.0,13,13,11,234,23.4,1,1,0,1,0,175,17.5,0,5,4,4,6.0,14207,13925,1392.5,-5368,-6202,1
435,2330,2167,1719.4,17194,19539,7.2,3,3,5,253,25.3,0,0,0,1,0,219,21.9,0,3,2,2,6.8,17372,14864,1486.4,-2167,-2330,1
436,3089,1750,1912.2,19122,19334,7.2,9,9,8,238,23.8,0,0,1,0,0,169,16.9,0,10,7,7,6.8,17584,16033,1603.3,-1750,-3089,0
437,540,867,1635.9,16359,17998,7.0,7,7,7,198,19.8,0,0,0,1,0,187,18.7,0,7,6,6,6.6,17131,15819,1581.9,-867,-540,1
438,508,-1704,1702.7,17027,17816,6.8,5,5,5,213,21.3,1,0,1,0,1,231,23.1,1,4,4,4,7.4,19520,16519,1651.9,1704,-508,1
439,625,-1035,1766.5,17665,18125,7.4,10,10,10,213,21.3,1,1,1,0,0,228,22.8,0,4,7,7,7.2,19160,17040,1704.0,1035,-625,0
440,2481,1962,1720.9,17209,18853,7.2,8,8,7,219,21.9,1,1,1,0,0,195,19.5,0,3,5,5,6.8,16891,14728,1472.8,-1962,-2481,1
441,2796,2669,1918.7,19187,19762,7.2,10,10,9,211,21.1,1,1,1,0,0,205,20.5,0,5,5,5,6.6,17093,16391,1639.1,-2669,-2796,1
442,2089,2123,1748.2,17482,19093,7.2,9,9,7,214,21.4,1,1,0,1,0,222,22.2,0,4,4,4,6.8,16970,15393,1539.3,-2123,-2089,1
443,-608,-703,1603.5,16035,16853,6.8,5,5,6,190,19.0,1,1,1,0,0,210,21.0,0,8,6,6,6.8,17556,16643,1664.3,703,608,1
444,-1923,-1753,1607.0,16070,16510,6.6,7,7,6,199,19.9,0,0,1,0,0,211,21.1,0,11,9,9,7.0,18263,17993,1799.3,1753,1923,0
445,-951,-546,1561.7,15617,18169,7.0,5,5,5,209,20.9,0,0,0,1,1,206,20.6,1,5,5,5,7.2,18715,16568,1656.8,546,951,0
446,1428,701,1613.0,16130,17156,6.8,6,6,8,242,24.2,1,1,1,0,0,200,20.0,0,6,4,4,6.6,16455,14702,1470.2,-701,-1428,1
447,1131,1145,1717.2,17172,18972,7.0,8,8,9,196,19.6,1,1,1,0,0,231,23.1,1,5,5,5,6.8,17827,16041,1604.1,-1145,-1131,0
448,-1972,-1010,1547.5,15475,16428,6.6,4,4,4,195,19.5,1,0,0,1,0,230,23.0,0,15,7,7,6.8,17438,17447,1744.7,1010,1972,0
449,-2242,-1819,1624.8,16248,18067,7.0,7,7,6,171,17.1,0,0,1,0,1,229,22.9,1,12,9,9,7.2,19886,18490,1849.0,1819,2242,0
450,2287,-268,1674.5,16745,17908,6.6,6,6,10,215,21.5,1,1,1,0,0,180,18.0,1,3,3,3,7.0,18176,14458,1445.8,268,-2287,1
451,1367,2396,1647.2,16472,18966,7.2,7,7,8,219,21.9,0,0,0,1,0,180,18.0,1,4,4,4,6.6,16570,15105,1510.5,-2396,-1367,0
452,2580,2954,1813.3,18133,20427,7.4,8,8,8,259,25.9,2,1,1,0,0,214,21.4,0,4,4,4,6.8,17473,15553,1555.3,-2954,-2580,1
453,786,-562,1706.8,17068,15357,6.2,11,11,20,153,15.3,1,1,0,1,0,199,19.9,0,8,7,7,6.6,15919,16282,1628.2,562,-786,0
454,152,-57,1663.5,16635,19221,7.4,5,5,5,235,23.5,2,1,1,0,0,233,23.3,0,10,6,6,7.4,19278,16483,1648.3,57,-152,1
455,2802,281,1795.0,17950,18805,7.4,8,8,9,226,22.6,0,0,1,0,1,213,21.3,1,3,4,4,7.0,18524,15148,1514.8,-281,-2802,1
456,-1610,-1393,1449.4,14494,15922,6.4,3,3,3,224,22.4,0,0,0,1,1,239,23.9,1,2,4,4,6.8,17315,16104,1610.4,1393,1610,0
457,1543,-21,1859.5,18595,18307,7.0,14,14,9,199,19.9,0,0,0,1,1,172,17.2,1,8,10,10,7.0,18328,17052,1705.2,21,-1543,1
458,1915,2606,1976.7,19767,17678,6.6,15,15,14,180,18.0,0,0,0,1,0,176,17.6,0,11,11,11,6.4,15072,17852,1785.2,-2606,-1915,1
459,-595,364,1497.0,14970,17530,6.8,4,4,7,212,21.2,1,1,0,1,0,238,23.8,0,1,3,3,6.8,17166,15565,1556.5,-364,595,1
460,-1190,-911,1589.1,15891,17964,7.0,6,6,5,207,20.7,0,0,1,0,0,224,22.4,0,4,7,7,7.0,18875,17081,1708.1,911,1190,0
461,1820,806,1647.2,16472,18393,6.8,5,5,3,252,25.2,1,0,1,0,1,239,23.9,1,2,1,1,6.8,17587,14652,1465.2,-806,-1820,1
462,-2630,-2244,1521.0,15210,17099,6.8,4,4,3,185,18.5,2,1,0,1,0,222,22.2,0,6,7,7,7.2,19343,17840,1784.0,2244,2630,0
463,-1327,-789,1609.6,16096,16891,6.6,8,8,9,175,17.5,0,0,0,1,1,198,19.8,1,9,8,8,6.8,17680,17423,1742.3,789,1327,1
464,1417,1016,1687.0,16870,18433,7.2,8,8,10,207,20.7,0,0,0,1,0,221,22.1,1,3,4,4,6.8,17417,15453,1545.3,-1016,-1417,1
465,71,409,1584.2,15842,18640,7.0,4,4,3,240,24.0,1,1,1,0,0,227,22.7,0,6,4,4,7.0,18231,15771,1577.1,-409,-71,0
466,17,1052,1529.7,15297,18319,7.0,5,5,0,202,20.2,0,0,0,1,1,210,21.0,1,2,4,4,6.6,17267,15280,1528.0,-1052,-17,1
467,151,840,1641.2,16412,18381,7.0,8,8,8,212,21.2,2,1,1,0,0,212,21.2,0,5,7,7,7.0,17541,16261,1626.1,-840,-151,0
468,4817,3220,1901.3,19013,20151,7.4,10,10,9,225,22.5,1,1,1,0,0,184,18.4,1,3,3,3,6.8,16931,14196,1419.6,-3220,-4817,1
469,-3400,-2763,1484.2,14842,16718,6.6,4,4,5,203,20.3,0,0,0,1,1,241,24.1,1,11,9,9,7.2,19481,18242,1824.2,2763,3400,0
470,-944,-556,1668.4,16684,17071,6.8,6,6,5,213,21.3,0,0,1,0,1,187,18.7,1,15,8,8,6.8,17627,17628,1762.8,556,944,0
471,-2839,18,1523.5,15235,17625,6.6,4,4,6,195,19.5,1,1,0,1,0,220,22.0,1,6,8,8,7.0,17607,18074,1807.4,-18,2839,0
472,818,-165,1815.9,18159,17740,6.8,11,11,14,238,23.8,1,1,1,0,0,192,19.2,0,10,8,8,6.8,17905,17341,1734.1,165,-818,1
473,-6286,-4733,1391.6,13916,15087,6.2,2,2,4,166,16.6,0,0,0,1,1,259,25.9,2,8,9,9,7.6,19820,20202,2020.2,4733,6286,0
474,-3799,-3285,1510.7,15107,16753,6.6,4,4,3,200,20.0,0,0,0,1,1,226,22.6,1,10,11,11,7.2,20038,18906,1890.6,3285,3799,0
475,4428,3489,1859.7,18597,19612,7.2,8,8,4,243,24.3,2,1,0,1,0,221,22.1,0,2,2,2,6.6,16123,14169,1416.9,-3489,-4428,1
476,4388,3527,1864.0,18640,20923,7.4,9,9,9,249,24.9,0,0,1,0,1,221,22.1,1,1,1,1,6.8,17396,14252,1425.2,-3527,-4388,1
477,-3045,-1634,1548.3,15483,17110,6.6,4,4,5,213,21.3,1,1,0,1,0,249,24.9,0,11,8,8,7.2,18744,18528,1852.8,1634,3045,0
478,-1497,-778,1524.2,15242,18202,7.0,2,2,3,260,26.0,0,0,0,1,0,257,25.7,1,9,4,4,7.2,18980,16739,1673.9,778,1497,0
479,-1696,-2153,1494.5,14945,16491,6.4,3,3,5,215,21.5,1,1,0,1,0,226,22.6,0,3,4,4,7.0,18644,16641,1664.1,2153,1696,0
480,733,-1480,1719.7,17197,16987,6.8,8,8,8,185,18.5,0,0,0,1,0,245,24.5,1,4,7,7,7.0,18467,16464,1646.4,1480,-733,1
481,-606,-1487,1729.2,17292,17127,6.8,9,9,11,200,20.0,1,1,1,0,0,197,19.7,0,10,10,10,7.0,18614,17898,1789.8,1487,606,1
482,-2420,-753,1482.2,14822,18244,7.0,3,3,3,231,23.1,0,0,0,1,0,246,24.6,1,5,5,5,7.0,18997,17242,1724.2,753,2420,0
483,-2037,110,1502.7,15027,17054,6.6,3,3,2,211,21.1,0,0,0,1,1,197,19.7,1,11,8,8,6.6,16944,17064,1706.4,-110,2037,0
484,631,1404,1550.2,15502,17035,6.6,4,4,3,221,22.1,0,0,0,1,1,207,20.7,1,5,4,4,6.4,15631,14871,1487.1,-1404,-631,1
485,-1570,-2103,1693.1,16931,18446,7.2,7,7,6,209,20.9,1,0,0,1,1,228,22.8,1,9,7,7,7.6,20549,18501,1850.1,2103,1570,0
486,-471,870,1678.7,16787,18466,7.2,7,7,11,201,20.1,1,1,0,1,0,229,22.9,0,9,7,7,6.6,17596,17258,1725.8,-870,471,1
487,-1211,-108,1502.2,15022,18105,7.0,3,3,4,220,22.0,0,0,0,1,0,216,21.6,0,5,4,4,6.8,18213,16233,1623.3,108,1211,1
488,2740,1708,1736.5,17365,19227,7.2,7,7,6,245,24.5,1,0,1,0,1,213,21.3,1,4,2,2,7.0,17519,14625,1462.5,-1708,-2740,1
489,1947,2521,1765.8,17658,19584,7.2,6,6,7,241,24.1,1,0,0,1,0,247,24.7,0,6,4,4,6.8,17063,15711,1571.1,-2521,-1947,1
490,4712,3798,1954.9,19549,20404,7.4,10,10,8,266,26.6,0,0,1,0,0,203,20.3,0,1,3,3,6.4,16606,14837,1483.7,-3798,-4712,1
491,1115,1256,1651.6,16516,19033,7.2,5,5,6,224,22.4,1,1,1,0,0,209,20.9,0,3,4,4,7.2,17777,15401,1540.1,-1256,-1115,0
492,-833,-116,1517.7,15177,18017,6.8,4,4,5,189,18.9,0,0,0,1,0,252,25.2,0,5,5,5,7.0,18133,16010,1601.0,116,833,1
493,564,633,1852.0,18520,19054,7.2,11,11,9,220,22.0,0,0,0,1,1,226,22.6,1,7,7,7,6.8,18421,17956,1795.6,-633,-564,1
494,-589,1794,1860.0,18600,19763,7.2,10,10,11,183,18.3,1,0,1,0,0,223,22.3,0,8,10,10,7.0,17969,19189,1918.9,-1794,589,0
495,3020,2593,1843.9,18439,19278,7.0,9,9,8,249,24.9,0,0,1,0,0,211,21.1,0,8,4,4,6.6,16685,15419,1541.9,-2593,-3020,1
496,-1339,-2802,1563.2,15632,15789,6.2,7,7,8,196,19.6,1,1,1,0,0,216,21.6,1,8,6,6,7.0,18591,16971,1697.1,2802,1339,1
497,1487,577,1716.1,17161,17817,7.0,10,10,17,157,15.7,1,1,1,0,0,203,20.3,1,3,4,4,6.6,17240,15674,1567.4,-577,-1487,0
498,579,-37,1526.3,15263,17693,7.0,5,5,5,216,21.6,2,1,1,0,0,245,24.5,0,1,3,3,7.0,17730,14684,1468.4,37,-579,1
499,975,659,1639.6,16396,17294,6.6,9,9,8,168,16.8,0,0,1,0,0,191,19.1,0,4,6,6,6.6,16635,15421,1542.1,-659,-975,1
500,1417,1171,1759.2,17592,17430,6.8,10,10,11,186,18.6,1,1,1,0,0,220,22.0,0,11,6,6,6.6,16259,16175,1617.5,-1171,-1417,1
501,2768,1411,1780.2,17802,18461,7.0,6,6,9,239,23.9,2,1,1,0,0,211,21.1,0,3,4,4,6.8,17050,15034,1503.4,-1411,-2768,1
502,3897,2558,2004.7,20047,19339,7.2,13,13,25,226,22.6,0,0,1,0,1,199,19.9,1,7,6,6,6.6,16781,16150,1615.0,-2558,-3897,1
503,-4631,-3612,1379.5,13795,16505,6.6,2,2,4,203,20.3,0,0,0,1,1,229,22.9,1,11,9,9,7.4,20117,18426,1842.6,3612,4631,0
504,-46,-458,1571.4,15714,17852,6.8,4,4,4,243,24.3,0,0,0,1,1,193,19.3,2,4,5,5,7.2,18310,15760,1576.0,458,46,0
505,-258,-419,1641.8,16418,17847,7.0,2,2,2,243,24.3,0,0,0,1,1,211,21.1,1,9,7,7,7.0,18266,16676,1667.6,419,258,0
506,2845,4032,1801.2,18012,19378,7.2,9,9,8,261,26.1,1,1,0,1,0,185,18.5,0,4,3,3,6.2,15346,15167,1516.7,-4032,-2845,1
507,-3177,-3271,1455.8,14558,15833,6.4,3,3,3,194,19.4,0,0,0,1,1,207,20.7,1,11,10,10,7.2,19104,17735,1773.5,3271,3177,0
508,2988,398,1777.9,17779,18276,6.8,8,8,9,247,24.7,1,1,1,0,0,210,21.0,0,1,4,4,7.0,17878,14791,1479.1,-398,-2988,1
509,2443,1566,1693.1,16931,18085,7.0,6,6,5,225,22.5,1,1,1,0,0,201,20.1,0,4,3,3,6.4,16519,14488,1448.8,-1566,-2443,1
510,-11,-176,1655.5,16555,18782,6.8,6,6,5,224,22.4,2,1,1,0,0,227,22.7,0,5,5,5,7.4,18958,16566,1656.6,176,11,1
511,286,17,1689.1,16891,18030,6.8,5,5,8,185,18.5,1,1,0,1,0,214,21.4,0,12,6,6,6.8,18013,16605,1660.5,-17,-286,1
512,90,-819,1694.0,16940,17580,6.8,6,6,6,222,22.2,2,1,1,0,0,219,21.9,0,5,7,7,7.0,18399,16850,1685.0,819,-90,0
513,403,1790,1724.2,17242,19085,7.2,7,7,5,236,23.6,0,0,0,1,0,216,21.6,0,9,6,6,6.8,17295,16839,1683.9,-1790,-403,1
514,3135,2622,1773.4,17734,19335,7.4,8,8,12,207,20.7,0,0,1,0,0,228,22.8,0,2,1,1,6.6,16713,14599,1459.9,-2622,-3135,1
515,372,160,1798.2,17982,18544,7.2,10,10,11,204,20.4,0,0,0,1,1,223,22.3,1,8,8,8,7.0,18384,17610,1761.0,-160,-372,0
516,-1636,-872,1616.2,16162,18095,7.0,6,6,10,211,21.1,1,1,0,1,0,226,22.6,0,14,8,8,7.2,18967,17798,1779.8,872,1636,1
517,5586,4058,1857.4,18574,19415,7.2,12,12,11,227,22.7,2,1,1,0,0,187,18.7,0,1,1,1,6.4,15357,12988,1298.8,-4058,-5586,1
518,-2105,-1094,1512.3,15123,17214,6.8,2,2,3,232,23.2,0,0,0,1,1,234,23.4,1,6,5,5,6.8,18308,17228,1722.8,1094,2105,0
519,-1374,-653,1607.5,16075,18425,7.0,6,6,4,211,21.1,1,0,0,1,1,237,23.7,1,8,8,8,7.2,19078,17449,1744.9,653,1374,1
520,-2166,-2885,1444.3,14443,16433,6.6,3,3,4,198,19.8,0,0,0,1,0,188,18.8,1,5,8,8,7.0,19318,16609,1660.9,2885,2166,0
521,930,275,1665.6,16656,18582,7.2,5,5,4,252,25.2,0,0,0,1,0,205,20.5,0,6,4,4,7.2,18307,15726,1572.6,-275,-930,1
522,-950,-650,1593.8,15938,17247,6.8,5,5,5,196,19.6,1,1,0,1,0,185,18.5,0,8,8,8,6.8,17897,16888,1688.8,650,950,0
523,-2421,-1685,1411.6,14116,16837,6.8,1,1,2,217,21.7,1,1,1,0,0,264,26.4,1,2,2,2,6.8,18522,16537,1653.7,1685,2421,1
524,-891,-633,1705.4,17054,17591,7.0,8,8,10,211,21.1,0,0,0,1,1,219,21.9,1,13,9,9,7.0,18224,17945,1794.5,633,891,1
525,-211,232,1530.6,15306,17734,7.2,4,4,2,226,22.6,0,0,0,1,1,202,20.2,1,7,5,5,7.0,17502,15517,1551.7,-232,211,1
526,-405,-1523,1619.3,16193,18763,7.0,4,4,5,235,23.5,0,0,1,0,1,248,24.8,2,7,5,5,7.4,20286,16598,1659.8,1523,405,1
527,2361,2502,1812.6,18126,18581,7.2,10,10,8,222,22.2,0,0,1,0,1,176,17.6,1,4,7,7,6.2,16079,15765,1576.5,-2502,-2361,1
528,-134,-565,1759.2,17592,17635,6.8,8,8,11,214,21.4,1,1,0,1,0,221,22.1,0,10,9,9,7.0,18200,17726,1772.6,565,134,1
529,2062,1120,1628.2,16282,16018,6.4,7,7,16,173,17.3,1,1,1,0,0,174,17.4,0,9,4,4,6.4,14898,14220,1422.0,-1120,-2062,1
530,2089,1771,1716.7,17167,18274,6.8,6,6,7,247,24.7,1,0,1,0,1,202,20.2,1,4,3,3,6.4,16503,15078,1507.8,-1771,-2089,1
531,-5377,-3249,1567.9,15679,16096,6.4,7,7,6,172,17.2,0,0,0,1,1,230,23.0,2,22,16,16,7.2,19345,21056,2105.6,3249,5377,0
532,-282,-79,1604.5,16045,17256,6.8,7,7,5,216,21.6,1,1,1,0,0,182,18.2,1,9,7,7,7.0,17335,16327,1632.7,79,282,1
533,-443,-447,1656.4,16564,18202,7.0,6,6,8,213,21.3,0,0,0,1,0,216,21.6,0,4,7,7,7.0,18649,17007,1700.7,447,443,0
534,-3122,-1229,1437.6,14376,17660,6.8,2,2,3,208,20.8,0,0,0,1,0,231,23.1,0,8,8,8,7.0,18889,17498,1749.8,1229,3122,0
535,-2425,-1778,1412.8,14128,16843,6.6,2,2,1,214,21.4,1,1,0,1,0,233,23.3,0,4,5,5,7.2,18621,16553,1655.3,1778,2425,0
536,-813,840,1458.4,14584,17432,6.8,3,3,2,201,20.1,0,0,0,1,1,195,19.5,1,5,5,5,6.6,16592,15397,1539.7,-840,813,1
537,1378,1678,1845.7,18457,19590,7.2,9,9,8,218,21.8,0,0,0,1,1,219,21.9,2,5,8,8,6.8,17912,17079,1707.9,-1678,-1378,1
538,1542,1059,1828.2,18282,19001,7.0,7,7,6,240,24.0,0,0,0,1,1,212,21.2,1,7,7,7,7.0,17942,16740,1674.0,-1059,-1542,0
539,-1553,-424,1713.0,17130,18060,7.0,7,7,10,232,23.2,0,0,0,1,1,247,24.7,1,16,11,11,7.0,18484,18683,1868.3,424,1553,0
540,4250,2686,1775.9,17759,19034,7.4,8,8,12,249,24.9,1,1,1,0,0,223,22.3,0,0,0,0,6.4,16348,13509,1350.9,-2686,-4250,1
541,2772,2140,1719.4,17194,18529,7.2,8,8,7,197,19.7,1,0,1,0,0,188,18.8,0,3,3,3,6.6,16389,14422,1442.2,-2140,-2772,1
542,-484,-1416,1652.7,16527,18240,7.0,6,6,8,225,22.5,1,1,1,0,0,221,22.1,0,5,6,6,7.4,19656,17011,1701.1,1416,484,1
543,1110,-544,1791.5,17915,18641,7.0,7,7,12,223,22.3,2,1,1,0,0,235,23.5,0,6,4,4,7.2,19185,16805,1680.5,544,-1110,1
544,1467,11,1761.0,17610,18110,6.8,5,5,6,232,23.2,1,0,0,1,1,222,22.2,1,6,4,4,7.0,18099,16143,1614.3,-11,-1467,0
545,1095,94,1945.3,19453,18043,6.8,12,12,20,165,16.5,2,1,1,0,0,227,22.7,0,17,10,10,6.8,17949,18358,1835.8,-94,-1095,1
546,5169,2153,1877.2,18772,18771,7.2,7,7,5,255,25.5,1,1,1,0,0,200,20.0,0,1,1,1,6.6,16618,13603,1360.3,-2153,-5169,1
547,-1547,-916,1462.6,14626,17441,6.6,1,1,3,229,22.9,0,0,0,1,1,246,24.6,2,4,3,3,7.2,18357,16173,1617.3,916,1547,0
548,5680,2175,2038.7,20387,18610,7.0,13,13,21,232,23.2,0,0,1,0,1,196,19.6,1,4,3,3,6.4,16435,14707,1470.7,-2175,-5680,1
549,823,-164,1725.6,17256,18564,7.0,6,6,6,236,23.6,0,0,1,0,0,230,23.0,0,7,6,6,7.0,18728,16433,1643.3,164,-823,0
550,1799,442,1660.1,16601,18535,7.0,6,6,8,231,23.1,2,1,1,0,0,231,23.1,0,1,1,1,6.8,18093,14802,1480.2,-442,-1799,1
551,-757,569,1467.2,14672,17598,6.8,1,1,1,247,24.7,1,0,0,1,1,242,24.2,1,3,3,3,6.6,17029,15429,1542.9,-569,757,0
552,91,-339,1700.1,17001,17576,6.8,8,8,9,187,18.7,1,1,1,0,0,237,23.7,0,6,6,6,7.0,17915,16910,1691.0,339,-91,1
553,-1538,-370,1821.3,18213,18240,6.8,8,8,6,217,21.7,1,0,0,1,1,225,22.5,1,16,11,11,7.2,18610,19751,1975.1,370,1538,0
554,2228,1524,1986.2,19862,20693,7.8,10,10,9,252,25.2,2,1,0,1,0,228,22.8,0,8,8,8,7.2,19169,17634,1763.4,-1524,-2228,1
555,4869,3243,1817.9,18179,19225,7.2,9,9,10,242,24.2,0,0,1,0,1,210,21.0,1,0,1,1,6.4,15982,13310,1331.0,-3243,-4869,0
556,640,-120,1579.6,15796,17499,6.8,4,4,7,234,23.4,0,0,0,1,0,236,23.6,0,4,2,2,7.0,17619,15156,1515.6,120,-640,1
557,-1871,-1775,1537.7,15377,16348,6.6,6,6,7,177,17.7,0,0,0,1,0,227,22.7,0,6,9,9,7.0,18123,17248,1724.8,1775,1871,1
558,-2189,-1838,1487.4,14874,16128,6.6,5,5,4,182,18.2,0,0,0,1,1,207,20.7,1,7,7,7,6.8,17966,17063,1706.3,1838,2189,0
559,474,-775,1778.0,17780,17456,6.6,7,7,8,245,24.5,0,0,1,0,0,207,20.7,0,10,9,9,7.0,18231,17306,1730.6,775,-474,0
560,-1072,-646,1680.4,16804,16732,6.6,7,7,8,184,18.4,0,0,0,1,0,194,19.4,0,16,12,12,7.0,17378,17876,1787.6,646,1072,0
561,-2817,-1700,1737.2,17372,17530,6.8,7,7,9,202,20.2,0,0,1,0,1,218,21.8,1,17,13,13,7.2,19230,20189,2018.9,1700,2817,0
562,-243,-465,1516.2,15162,16973,6.6,4,4,7,195,19.5,1,1,0,1,0,235,23.5,0,4,3,3,6.6,17438,15405,1540.5,465,243,1
563,-1517,-1565,1474.2,14742,16390,6.6,3,3,7,202,20.2,1,1,0,1,0,255,25.5,0,5,3,3,7.0,17955,16259,1625.9,1565,1517,0
564,-3205,-3400,1307.8,13078,15827,6.2,0,0,0,184,18.4,0,0,0,1,1,210,21.0,1,4,6,6,7.4,19227,16283,1628.3,3400,3205,0
565,-2820,-2751,1388.6,13886,17234,6.6,2,2,4,203,20.3,0,0,0,1,1,255,25.5,1,1,5,5,7.4,19985,16706,1670.6,2751,2820,0
566,1722,1010,1663.2,16632,16709,6.8,7,7,13,212,21.2,1,1,1,0,0,224,22.4,0,4,3,3,6.2,15699,14910,1491.0,-1010,-1722,1
567,1978,1595,1721.5,17215,19549,7.0,6,6,5,264,26.4,2,1,1,0,0,199,19.9,0,2,2,2,7.0,17954,15237,1523.7,-1595,-1978,1
568,171,618,1752.8,17528,18271,7.0,11,11,8,191,19.1,0,0,1,0,0,209,20.9,0,10,9,9,6.6,17653,17357,1735.7,-618,-171,1
569,659,405,1655.5,16555,19152,7.2,5,5,9,252,25.2,1,1,0,1,0,238,23.8,1,3,3,3,7.0,18747,15896,1589.6,-405,-659,0
570,-2974,-2746,1524.6,15246,16135,6.6,6,6,7,174,17.4,1,1,0,1,0,198,19.8,1,9,11,11,7.2,18881,18220,1822.0,2746,2974,1
571,-3078,-3306,1403.3,14033,15049,6.2,3,3,3,184,18.4,0,0,0,1,1,204,20.4,1,10,9,9,7.4,18355,17111,1711.1,3306,3078,0
572,1153,282,1677.8,16778,17473,7.0,7,7,6,205,20.5,0,0,1,0,1,203,20.3,1,9,6,6,6.6,17191,15625,1562.5,-282,-1153,0
573,3878,2862,1896.0,18960,20136,7.4,11,11,8,225,22.5,2,1,1,0,0,204,20.4,0,3,5,5,6.8,17274,15082,1508.2,-2862,-3878,1
574,2717,1557,1706.5,17065,18930,7.0,5,5,5,220,22.0,2,1,1,0,0,227,22.7,0,1,1,1,7.0,17373,14348,1434.8,-1557,-2717,1
575,3038,3164,1828.3,18283,19207,7.4,9,9,8,243,24.3,0,0,1,0,1,147,14.7,1,5,7,7,6.4,16043,15245,1524.5,-3164,-3038,1
576,-1903,-584,1519.0,15190,16345,6.6,4,4,6,196,19.6,0,0,0,1,1,206,20.6,1,14,7,7,6.6,16929,17093,1709.3,584,1903,0
577,3518,2843,1819.2,18192,18534,6.8,9,9,8,229,22.9,0,0,1,0,1,188,18.8,1,7,5,5,6.4,15691,14674,1467.4,-2843,-3518,1
578,216,259,1732.9,17329,17342,6.8,7,7,12,212,21.2,0,0,0,1,0,181,18.1,0,12,7,7,6.8,17083,17113,1711.3,-259,-216,1
579,-509,-196,1642.2,16422,18934,7.0,5,5,3,247,24.7,0,0,1,0,1,218,21.8,1,8,8,8,6.8,19130,16931,1693.1,196,509,0
580,978,372,1738.5,17385,18061,7.0,9,9,14,208,20.8,0,0,0,1,0,226,22.6,1,7,6,6,7.0,17689,16407,1640.7,-372,-978,0
581,1884,1871,1666.3,16663,18021,7.0,11,11,9,188,18.8,1,1,1,0,0,208,20.8,0,2,3,3,6.4,16150,14779,1477.9,-1871,-1884,1
582,2224,2062,1790.2,17902,18882,7.2,10,10,13,186,18.6,1,0,1,0,1,208,20.8,1,7,4,4,6.6,16820,15678,1567.8,-2062,-2224,1
583,-1079,252,1739.8,17398,18429,7.0,8,8,9,206,20.6,1,0,0,1,1,233,23.3,1,7,11,11,7.0,18177,18477,1847.7,-252,1079,0
584,-1768,-1778,1553.2,15532,17712,6.8,5,5,6,201,20.1,0,0,0,1,1,253,25.3,2,8,7,7,7.4,19490,17300,1730.0,1778,1768,0
585,-886,-476,1541.2,15412,17010,6.8,6,6,4,197,19.7,1,1,0,1,0,205,20.5,0,8,6,6,6.8,17486,16298,1629.8,476,886,0
586,3017,1450,1771.8,17718,18091,7.0,9,9,16,209,20.9,0,0,1,0,0,197,19.7,0,2,3,3,6.8,16641,14701,1470.1,-1450,-3017,1
587,-431,120,1705.5,17055,17918,7.0,8,8,9,199,19.9,1,1,1,0,0,221,22.1,0,13,8,8,7.0,17798,17486,1748.6,-120,431,0
588,-2618,-2637,1602.0,16020,17180,6.8,6,6,6,215,21.5,0,0,0,1,0,212,21.2,0,7,12,12,7.6,19817,18638,1863.8,2637,2618,0
589,-740,-665,1625.4,16254,17969,7.0,6,6,6,203,20.3,2,1,1,0,0,238,23.8,0,9,6,6,7.0,18634,16994,1699.4,665,740,0
590,3982,3457,1920.1,19201,18883,7.2,12,12,13,214,21.4,1,0,1,0,0,182,18.2,0,7,5,5,6.2,15426,15219,1521.9,-3457,-3982,1
591,-2028,-1740,1599.4,15994,17730,6.8,5,5,6,211,21.1,0,0,0,1,1,242,24.2,1,7,10,10,7.2,19470,18022,1802.2,1740,2028,0
592,5649,3668,2035.2,20352,19537,7.4,10,10,8,232,23.2,1,0,0,1,1,200,20.0,1,6,4,4,6.4,15869,14703,1470.3,-3668,-5649,1
593,-4949,-4010,1275.6,12756,16250,6.4,0,0,0,190,19.0,0,0,0,1,1,253,25.3,2,7,9,9,7.4,20260,17705,1770.5,4010,4949,0
594,4867,4211,1866.1,18661,19718,7.4,8,8,5,233,23.3,2,1,1,0,0,169,16.9,0,7,3,3,6.6,15507,13794,1379.4,-4211,-4867,1
595,-978,-226,1548.8,15488,18660,6.8,2,2,2,265,26.5,2,1,0,1,0,220,22.0,0,8,6,6,7.2,18886,16466,1646.6,226,978,0
596,2425,1426,1754.7,17547,18409,7.0,8,8,9,214,21.4,0,0,0,1,0,233,23.3,0,6,4,4,6.6,16983,15122,1512.2,-1426,-2425,0
597,3815,2726,1918.9,19189,20302,7.4,12,12,11,227,22.7,1,1,1,0,0,203,20.3,0,5,6,6,6.6,17576,15374,1537.4,-2726,-3815,1
598,976,2257,1674.9,16749,18142,7.0,7,7,4,192,19.2,1,1,1,0,0,209,20.9,0,8,5,5,6.6,15885,15773,1577.3,-2257,-976,1
599,862,-426,1621.4,16214,18139,7.2,5,5,6,257,25.7,1,1,1,0,0,219,21.9,0,3,4,4,7.0,18565,15352,1535.2,426,-862,1
600,-403,-26,1550.0,15500,18238,7.0,4,4,6,216,21.6,0,0,1,0,1,242,24.2,1,3,3,3,7.0,18264,15903,1590.3,26,403,0
601,-2204,-1476,1473.5,14735,17898,7.0,2,2,3,219,21.9,0,0,0,1,0,243,24.3,1,5,6,6,7.2,19374,16939,1693.9,1476,2204,0
602,-219,-1275,1748.9,17489,16724,6.6,9,9,11,221,22.1,1,1,1,0,0,226,22.6,0,13,9,9,6.8,17999,17708,1770.8,1275,219,1
603,5330,4040,2038.0,20380,20228,7.2,16,16,16,230,23.0,1,0,1,0,1,173,17.3,1,3,5,5,6.6,16188,15050,1505.0,-4040,-5330,1
604,3414,1608,1804.8,18048,19194,7.0,9,9,12,227,22.7,2,1,1,0,0,237,23.7,0,1,4,4,6.8,17586,14634,1463.4,-1608,-3414,1
605,792,-622,1584.3,15843,16776,6.6,5,5,4,220,22.0,0,0,1,0,0,185,18.5,0,4,4,4,6.8,17398,15051,1505.1,622,-792,0
606,-146,-399,1681.0,16810,18437,7.0,4,4,5,224,22.4,0,0,1,0,1,235,23.5,2,8,7,7,7.0,18836,16956,1695.6,399,146,1
607,-1578,-1724,1520.4,15204,17694,7.0,5,5,5,182,18.2,1,0,1,0,0,250,25.0,0,8,5,5,7.2,19418,16782,1678.2,1724,1578,0
608,-769,-701,1600.6,16006,18385,7.0,5,5,5,225,22.5,0,0,1,0,1,235,23.5,1,5,6,6,7.0,19086,16775,1677.5,701,769,1
609,1860,1798,1674.6,16746,17690,7.0,6,6,6,204,20.4,0,0,0,1,0,225,22.5,0,5,3,3,6.4,15892,14886,1488.6,-1798,-1860,1
610,3525,2979,1764.8,17648,18419,7.2,10,10,8,181,18.1,0,0,1,0,0,183,18.3,0,4,3,3,6.4,15440,14123,1412.3,-2979,-3525,1
611,679,-305,1804.7,18047,18071,7.0,12,12,18,202,20.2,1,1,1,0,0,206,20.6,1,7,8,8,7.0,18376,17368,1736.8,305,-679,1
612,-2555,-1896,1397.6,13976,17001,6.6,1,1,1,210,21.0,0,0,0,1,1,234,23.4,1,4,5,5,7.2,18897,16531,1653.1,1896,2555,0
613,765,425,1726.4,17264,18859,7.2,11,11,5,196,19.6,0,0,1,0,1,212,21.2,2,4,6,6,7.2,18434,16499,1649.9,-425,-765,0
614,-1221,-2380,1676.7,16767,18062,7.0,6,6,6,228,22.8,0,0,1,0,1,252,25.2,2,7,8,8,7.4,20442,17988,1798.8,2380,1221,0
615,4492,3211,1948.8,19488,20329,7.4,10,10,10,230,23.0,0,0,0,1,1,181,18.1,1,3,6,6,6.8,17118,14996,1499.6,-3211,-4492,1
616,186,-273,1587.5,15875,17351,6.8,3,3,4,241,24.1,0,0,0,1,0,232,23.2,0,4,4,4,7.2,17624,15689,1568.9,273,-186,0
617,1227,996,1771.7,17717,19042,7.4,8,8,7,203,20.3,1,1,1,0,0,225,22.5,0,8,7,7,6.8,18046,16490,1649.0,-996,-1227,1
618,-70,-456,1686.4,16864,19251,7.0,5,5,1,240,24.0,1,0,0,1,1,223,22.3,1,5,7,7,7.6,19707,16934,1693.4,456,70,1
619,-1605,-1335,1478.8,14788,17425,7.0,3,3,3,227,22.7,0,0,0,1,0,252,25.2,0,4,4,4,7.2,18760,16393,1639.3,1335,1605,0
620,-3465,-3351,1474.3,14743,15965,6.4,4,4,4,197,19.7,0,0,0,1,1,224,22.4,1,10,9,9,7.4,19316,18208,1820.8,3351,3465,0
621,-431,-1022,1794.9,17949,16183,6.6,11,11,20,172,17.2,1,0,1,0,1,207,20.7,1,10,10,10,6.6,17205,18380,1838.0,1022,431,0
622,1083,451,1773.7,17737,18303,7.2,8,8,9,193,19.3,0,0,0,1,0,207,20.7,0,2,7,7,7.2,17852,16654,1665.4,-451,-1083,1
623,-1259,-360,1530.7,15307,18407,7.0,5,5,5,218,21.8,0,0,0,1,0,250,25.0,0,12,6,6,7.2,18767,16566,1656.6,360,1259,0
624,-6801,-4611,1397.3,13973,15260,6.2,4,4,4,166,16.6,0,0,0,1,0,234,23.4,1,14,12,12,7.4,19871,20774,2077.4,4611,6801,0
625,1158,191,1808.9,18089,18770,7.4,7,7,8,225,22.5,1,1,1,0,0,202,20.2,1,8,10,10,7.2,18579,16931,1693.1,-191,-1158,1
626,2053,1371,1722.4,17224,18597,7.2,7,7,6,237,23.7,2,1,1,0,0,237,23.7,0,4,3,3,6.6,17226,15171,1517.1,-1371,-2053,1
627,604,1983,1764.9,17649,18664,7.2,11,11,12,187,18.7,0,0,0,1,1,187,18.7,1,8,7,7,6.6,16681,17045,1704.5,-1983,-604,1
628,75,616,1688.6,16886,17965,7.0,3,3,5,244,24.4,1,0,0,1,1,195,19.5,1,14,7,7,7.0,17349,16811,1681.1,-616,-75,1
629,-542,-927,1458.4,14584,16647,6.6,2,2,2,235,23.5,0,0,1,0,0,211,21.1,0,5,4,4,6.8,17574,15126,1512.6,927,542,0
630,1099,-98,1733.1,17331,17982,6.8,9,9,13,201,20.1,0,0,1,0,1,195,19.5,1,7,7,7,6.8,18080,16232,1623.2,98,-1099,1
631,2183,263,1776.3,17763,18822,7.0,8,8,4,246,24.6,1,1,1,0,0,212,21.2,0,6,4,4,7.0,18559,15580,1558.0,-263,-2183,1
632,791,224,1681.4,16814,18549,7.0,4,4,5,220,22.0,2,1,1,0,0,228,22.8,0,6,4,4,7.0,18325,16023,1602.3,-224,-791,1
633,-3614,-3434,1450.0,14500,16097,6.6,3,3,2,209,20.9,0,0,0,1,0,222,22.2,1,10,8,8,7.2,19531,18114,1811.4,3434,3614,0
634,1220,589,1743.5,17435,19432,7.0,11,11,9,236,23.6,2,1,1,0,0,241,24.1,0,2,2,2,7.0,18843,16215,1621.5,-589,-1220,0
635,-1827,-2059,1468.2,14682,17105,6.6,4,4,3,199,19.9,0,0,1,0,0,235,23.5,0,5,5,5,7.4,19164,16509,1650.9,2059,1827,0
636,583,751,1675.2,16752,18737,7.0,8,8,8,229,22.9,0,0,0,1,1,201,20.1,1,5,5,5,7.0,17986,16169,1616.9,-751,-583,0
637,-334,-1054,1564.9,15649,18818,7.2,3,3,5,227,22.7,1,0,1,0,1,238,23.8,1,1,2,2,7.4,19872,15983,1598.3,1054,334,0
638,-2494,-1188,1612.4,16124,17595,7.0,6,6,9,232,23.2,0,0,0,1,1,230,23.0,1,18,11,11,7.0,18783,18618,1861.8,1188,2494,0
639,2658,2407,2113.2,21132,19294,7.2,18,18,6,236,23.6,0,0,1,0,0,154,15.4,0,16,13,13,6.6,16887,18474,1847.4,-2407,-2658,1
640,-116,-303,1756.9,17569,17411,6.8,9,9,10,228,22.8,1,1,0,1,0,207,20.7,1,11,9,9,7.0,17714,17685,1768.5,303,116,1
641,-197,-2391,1709.7,17097,16795,6.8,9,9,11,202,20.2,2,1,1,0,0,219,21.9,0,8,8,8,7.2,19186,17294,1729.4,2391,197,1
642,760,521,1690.6,16906,18034,6.8,7,7,8,218,21.8,0,0,0,1,0,244,24.4,0,4,5,5,6.8,17513,16146,1614.6,-521,-760,0
643,1224,1259,1663.2,16632,18912,7.0,5,5,6,233,23.3,0,0,0,1,1,228,22.8,1,5,4,4,6.8,17653,15408,1540.8,-1259,-1224,1
644,-6076,-3107,1344.9,13449,15122,6.4,2,2,2,180,18.0,0,0,0,1,0,193,19.3,1,12,11,11,6.8,18229,19525,1952.5,3107,6076,0
645,-2339,-917,1671.2,16712,17809,6.8,8,8,9,190,19.0,1,1,0,1,0,228,22.8,0,19,11,11,7.2,18726,19051,1905.1,917,2339,0
646,2590,1325,1637.2,16372,18954,7.2,3,3,4,279,27.9,0,0,1,0,1,226,22.6,1,0,1,1,7.0,17629,13782,1378.2,-1325,-2590,1
647,2175,1409,1738.4,17384,19286,7.4,9,9,6,235,23.5,1,1,1,0,0,222,22.2,0,3,5,5,7.2,17877,15209,1520.9,-1409,-2175,0
648,1188,-284,1707.5,17075,18328,7.0,6,6,10,229,22.9,1,1,1,0,0,182,18.2,0,5,7,7,7.0,18612,15887,1588.7,284,-1188,0
649,1651,3902,1886.0,18860,22224,8.0,11,11,7,233,23.3,0,0,0,1,1,215,21.5,1,6,7,7,7.0,18322,17209,1720.9,-3902,-1651,0
650,-187,2135,1538.1,15381,19473,7.2,5,5,4,211,21.1,0,0,0,1,1,238,23.8,1,5,3,3,6.8,17338,15568,1556.8,-2135,187,0
651,-4868,-4160,1354.5,13545,15716,6.4,2,2,2,180,18.0,0,0,0,1,1,242,24.2,1,12,9,9,7.4,19876,18413,1841.3,4160,4868,0
652,-4149,-3222,1325.6,13256,16464,6.4,0,0,0,202,20.2,0,0,0,1,0,272,27.2,1,4,5,5,7.0,19686,17405,1740.5,3222,4149,0
653,-2602,-1426,1442.3,14423,16966,6.6,3,3,1,219,21.9,0,0,0,1,0,249,24.9,0,6,6,6,7.2,18392,17025,1702.5,1426,2602,0
654,-1018,1114,1755.1,17551,18910,7.0,7,7,5,244,24.4,1,1,1,0,0,204,20.4,0,10,8,8,7.0,17796,18569,1856.9,-1114,1018,1
655,2718,1185,1953.7,19537,18358,7.0,11,11,12,189,18.9,0,0,0,1,1,211,21.1,1,8,6,6,7.0,17173,16819,1681.9,-1185,-2718,1
656,4899,2415,2021.8,20218,18620,7.2,17,17,16,199,19.9,1,1,1,0,0,165,16.5,0,5,5,5,6.4,16205,15319,1531.9,-2415,-4899,1
657,-1344,-2597,1519.1,15191,16443,6.6,5,5,5,193,19.3,0,0,0,1,1,207,20.7,1,4,5,5,7.0,19040,16535,1653.5,2597,1344,1
658,3781,1725,1880.2,18802,18095,7.0,11,11,12,224,22.4,1,1,1,0,0,222,22.2,0,2,3,3,6.6,16370,15021,1502.1,-1725,-3781,1
659,3328,3696,1711.6,17116,19290,7.2,7,7,3,237,23.7,1,1,1,0,0,173,17.3,0,3,3,3,6.4,15594,13788,1378.8,-3696,-3328,1
660,2114,75,1823.0,18230,17602,6.8,11,11,15,195,19.5,1,1,1,0,0,198,19.8,0,7,6,6,6.8,17527,16116,1611.6,-75,-2114,1
661,-464,-47,1582.9,15829,18055,7.0,6,6,3,228,22.8,1,1,1,0,0,208,20.8,0,8,7,7,7.0,18102,16293,1629.3,47,464,0
662,-17,588,1472.9,14729,18508,6.8,4,4,2,228,22.8,2,1,0,1,0,192,19.2,0,1,2,2,6.8,17920,14746,1474.6,-588,17,1
663,1300,3056,1779.3,17793,19086,7.0,8,8,9,208,20.8,0,0,0,1,1,221,22.1,1,12,7,7,6.4,16030,16493,1649.3,-3056,-1300,1
664,3884,2315,1752.5,17525,19534,7.2,7,7,15,240,24.0,2,1,1,0,0,238,23.8,0,0,0,0,6.8,17219,13641,1364.1,-2315,-3884,1
665,475,1006,1757.9,17579,18266,7.2,8,8,13,224,22.4,1,1,0,1,0,205,20.5,0,10,9,9,6.8,17260,17104,1710.4,-1006,-475,0
666,2689,2827,1822.7,18227,19568,7.2,7,7,7,256,25.6,2,1,1,0,0,224,22.4,0,4,4,4,6.6,16741,15538,1553.8,-2827,-2689,1
667,-1367,-197,1489.8,14898,17842,7.0,4,4,1,192,19.2,1,0,0,1,0,219,21.9,0,10,6,6,6.8,18039,16265,1626.5,197,1367,0
668,-2999,-1476,1576.9,15769,17360,6.8,4,4,3,222,22.2,1,1,1,0,0,232,23.2,0,11,8,8,7.0,18836,18768,1876.8,1476,2999,0
669,-967,-965,1927.2,19272,16786,6.8,12,12,17,188,18.8,1,0,0,1,0,222,22.2,0,23,12,12,7.0,17751,20239,2023.9,965,967,0
670,1969,1497,1778.8,17788,19078,7.2,7,7,8,255,25.5,1,1,1,0,0,234,23.4,1,4,4,4,6.8,17581,15819,1581.9,-1497,-1969,0
671,-4199,-3186,1473.8,14738,17148,6.4,3,3,4,197,19.7,0,0,0,1,1,241,24.1,1,7,11,11,7.6,20334,18937,1893.7,3186,4199,0
672,-105,-896,1611.3,16113,17058,6.8,5,5,2,231,23.1,0,0,1,0,1,217,21.7,1,6,6,6,7.0,17954,16218,1621.8,896,105,1
673,3652,1542,1896.7,18967,17807,7.2,9,9,11,231,23.1,1,0,1,0,0,194,19.4,0,7,5,5,6.4,16265,15315,1531.5,-1542,-3652,0
674,-83,-64,1541.6,15416,18096,7.0,2,2,4,253,25.3,0,0,0,1,1,230,23.0,1,3,3,3,7.2,18160,15499,1549.9,64,83,0
675,2526,1379,1809.6,18096,18969,7.2,9,9,8,232,23.2,0,0,1,0,1,194,19.4,1,4,5,5,6.8,17590,15570,1557.0,-1379,-2526,0
676,-1864,-1945,1441.1,14411,16806,6.8,3,3,1,210,21.0,1,1,0,1,0,198,19.8,1,6,6,6,7.2,18751,16275,1627.5,1945,1864,0
677,787,481,1566.8,15668,18873,7.0,4,4,2,250,25.0,1,0,1,0,1,221,22.1,1,1,3,3,7.0,18392,14881,1488.1,-481,-787,1
678,-1222,-2334,1628.8,16288,17321,6.8,7,7,8,193,19.3,1,0,1,0,1,221,22.1,1,9,7,7,7.2,19655,17510,1751.0,2334,1222,0
679,-204,1350,1857.5,18575,18974,7.2,11,11,13,198,19.8,0,0,1,0,1,211,21.1,1,10,11,11,6.8,17624,18779,1877.9,-1350,204,0
680,1759,1710,1737.9,17379,19080,7.2,6,6,4,251,25.1,1,1,1,0,0,220,22.0,1,5,5,5,6.8,17370,15620,1562.0,-1710,-1759,0
681,-1650,-1358,1522.2,15222,17667,6.8,3,3,3,220,22.0,1,1,0,1,0,217,21.7,1,9,8,8,7.2,19025,16872,1687.2,1358,1650,0
682,290,617,1619.1,16191,18795,7.2,5,5,6,238,23.8,1,1,1,0,0,242,24.2,0,3,5,5,7.2,18178,15901,1590.1,-617,-290,1
683,-3418,-2689,1493.0,14930,17328,6.8,2,2,3,231,23.1,1,1,1,0,0,263,26.3,0,3,5,5,7.4,20017,18348,1834.8,2689,3418,0
684,1922,1870,1706.2,17062,19299,7.2,7,7,8,238,23.8,0,0,1,0,0,191,19.1,0,4,4,4,6.8,17429,15140,1514.0,-1870,-1922,0
685,-3584,-2457,1476.3,14763,16159,6.6,4,4,5,205,20.5,0,0,0,1,1,254,25.4,1,13,8,8,7.0,18616,18347,1834.7,2457,3584,0
686,-2827,-2675,1535.1,15351,13858,6.0,7,7,5,169,16.9,0,0,1,0,1,181,18.1,1,11,10,10,6.4,16533,18178,1817.8,2675,2827,0
687,817,2322,1762.5,17625,18727,7.0,11,11,8,212,21.2,0,0,0,1,0,209,20.9,1,7,7,7,6.6,16405,16808,1680.8,-2322,-817,0
688,75,536,1593.3,15933,19079,7.2,3,3,5,259,25.9,0,0,0,1,1,262,26.2,1,4,3,3,7.2,18543,15858,1585.8,-536,-75,1
689,-1502,-321,1822.9,18229,19238,7.2,11,11,8,198,19.8,0,0,0,1,1,186,18.6,1,14,14,14,7.4,19559,19731,1973.1,321,1502,0
690,-1706,-1004,1535.6,15356,17995,7.0,2,2,2,230,23.0,0,0,0,1,1,209,20.9,1,7,7,7,7.0,18999,17062,1706.2,1004,1706,1
691,274,1018,1700.5,17005,18098,6.8,7,7,6,216,21.6,1,0,0,1,1,200,20.0,1,10,9,9,6.6,17080,16731,1673.1,-1018,-274,1
692,1058,1735,1674.7,16747,18344,6.8,7,7,8,198,19.8,0,0,0,1,1,198,19.8,1,9,5,5,6.6,16609,15689,1568.9,-1735,-1058,1
693,-1776,-3265,1606.0,16060,16426,6.6,6,6,9,187,18.7,0,0,0,1,0,248,24.8,0,7,7,7,7.2,19691,17836,1783.6,3265,1776,0
694,-2698,-3640,1499.8,14998,15234,6.2,5,5,8,197,19.7,0,0,1,0,1,232,23.2,1,11,9,9,7.2,18874,17696,1769.6,3640,2698,0
695,-95,-1113,1618.2,16182,17791,6.8,6,6,7,221,22.1,0,0,1,0,1,216,21.6,1,11,7,7,7.0,18904,16277,1627.7,1113,95,0
696,519,1006,1706.5,17065,19772,7.6,8,8,7,214,21.4,1,0,1,0,1,204,20.4,1,6,8,8,7.0,18766,16546,1654.6,-1006,-519,0
697,-873,300,1554.4,15544,18579,6.8,3,3,4,222,22.2,1,1,1,0,0,240,24.0,0,2,4,4,7.0,18279,16417,1641.7,-300,873,0
698,-1514,-629,1654.1,16541,18666,7.0,4,4,8,225,22.5,1,1,0,1,0,239,23.9,0,8,9,9,7.4,19295,18055,1805.5,629,1514,1
699,-973,-674,1511.2,15112,16369,6.6,6,6,9,184,18.4,1,1,0,1,0,231,23.1,0,4,5,5,6.8,17043,16085,1608.5,674,973,1
700,-1499,-1282,1755.0,17550,18186,7.0,8,8,7,229,22.9,0,0,0,1,0,247,24.7,1,14,11,11,7.0,19468,19049,1904.9,1282,1499,0
701,4011,2732,1832.3,18323,20458,7.4,8,8,9,262,26.2,2,1,1,0,0,208,20.8,0,0,2,2,6.6,17726,14312,1431.2,-2732,-4011,1
702,4957,3218,1855.3,18553,18785,7.0,6,6,5,248,24.8,2,1,1,0,0,214,21.4,0,0,1,1,6.4,15567,13596,1359.6,-3218,-4957,1
703,-615,-347,1525.2,15252,17517,6.8,4,4,5,225,22.5,0,0,0,1,1,229,22.9,1,3,4,4,6.6,17864,15867,1586.7,347,615,0
704,783,-301,1686.3,16863,17725,6.8,7,7,3,206,20.6,0,0,1,0,1,186,18.6,1,7,8,8,7.0,18026,16080,1608.0,301,-783,1
705,-3617,-1967,1392.5,13925,18363,7.0,1,1,2,216,21.6,1,1,0,1,0,260,26.0,0,5,4,4,7.4,20330,17542,1754.2,1967,3617,0
706,912,-241,1682.8,16828,17273,6.8,7,7,8,217,21.7,0,0,1,0,1,217,21.7,1,5,5,5,6.6,17514,15916,1591.6,241,-912,1
707,-2746,-2775,1539.1,15391,16275,6.6,4,4,6,189,18.9,1,0,1,0,0,247,24.7,0,7,9,9,7.0,19050,18137,1813.7,2775,2746,0
708,1290,1337,1635.0,16350,18701,7.0,5,5,4,245,24.5,0,0,1,0,0,236,23.6,0,2,2,2,6.8,17364,15060,1506.0,-1337,-1290,1
709,-71,994,1715.9,17159,19172,7.2,6,6,7,223,22.3,0,0,0,1,1,229,22.9,1,8,6,6,6.8,18178,17230,1723.0,-994,71,1
710,-2528,-882,1548.4,15484,18316,7.2,4,4,3,226,22.6,1,0,0,1,1,236,23.6,1,11,8,8,7.2,19198,18012,1801.2,882,2528,0
711,901,1182,1702.4,17024,19195,7.2,5,5,4,254,25.4,0,0,1,0,0,214,21.4,0,7,6,6,6.8,18013,16123,1612.3,-1182,-901,1
712,2013,1022,1868.0,18680,19206,7.2,10,10,13,220,22.0,0,0,1,0,1,210,21.0,2,8,6,6,6.8,18184,16667,1666.7,-1022,-2013,1
713,-3113,-1771,1465.7,14657,16983,6.8,4,4,2,188,18.8,2,1,0,1,0,201,20.1,0,20,11,11,7.2,18754,17770,1777.0,1771,3113,0
714,-1467,-1916,1555.0,15550,17134,6.8,6,6,5,191,19.1,1,1,1,0,0,213,21.3,0,5,9,9,7.2,19050,17017,1701.7,1916,1467,0
715,-3197,-1400,1586.1,15861,17082,6.6,6,6,3,208,20.8,1,1,0,1,0,208,20.8,0,20,12,12,7.4,18482,19058,1905.8,1400,3197,0
716,-31,849,1520.2,15202,19256,7.2,2,2,2,225,22.5,0,0,0,1,1,218,21.8,1,3,4,4,7.2,18407,15233,1523.3,-849,31,1
717,-802,-842,1521.4,15214,16970,6.8,4,4,5,211,21.1,1,0,0,1,1,209,20.9,1,6,7,7,6.8,17812,16016,1601.6,842,802,0
718,-1642,-2040,1617.1,16171,16898,6.6,8,8,12,214,21.4,1,1,1,0,0,235,23.5,1,9,8,8,7.2,18938,17813,1781.3,2040,1642,0
719,2989,4519,1818.4,18184,20169,7.4,9,9,5,238,23.8,0,0,0,1,0,192,19.2,0,6,4,4,6.4,15650,15195,1519.5,-4519,-2989,0
720,2197,1707,1675.1,16751,17829,6.8,5,5,8,247,24.7,1,1,1,0,0,193,19.3,0,1,3,3,6.2,16122,14554,1455.4,-1707,-2197,1
721,2983,1577,1697.3,16973,18787,7.0,6,6,8,250,25.0,1,1,0,1,0,199,19.9,1,1,1,1,6.8,17210,13990,1399.0,-1577,-2983,0
722,1167,2368,1723.9,17239,19174,7.4,7,7,7,222,22.2,2,1,0,1,0,182,18.2,0,7,7,7,6.6,16806,16072,1607.2,-2368,-1167,1
723,-3941,-2386,1466.0,14660,17284,6.6,2,2,4,232,23.2,0,0,0,1,1,195,19.5,1,19,11,11,7.4,19670,18601,1860.1,2386,3941,0
724,720,-183,1742.9,17429,17309,6.8,9,9,11,211,21.1,1,1,1,0,0,210,21.0,0,10,8,8,6.8,17492,16709,1670.9,183,-720,0
725,4098,1004,1851.3,18513,18739,7.2,8,8,8,250,25.0,0,0,1,0,0,194,19.4,0,4,3,3,6.8,17735,14415,1441.5,-1004,-4098,1
726,2430,2023,1622.5,16225,17742,6.8,5,5,6,231,23.1,1,1,1,0,0,179,17.9,0,2,2,2,6.6,15719,13795,1379.5,-2023,-2430,1
727,206,-364,1626.7,16267,17908,7.0,5,5,5,247,24.7,1,1,1,0,0,228,22.8,0,5,5,5,6.8,18272,16061,1606.1,364,-206,0
728,-1003,-1571,1547.8,15478,17551,6.8,3,3,4,233,23.3,0,0,1,0,0,236,23.6,0,4,4,4,7.2,19122,16481,1648.1,1571,1003,0
729,600,-81,1633.5,16335,18087,7.2,7,7,10,212,21.2,2,1,0,1,0,246,24.6,0,3,3,3,7.0,18168,15735,1573.5,81,-600,0
730,-1596,-1318,1482.6,14826,16660,6.8,4,4,2,204,20.4,0,0,0,1,0,214,21.4,1,7,5,5,7.0,17978,16422,1642.2,1318,1596,1
731,2035,1188,1909.2,19092,19183,7.2,9,9,19,226,22.6,0,0,1,0,1,214,21.4,1,8,7,7,7.0,17995,17057,1705.7,-1188,-2035,1
732,1273,622,1761.9,17619,18563,7.2,10,10,9,186,18.6,1,0,1,0,1,186,18.6,1,4,7,7,7.0,17941,16346,1634.6,-622,-1273,0
733,-1232,-272,1687.2,16872,17906,7.0,9,9,9,199,19.9,0,0,0,1,1,225,22.5,1,6,8,8,7.0,18178,18104,1810.4,272,1232,1
734,1726,1423,1726.5,17265,17683,6.8,8,8,9,233,23.3,1,1,1,0,0,192,19.2,0,11,5,5,6.4,16260,15539,1553.9,-1423,-1726,1
735,2036,2183,1930.8,19308,18764,7.2,11,11,12,243,24.3,0,0,1,0,0,164,16.4,0,9,7,7,6.6,16581,17272,1727.2,-2183,-2036,1
736,-1123,-1665,1653.5,16535,17930,7.0,7,7,8,230,23.0,1,1,1,0,0,225,22.5,1,7,8,8,7.0,19595,17658,1765.8,1665,1123,1
737,-1325,64,1660.6,16606,18604,7.0,6,6,8,226,22.6,0,0,0,1,1,233,23.3,1,11,8,8,7.2,18540,17931,1793.1,-64,1325,0
738,-25,1849,1716.8,17168,17668,6.8,9,9,10,212,21.2,1,1,1,0,0,196,19.6,0,10,9,9,6.6,15819,17193,1719.3,-1849,25,0
739,-1089,-782,1483.9,14839,17555,6.6,4,4,6,215,21.5,0,0,0,1,0,225,22.5,0,1,4,4,7.0,18337,15928,1592.8,782,1089,0
740,1745,1180,1781.2,17812,18372,7.0,7,7,8,244,24.4,0,0,1,0,1,216,21.6,1,10,6,6,6.8,17192,16067,1606.7,-1180,-1745,1
741,-1838,-1584,1482.7,14827,17341,7.0,3,3,4,201,20.1,0,0,0,1,1,230,23.0,1,4,5,5,7.0,18925,16665,1666.5,1584,1838,0
742,-1018,-1124,1557.8,15578,17702,6.8,4,4,4,229,22.9,1,0,0,1,0,240,24.0,0,6,6,6,7.0,18826,16596,1659.6,1124,1018,1
743,-105,1234,1662.8,16628,17255,6.8,7,7,8,215,21.5,1,1,0,1,0,213,21.3,1,5,3,3,6.2,16021,16733,1673.3,-1234,105,0
744,-2141,-2439,1460.9,14609,16875,6.8,3,3,6,218,21.8,1,1,1,0,0,253,25.3,1,4,4,4,7.2,19314,16750,1675.0,2439,2141,0
745,-3573,-2497,1332.5,13325,16064,6.6,1,1,1,171,17.1,0,0,0,1,1,230,23.0,2,12,7,7,7.2,18561,16898,1689.8,2497,3573,0
746,-2105,-88,1527.7,15277,17286,6.8,3,3,3,234,23.4,0,0,0,1,1,191,19.1,1,15,7,7,7.0,17374,17382,1738.2,88,2105,1
747,25,2,1628.7,16287,17787,6.6,6,6,4,226,22.6,0,0,1,0,0,226,22.6,0,9,5,5,6.8,17785,16262,1626.2,-2,-25,0
748,-6435,-5116,1274.7,12747,14396,6.0,1,1,1,180,18.0,1,1,0,1,0,227,22.7,0,10,14,14,7.4,19512,19182,1918.2,5116,6435,0
749,-609,-504,1768.7,17687,18503,6.8,9,9,7,206,20.6,1,1,1,0,0,225,22.5,0,13,9,9,7.0,19007,18296,1829.6,504,609,0
750,1546,61,1718.7,17187,18382,7.0,8,8,6,232,23.2,1,0,1,0,0,240,24.0,0,3,4,4,7.2,18321,15641,1564.1,-61,-1546,1
751,-4929,-3345,1401.5,14015,15677,6.4,3,3,4,178,17.8,0,0,0,1,1,228,22.8,1,16,12,12,7.2,19022,18944,1894.4,3345,4929,0
752,164,-222,1629.1,16291,18130,6.8,6,6,5,228,22.8,0,0,1,0,0,227,22.7,0,6,6,6,7.0,18352,16127,1612.7,222,-164,1
753,1025,1276,1628.9,16289,19421,7.4,4,4,9,229,22.9,0,0,0,1,1,271,27.1,2,1,2,2,7.0,18145,15264,1526.4,-1276,-1025,1
754,1474,1001,1723.4,17234,18799,7.2,8,8,9,228,22.8,0,0,1,0,0,201,20.1,0,5,5,5,6.8,17798,15760,1576.0,-1001,-1474,1
755,-2454,-3816,1466.3,14663,15749,6.6,3,3,4,201,20.1,0,0,1,0,0,213,21.3,1,8,8,8,7.4,19565,17117,1711.7,3816,2454,0
756,269,480,1627.8,16278,18389,7.0,5,5,4,244,24.4,1,0,1,0,0,219,21.9,0,5,5,5,7.0,17909,16009,1600.9,-480,-269,1
757,-524,-904,1902.5,19025,16965,6.8,14,14,18,150,15.0,1,0,0,1,1,185,18.5,1,9,17,17,7.0,17869,19549,1954.9,904,524,1
758,-1364,-87,1536.6,15366,17861,7.0,3,3,3,230,23.0,0,0,0,1,1,243,24.3,1,7,5,5,6.8,17948,16730,1673.0,87,1364,1
759,-2320,-1718,1452.6,14526,17736,6.8,0,0,0,246,24.6,0,0,0,1,1,248,24.8,1,6,5,5,7.4,19454,16846,1684.6,1718,2320,0
760,1268,1705,1654.7,16547,19666,7.2,4,4,8,259,25.9,1,1,1,0,0,249,24.9,0,3,2,2,7.0,17961,15279,1527.9,-1705,-1268,1
761,-1543,-509,1493.6,14936,17688,7.2,2,2,1,231,23.1,1,1,1,0,0,250,25.0,0,8,5,5,7.0,18197,16479,1647.9,509,1543,1
762,-2997,-2029,1559.4,15594,16987,6.6,5,5,3,213,21.3,1,1,0,1,0,222,22.2,0,14,11,11,7.2,19016,18591,1859.1,2029,2997,0
763,-367,-1771,1741.6,17416,18429,7.2,9,9,11,208,20.8,0,0,1,0,1,243,24.3,1,6,6,6,7.4,20200,17783,1778.3,1771,367,0
764,-3309,-2741,1572.2,15722,17329,6.8,4,4,4,221,22.1,1,1,0,1,0,230,23.0,0,9,7,7,7.4,20070,19031,1903.1,2741,3309,0
765,1188,2851,1609.1,16091,20383,7.6,3,3,2,256,25.6,1,0,1,0,1,244,24.4,1,3,2,2,7.0,17532,14903,1490.3,-2851,-1188,0
766,-1138,-867,1504.8,15048,17356,7.0,6,6,6,183,18.3,0,0,1,0,1,253,25.3,1,3,3,3,7.0,18223,16186,1618.6,867,1138,0
767,6790,5348,2333.5,23335,20839,7.6,17,17,25,239,23.9,0,0,1,0,0,129,12.9,0,11,10,10,6.4,15491,16545,1654.5,-5348,-6790,1
768,3723,3777,1827.2,18272,19342,7.2,8,8,10,233,23.3,1,0,1,0,1,196,19.6,1,3,3,3,6.4,15565,14549,1454.9,-3777,-3723,1
769,748,-77,1627.0,16270,18195,7.2,5,5,6,223,22.3,1,1,0,1,0,208,20.8,0,5,5,5,6.8,18272,15522,1552.2,77,-748,0
770,326,1472,1729.8,17298,16912,6.4,8,8,8,233,23.3,0,0,0,1,1,210,21.0,1,11,7,7,6.4,15440,16972,1697.2,-1472,-326,1
771,1449,-530,1723.0,17230,17823,6.6,4,4,6,244,24.4,2,1,1,0,0,229,22.9,0,5,2,2,7.0,18353,15781,1578.1,530,-1449,1
772,-635,-1011,1709.8,17098,17045,6.8,10,10,9,201,20.1,1,1,1,0,0,208,20.8,0,9,9,9,7.2,18056,17733,1773.3,1011,635,0
773,1060,488,1738.0,17380,18220,7.0,8,8,11,211,21.1,1,0,1,0,1,215,21.5,1,9,6,6,7.0,17732,16320,1632.0,-488,-1060,0
774,-489,188,1682.9,16829,17978,6.8,6,6,4,198,19.8,1,0,0,1,1,216,21.6,1,11,9,9,6.8,17790,17318,1731.8,-188,489,0
775,-2335,-2787,1453.8,14538,16871,6.8,3,3,6,218,21.8,0,0,1,0,1,236,23.6,1,6,5,5,7.4,19658,16873,1687.3,2787,2335,0
776,-2496,-2174,1515.9,15159,17115,6.6,4,4,6,217,21.7,1,1,1,0,0,240,24.0,1,6,7,7,7.2,19289,17655,1765.5,2174,2496,1
777,-2695,-1042,1487.4,14874,16504,6.6,5,5,3,177,17.7,0,0,0,1,1,249,24.9,1,14,8,8,6.8,17546,17569,1756.9,1042,2695,0
778,1160,939,1772.1,17721,18253,7.0,9,9,9,226,22.6,2,1,1,0,0,213,21.3,0,7,6,6,6.8,17314,16561,1656.1,-939,-1160,0
779,4982,1971,2027.3,20273,19742,7.2,9,9,10,254,25.4,1,1,1,0,0,195,19.5,0,4,3,3,6.8,17771,15291,1529.1,-1971,-4982,1
780,4688,983,2010.3,20103,17668,6.8,13,13,13,220,22.0,1,1,1,0,0,172,17.2,0,4,6,6,6.8,16685,15415,1541.5,-983,-4688,1
781,1774,1305,1649.1,16491,17031,6.8,7,7,10,199,19.9,0,0,1,0,0,170,17.0,0,5,5,5,6.4,15726,14717,1471.7,-1305,-1774,1
782,2768,2761,1764.0,17640,19566,7.2,8,8,8,233,23.3,1,1,1,0,0,220,22.0,0,2,3,3,6.6,16805,14872,1487.2,-2761,-2768,1
783,-686,-619,1551.8,15518,16862,6.6,5,5,8,197,19.7,1,1,1,0,0,249,24.9,1,5,4,4,6.8,17481,16204,1620.4,619,686,1
784,1418,544,1738.1,17381,18495,7.0,7,7,5,220,22.0,2,1,1,0,0,225,22.5,0,5,5,5,6.8,17951,15963,1596.3,-544,-1418,0
785,-5,-269,1512.7,15127,17750,7.0,3,3,1,238,23.8,1,1,0,1,0,203,20.3,0,3,3,3,7.0,18019,15132,1513.2,269,5,0
786,-4000,-2533,1379.4,13794,14884,6.0,3,3,4,183,18.3,0,0,0,1,0,245,24.5,0,5,5,5,6.8,17417,17794,1779.4,2533,4000,0
787,-243,799,1513.9,15139,17354,6.8,3,3,0,240,24.0,0,0,0,1,1,206,20.6,1,10,4,4,6.6,16555,15382,1538.2,-799,243,1
788,-709,-147,1592.9,15929,18460,7.2,3,3,6,229,22.9,0,0,1,0,1,232,23.2,1,10,5,5,7.0,18607,16638,1663.8,147,709,0
789,-726,-31,1497.4,14974,18286,7.0,2,2,3,224,22.4,2,1,0,1,0,216,21.6,0,5,5,5,7.0,18317,15700,1570.0,31,726,1
790,3936,2111,1969.5,19695,19512,7.2,11,11,18,258,25.8,1,1,0,1,0,205,20.5,1,4,4,4,7.0,17401,15759,1575.9,-2111,-3936,1
791,-277,208,1515.4,15154,17000,6.6,4,4,0,219,21.9,1,1,1,0,0,224,22.4,0,7,4,4,6.6,16792,15431,1543.1,-208,277,1
792,-2769,-820,1476.6,14766,16507,6.6,4,4,7,190,19.0,1,1,0,1,0,229,22.9,0,11,8,8,6.8,17327,17535,1753.5,820,2769,0
793,1513,1585,1734.1,17341,18528,7.0,9,9,11,209,20.9,1,1,0,1,0,222,22.2,0,8,4,4,7.0,16943,15828,1582.8,-1585,-1513,0
794,-736,-94,1546.4,15464,17833,7.0,4,4,0,218,21.8,2,1,1,0,0,223,22.3,0,9,5,5,7.0,17927,16200,1620.0,94,736,1
795,1334,656,1852.9,18529,19610,7.2,8,8,9,251,25.1,0,0,1,0,1,202,20.2,1,11,9,9,7.0,18954,17195,1719.5,-656,-1334,1
796,3036,1766,1814.9,18149,18067,7.0,9,9,17,202,20.2,0,0,0,1,1,222,22.2,1,5,4,4,6.6,16301,15113,1511.3,-1766,-3036,1
797,1811,-631,1584.0,15840,16848,6.6,3,3,6,212,21.2,1,0,1,0,1,221,22.1,1,1,2,2,6.8,17479,14029,1402.9,631,-1811,0
798,1451,1985,1791.5,17915,19197,7.2,8,8,8,215,21.5,0,0,1,0,0,222,22.2,0,9,6,6,7.0,17212,16464,1646.4,-1985,-1451,1
799,-598,-146,1624.2,16242,18244,7.0,5,5,7,235,23.5,1,0,1,0,1,229,22.9,1,11,5,5,7.0,18390,16840,1684.0,146,598,0
800,1446,1597,1849.8,18498,20017,7.2,10,10,10,238,23.8,1,1,1,0,0,229,22.9,0,5,6,6,7.0,18420,17052,1705.2,-1597,-1446,1
801,1618,393,1912.0,19120,17735,6.8,10,10,15,219,21.9,1,1,1,0,0,207,20.7,0,10,9,9,6.8,17342,17502,1750.2,-393,-1618,0
802,93,-1276,1794.8,17948,16194,6.6,10,10,13,193,19.3,1,1,0,1,0,219,21.9,0,13,11,11,6.8,17470,17855,1785.5,1276,-93,1
803,1183,887,1651.7,16517,17531,6.6,6,6,8,219,21.9,0,0,0,1,0,192,19.2,0,7,5,5,6.6,16644,15334,1533.4,-887,-1183,0
804,-3453,-720,1345.2,13452,15569,6.4,3,3,0,170,17.0,0,0,0,1,1,212,21.2,1,10,7,7,6.6,16289,16905,1690.5,720,3453,0
805,-1655,-1323,1568.7,15687,17057,6.6,5,5,3,210,21.0,0,0,0,1,1,215,21.5,1,12,10,10,7.2,18380,17342,1734.2,1323,1655,0
806,-4462,-2990,1476.3,14763,16834,6.8,5,5,4,179,17.9,1,1,0,1,0,255,25.5,0,11,11,11,7.2,19824,19225,1922.5,2990,4462,0
807,557,1061,1641.7,16417,16981,6.6,7,7,8,211,21.1,0,0,0,1,0,194,19.4,0,9,6,6,6.8,15920,15860,1586.0,-1061,-557,0
808,2527,3473,1816.8,18168,20892,7.4,9,9,10,254,25.4,0,0,1,0,0,220,22.0,0,6,4,4,6.8,17419,15641,1564.1,-3473,-2527,1
809,-1831,-2604,1590.3,15903,17263,6.8,7,7,9,189,18.9,0,0,0,1,1,226,22.6,2,11,8,8,7.2,19867,17734,1773.4,2604,1831,0
810,649,69,1470.2,14702,16741,6.6,2,2,1,244,24.4,1,0,1,0,1,214,21.4,1,1,1,1,6.8,16672,14053,1405.3,-69,-649,1
811,3091,2498,1887.4,18874,19652,7.2,11,11,10,224,22.4,0,0,0,1,0,215,21.5,0,7,5,5,6.6,17154,15783,1578.3,-2498,-3091,0
812,-2707,-1826,1522.5,15225,17939,7.0,3,3,3,211,21.1,1,1,0,1,0,209,20.9,0,11,10,10,7.4,19765,17932,1793.2,1826,2707,0
813,-512,-844,1585.8,15858,17491,6.8,4,4,7,246,24.6,0,0,0,1,1,241,24.1,2,6,5,5,7.0,18335,16370,1637.0,844,512,0
814,-3874,-2423,1469.3,14693,15883,6.6,4,4,6,169,16.9,0,0,0,1,0,223,22.3,0,13,9,9,7.0,18306,18567,1856.7,2423,3874,0
815,-100,219,1557.4,15574,17686,6.8,3,3,3,217,21.7,1,1,1,0,0,240,24.0,0,2,2,2,6.6,17467,15674,1567.4,-219,100,1
816,506,1580,1569.2,15692,17765,6.6,3,3,2,221,22.1,0,0,0,1,1,182,18.2,1,8,5,5,6.8,16185,15186,1518.6,-1580,-506,0
817,4796,3112,1829.7,18297,19315,7.2,9,9,13,251,25.1,0,0,1,0,0,203,20.3,0,0,1,1,6.4,16203,13501,1350.1,-3112,-4796,1
818,-1709,-1585,1924.7,19247,16835,6.8,15,15,10,205,20.5,2,1,0,1,0,182,18.2,0,16,16,16,7.0,18420,20956,2095.6,1585,1709,1
819,-553,-114,1541.4,15414,17341,6.8,1,1,1,236,23.6,0,0,0,1,0,194,19.4,0,8,7,7,7.0,17455,15967,1596.7,114,553,0
820,3190,2346,1960.1,19601,20002,7.4,10,10,15,227,22.7,1,1,0,1,0,214,21.4,1,8,7,7,6.8,17656,16411,1641.1,-2346,-3190,1
821,-1720,-2056,1518.9,15189,17014,6.6,3,3,0,225,22.5,1,0,0,1,1,248,24.8,1,3,6,6,7.2,19070,16909,1690.9,2056,1720,0
822,-480,353,1645.2,16452,17540,6.6,5,5,3,232,23.2,0,0,1,0,0,192,19.2,0,10,9,9,6.8,17187,16932,1693.2,-353,480,0
823,-1081,-631,1489.9,14899,17481,6.8,2,2,3,238,23.8,0,0,0,1,1,209,20.9,1,6,5,5,6.8,18112,15980,1598.0,631,1081,0
824,5436,3459,1896.4,18964,19620,7.2,9,9,9,255,25.5,1,1,1,0,0,183,18.3,0,1,1,1,6.4,16161,13528,1352.8,-3459,-5436,1
825,5323,2352,1892.3,18923,18586,7.0,12,12,14,236,23.6,1,1,1,0,0,191,19.1,0,1,1,1,6.4,16234,13600,1360.0,-2352,-5323,1
826,-214,-356,1747.2,17472,18276,6.8,7,7,8,229,22.9,0,0,0,1,1,211,21.1,2,9,8,8,7.0,18632,17686,1768.6,356,214,0
827,-2705,-1757,1466.5,14665,15990,6.2,3,3,2,188,18.8,1,1,0,1,0,226,22.6,0,9,9,9,7.2,17747,17370,1737.0,1757,2705,0
828,1419,82,1641.5,16415,17432,6.8,5,5,4,213,21.3,1,0,1,0,1,223,22.3,1,2,3,3,6.8,17350,14996,1499.6,-82,-1419,1
829,-5431,-4681,1396.0,13960,15286,6.4,2,2,2,191,19.1,0,0,0,1,0,200,20.0,0,10,11,11,7.4,19967,19391,1939.1,4681,5431,0
830,-4125,-2712,1477.3,14773,16673,6.6,2,2,3,202,20.2,0,0,0,1,1,237,23.7,1,11,11,11,7.2,19385,18898,1889.8,2712,4125,0
831,3153,3196,1918.1,19181,19634,7.4,11,11,11,247,24.7,2,1,1,0,0,185,18.5,0,10,5,5,6.6,16438,16028,1602.8,-3196,-3153,1
832,-3991,-3529,1452.8,14528,16282,6.4,5,5,1,175,17.5,1,1,1,0,0,239,23.9,0,3,8,8,7.4,19811,18519,1851.9,3529,3991,0
833,-1694,-603,1582.7,15827,17709,6.6,6,6,3,218,21.8,0,0,0,1,0,239,23.9,1,6,7,7,7.0,18312,17521,1752.1,603,1694,0
834,989,631,1617.9,16179,17928,6.8,6,6,4,215,21.5,1,0,0,1,0,212,21.2,0,3,4,4,6.8,17297,15190,1519.0,-631,-989,0
835,-1564,-953,1504.9,15049,17760,6.8,3,3,5,247,24.7,1,1,0,1,0,242,24.2,0,4,5,5,7.2,18713,16613,1661.3,953,1564,1
836,-664,615,1545.3,15453,18464,7.2,3,3,2,209,20.9,0,0,0,1,1,180,18.0,1,8,8,8,7.0,17849,16117,1611.7,-615,664,0
837,-1377,-180,1464.5,14645,18690,7.2,1,1,0,256,25.6,1,1,0,1,0,289,28.9,1,2,2,2,7.2,18870,16022,1602.2,180,1377,1
838,-1089,-2134,1576.6,15766,16285,6.8,6,6,10,197,19.7,1,1,0,1,0,226,22.6,0,6,7,7,7.0,18419,16855,1685.5,2134,1089,0
839,4234,1695,1889.0,18890,18772,7.2,7,7,10,227,22.7,2,1,1,0,0,214,21.4,0,3,2,2,6.6,17077,14656,1465.6,-1695,-4234,1
840,-702,-89,1645.0,16450,18541,7.0,6,6,7,238,23.8,1,0,0,1,1,226,22.6,1,10,7,7,7.0,18630,17152,1715.2,89,702,0
841,-508,-1394,1649.0,16490,17576,6.8,6,6,5,225,22.5,1,0,1,0,1,257,25.7,1,3,5,5,7.2,18970,16998,1699.8,1394,508,0
842,2366,1147,1740.8,17408,18740,7.2,10,10,13,193,19.3,0,0,1,0,1,231,23.1,1,5,4,4,6.8,17593,15042,1504.2,-1147,-2366,1
843,248,-219,1695.1,16951,18426,7.0,6,6,12,229,22.9,1,1,0,1,0,245,24.5,1,7,6,6,6.8,18645,16703,1670.3,219,-248,1
844,1426,128,1712.0,17120,17636,7.0,9,9,11,163,16.3,1,1,1,0,0,207,20.7,0,2,5,5,6.8,17508,15694,1569.4,-128,-1426,1
845,-740,76,1431.0,14310,17797,7.0,2,2,2,207,20.7,0,0,0,1,1,242,24.2,1,2,2,2,7.0,17721,15050,1505.0,-76,740,0
846,-1724,-262,1468.9,14689,18046,6.8,2,2,2,241,24.1,2,1,0,1,0,260,26.0,0,4,4,4,7.0,18308,16413,1641.3,262,1724,0
847,3311,2682,1834.1,18341,19070,7.4,8,8,10,217,21.7,1,1,1,0,0,228,22.8,0,3,4,4,6.6,16388,15030,1503.0,-2682,-3311,1
848,3401,2392,1777.2,17772,19337,7.2,6,6,10,251,25.1,0,0,1,0,1,204,20.4,1,2,3,3,6.6,16945,14371,1437.1,-2392,-3401,0
849,-1293,-625,1626.2,16262,18551,7.0,4,4,4,224,22.4,0,0,1,0,0,243,24.3,0,5,7,7,7.2,19176,17555,1755.5,625,1293,0
850,906,1767,1623.9,16239,18466,7.2,5,5,7,189,18.9,0,0,0,1,1,221,22.1,1,3,3,3,6.6,16699,15333,1533.3,-1767,-906,1
851,-2761,-2375,1694.4,16944,17663,7.0,6,6,9,193,19.3,0,0,0,1,1,227,22.7,1,12,12,12,7.4,20038,19705,1970.5,2375,2761,0
852,1419,731,1693.9,16939,17733,7.0,6,6,12,211,21.1,2,1,1,0,0,227,22.7,0,6,4,4,6.6,17002,15520,1552.0,-731,-1419,1
853,-1530,-1114,1461.5,14615,18302,7.0,2,2,3,221,22.1,0,0,1,0,1,243,24.3,1,5,4,4,7.4,19416,16145,1614.5,1114,1530,0
854,216,1250,1770.6,17706,18475,6.8,8,8,11,231,23.1,0,0,0,1,0,204,20.4,0,7,8,8,6.8,17225,17490,1749.0,-1250,-216,1
855,1521,1915,1772.7,17727,18993,7.2,8,8,7,217,21.7,1,1,1,0,0,198,19.8,1,7,5,5,6.8,17078,16206,1620.6,-1915,-1521,0
856,-5264,-4627,1298.8,12988,14678,6.2,0,0,0,153,15.3,0,0,0,1,1,273,27.3,2,10,8,8,7.2,19305,18252,1825.2,4627,5264,0
857,3949,2440,1761.3,17613,19092,7.2,8,8,8,234,23.4,1,1,1,0,0,216,21.6,0,2,1,1,6.6,16652,13664,1366.4,-2440,-3949,1
858,2907,1175,1863.2,18632,19093,7.2,11,11,12,227,22.7,1,1,1,0,0,204,20.4,0,8,5,5,7.0,17918,15725,1572.5,-1175,-2907,1
859,-706,-873,1547.6,15476,18246,7.0,5,5,2,233,23.3,1,1,1,0,0,244,24.4,0,7,6,6,7.4,19119,16182,1618.2,873,706,1
860,-527,-208,1571.7,15717,17679,6.8,4,4,5,224,22.4,0,0,1,0,1,199,19.9,1,9,5,5,6.8,17887,16244,1624.4,208,527,0
861,1683,-172,1825.3,18253,17351,6.8,8,8,8,240,24.0,1,1,0,1,0,203,20.3,0,6,8,8,6.8,17523,16570,1657.0,172,-1683,1
862,-1005,-251,1434.9,14349,16271,6.6,3,3,2,205,20.5,0,0,1,0,0,228,22.8,0,3,5,5,6.4,16522,15354,1535.4,251,1005,0
863,-1122,-302,1540.7,15407,17007,6.6,4,4,6,232,23.2,1,1,0,1,0,214,21.4,0,8,6,6,6.8,17309,16529,1652.9,302,1122,0
864,-808,-311,1527.3,15273,17539,6.8,4,4,4,211,21.1,1,1,1,0,0,238,23.8,0,6,5,5,7.2,17850,16081,1608.1,311,808,0
865,-2281,-1594,1486.8,14868,16330,6.6,4,4,5,182,18.2,0,0,1,0,1,209,20.9,1,9,6,6,6.8,17924,17149,1714.9,1594,2281,0
866,-1750,-628,1489.2,14892,17899,6.8,4,4,4,199,19.9,0,0,0,1,1,250,25.0,1,4,4,4,7.2,18527,16642,1664.2,628,1750,1
867,2974,1421,1850.9,18509,20432,7.6,10,10,12,223,22.3,0,0,1,0,1,213,21.3,1,5,4,4,7.4,19011,15535,1553.5,-1421,-2974,1
868,419,462,1709.6,17096,19253,7.2,6,6,9,241,24.1,0,0,0,1,1,247,24.7,1,5,4,4,7.2,18791,16677,1667.7,-462,-419,1
869,2101,1596,1737.7,17377,19245,7.2,6,6,10,247,24.7,2,1,0,1,0,193,19.3,0,5,3,3,6.8,17649,15276,1527.6,-1596,-2101,1
870,-776,166,1655.4,16554,18512,7.0,7,7,5,235,23.5,1,1,0,1,0,259,25.9,0,14,7,7,6.8,18346,17330,1733.0,-166,776,0
871,-957,-2267,1525.6,15256,16513,6.8,4,4,6,210,21.0,0,0,0,1,1,235,23.5,1,5,5,5,7.2,18780,16213,1621.3,2267,957,1
872,4311,3239,1771.0,17710,19233,7.2,9,9,7,230,23.0,2,1,1,0,0,201,20.1,0,0,1,1,6.6,15994,13399,1339.9,-3239,-4311,1
873,-1207,-1748,1504.1,15041,16622,7.0,4,4,3,214,21.4,1,1,0,1,0,228,22.8,0,3,5,5,7.0,18370,16248,1624.8,1748,1207,0
874,4616,2050,1902.7,19027,19029,7.2,9,9,9,247,24.7,2,1,1,0,0,187,18.7,0,1,3,3,6.6,16979,14411,1441.1,-2050,-4616,1
875,2404,927,1871.8,18718,18807,7.4,10,10,16,214,21.4,2,1,1,0,0,228,22.8,0,6,6,6,7.0,17880,16314,1631.4,-927,-2404,1
876,600,824,1693.8,16938,19399,7.2,7,7,10,231,23.1,1,1,0,1,0,229,22.9,1,8,5,5,7.0,18575,16338,1633.8,-824,-600,0
877,1936,1799,1677.2,16772,18456,7.0,7,7,3,255,25.5,0,0,1,0,1,205,20.5,1,4,3,3,6.6,16657,14836,1483.6,-1799,-1936,1
878,-4685,-3600,1603.5,16035,16424,6.6,6,6,9,160,16.0,1,1,0,1,0,244,24.4,0,23,13,13,7.6,20024,20720,2072.0,3600,4685,1
879,315,-61,1551.8,15518,16768,6.6,3,3,5,234,23.4,1,1,0,1,0,216,21.6,0,4,3,3,6.6,16829,15203,1520.3,61,-315,0
880,994,-547,1754.3,17543,17748,7.0,7,7,12,195,19.5,1,0,1,0,1,215,21.5,1,11,7,7,7.0,18295,16549,1654.9,547,-994,0
881,450,661,1582.9,15829,17924,7.0,3,3,4,242,24.2,1,0,0,1,1,239,23.9,1,5,4,4,6.6,17263,15379,1537.9,-661,-450,1
882,110,-402,1738.9,17389,18695,7.0,5,5,6,231,23.1,1,0,0,1,0,231,23.1,0,9,8,8,7.2,19097,17279,1727.9,402,-110,1
883,-396,481,1668.3,16683,18315,7.2,7,7,7,231,23.1,0,0,0,1,1,246,24.6,2,5,7,7,6.8,17834,17079,1707.9,-481,396,1
884,-805,254,1698.5,16985,18802,7.0,6,6,8,240,24.0,0,0,0,1,1,221,22.1,1,10,8,8,7.0,18548,17790,1779.0,-254,805,0
885,-1302,-1959,1490.4,14904,15958,6.6,2,2,2,222,22.2,0,0,1,0,1,194,19.4,2,6,8,8,7.0,17917,16206,1620.6,1959,1302,0
886,1763,-239,1755.1,17551,17463,6.6,8,8,12,237,23.7,1,1,1,0,0,213,21.3,0,6,5,5,7.0,17702,15788,1578.8,239,-1763,0
887,-1993,-2178,1527.8,15278,16785,6.4,5,5,3,186,18.6,1,1,0,1,0,211,21.1,0,5,9,9,7.0,18963,17271,1727.1,2178,1993,0
888,8,572,1553.9,15539,17101,6.8,6,6,5,191,19.1,2,1,0,1,0,208,20.8,0,8,6,6,6.4,16529,15531,1553.1,-572,-8,0
889,1240,-349,1786.0,17860,17606,6.8,11,11,16,172,17.2,0,0,1,0,0,202,20.2,1,6,8,8,6.8,17955,16620,1662.0,349,-1240,1
890,-1063,-2035,1515.6,15156,17247,6.6,3,3,2,207,20.7,1,1,1,0,0,229,22.9,0,4,5,5,7.2,19282,16219,1621.9,2035,1063,1
891,22,1773,1815.2,18152,18823,7.0,9,9,11,223,22.3,1,1,1,0,0,200,20.0,1,10,6,6,6.6,17050,18130,1813.0,-1773,-22,1
892,-16,497,1658.7,16587,18340,7.0,5,5,9,252,25.2,0,0,1,0,1,242,24.2,2,5,4,4,7.0,17843,16603,1660.3,-497,16,1
893,-526,496,1556.2,15562,18694,7.2,4,4,5,235,23.5,1,1,0,1,0,219,21.9,0,2,3,3,7.0,18198,16088,1608.8,-496,526,0
894,-916,-659,1494.4,14944,16969,6.8,4,4,4,200,20.0,0,0,0,1,1,193,19.3,1,8,6,6,7.0,17628,15860,1586.0,659,916,1
895,-2793,-1055,1526.9,15269,16739,6.6,5,5,8,194,19.4,1,1,0,1,0,204,20.4,0,13,10,10,6.8,17794,18062,1806.2,1055,2793,0
896,-1561,925,1716.6,17166,18945,7.2,7,7,7,224,22.4,0,0,0,1,1,177,17.7,2,10,9,9,7.0,18020,18727,1872.7,-925,1561,0
897,-3707,-1742,1481.3,14813,16945,6.8,5,5,6,182,18.2,0,0,0,1,1,225,22.5,2,10,11,11,7.2,18687,18520,1852.0,1742,3707,1
898,-2457,-1625,1578.7,15787,16711,6.8,6,6,7,205,20.5,0,0,1,0,0,238,23.8,1,10,10,10,7.0,18336,18244,1824.4,1625,2457,0
899,-2348,-1246,1479.5,14795,15646,6.4,6,6,4,172,17.2,0,0,0,1,1,193,19.3,1,10,8,8,6.6,16892,17143,1714.3,1246,2348,0
900,5275,3662,1984.8,19848,19712,7.2,15,15,15,224,22.4,1,1,1,0,0,227,22.7,0,0,2,2,6.6,16050,14573,1457.3,-3662,-5275,1
901,-3413,-3079,1388.6,13886,15720,6.6,1,1,1,222,22.2,0,0,1,0,1,245,24.5,1,3,7,7,7.2,18799,17299,1729.9,3079,3413,0
902,-1286,-848,1614.9,16149,17146,6.8,6,6,4,212,21.2,0,0,0,1,0,190,19.0,0,14,10,10,7.0,17994,17435,1743.5,848,1286,1
903,-1785,-1581,1531.2,15312,16667,6.6,7,7,4,174,17.4,0,0,0,1,1,216,21.6,2,4,7,7,7.0,18248,17097,1709.7,1581,1785,1
904,3107,2096,1726.7,17267,18482,7.2,7,7,10,224,22.4,1,1,1,0,0,218,21.8,0,0,2,2,6.6,16386,14160,1416.0,-2096,-3107,1
905,-41,-1008,1596.1,15961,17670,7.0,5,5,3,224,22.4,1,1,0,1,0,233,23.3,0,2,4,4,7.2,18678,16002,1600.2,1008,41,0
906,639,1171,1770.4,17704,18183,7.0,9,9,12,196,19.6,0,0,1,0,0,208,20.8,0,10,7,7,6.4,17012,17065,1706.5,-1171,-639,1
907,-2041,-1090,1480.8,14808,18642,7.2,1,1,2,240,24.0,0,0,0,1,1,227,22.7,1,6,6,6,7.4,19732,16849,1684.9,1090,2041,0
908,412,93,1637.4,16374,18711,7.2,5,5,3,227,22.7,1,1,1,0,0,234,23.4,0,1,4,4,7.2,18618,15962,1596.2,-93,-412,0
909,2836,448,1693.3,16933,18512,7.2,6,6,11,242,24.2,0,0,1,0,0,207,20.7,1,0,1,1,6.8,18064,14097,1409.7,-448,-2836,0
910,957,469,1815.6,18156,18548,7.2,11,11,12,208,20.8,0,0,1,0,1,218,21.8,2,5,8,8,6.8,18079,17199,1719.9,-469,-957,1
911,2287,2551,1939.7,19397,19301,7.0,12,12,9,232,23.2,0,0,0,1,0,184,18.4,0,4,9,9,6.6,16750,17110,1711.0,-2551,-2287,1
912,-462,-1186,1703.3,17033,16630,6.8,7,7,10,209,20.9,0,0,1,0,0,213,21.3,0,9,9,9,7.0,17816,17495,1749.5,1186,462,0
913,1362,1592,1906.1,19061,19093,7.2,11,11,7,236,23.6,1,1,0,1,0,191,19.1,0,11,10,10,6.8,17501,17699,1769.9,-1592,-1362,1
914,140,1737,1665.3,16653,19603,7.4,7,7,3,229,22.9,1,0,0,1,0,229,22.9,0,5,6,6,7.0,17866,16513,1651.3,-1737,-140,1
915,633,-295,1678.1,16781,17452,6.6,5,5,5,237,23.7,1,1,1,0,0,180,18.0,0,13,8,8,6.8,17747,16148,1614.8,295,-633,1
916,-323,214,1597.8,15978,18068,6.8,5,5,5,210,21.0,0,0,0,1,1,203,20.3,1,6,6,6,7.0,17854,16301,1630.1,-214,323,0
917,-1296,227,1585.9,15859,19145,7.0,3,3,3,241,24.1,0,0,0,1,1,257,25.7,1,7,6,6,7.2,18918,17155,1715.5,-227,1296,1
918,-3622,-1908,1620.5,16205,16887,6.4,6,6,6,196,19.6,0,0,0,1,1,224,22.4,2,16,14,14,7.0,18795,19827,1982.7,1908,3622,1
919,-541,546,1752.8,17528,17194,6.8,10,10,11,197,19.7,0,0,0,1,1,223,22.3,1,11,10,10,6.6,16648,18069,1806.9,-546,541,1
920,1933,2792,1715.4,17154,18697,7.0,8,8,9,202,20.2,0,0,1,0,0,174,17.4,0,6,6,6,6.6,15905,15221,1522.1,-2792,-1933,1
921,-692,-758,1611.2,16112,18339,7.2,4,4,6,247,24.7,0,0,0,1,1,223,22.3,2,7,7,7,7.2,19097,16804,1680.4,758,692,0
922,766,-662,1621.0,16210,17888,7.2,5,5,7,226,22.6,0,0,0,1,0,202,20.2,0,2,3,3,6.8,18550,15444,1544.4,662,-766,0
923,2334,1835,1836.9,18369,20686,7.4,6,6,10,276,27.6,1,0,1,0,1,249,24.9,1,2,4,4,7.2,18851,16035,1603.5,-1835,-2334,1
924,-143,462,1609.7,16097,17793,6.8,5,5,4,243,24.3,0,0,1,0,0,198,19.8,0,8,7,7,6.6,17331,16240,1624.0,-462,143,1
925,-5525,-5585,1319.6,13196,15515,6.4,1,1,2,194,19.4,0,0,0,1,0,252,25.2,0,8,11,11,7.8,21100,18721,1872.1,5585,5525,0
926,-1493,-1179,1555.2,15552,17234,6.6,5,5,8,201,20.1,0,0,0,1,1,250,25.0,1,5,4,4,7.0,18413,17045,1704.5,1179,1493,0
927,2534,2539,1759.7,17597,17045,6.8,11,11,21,190,19.0,1,1,1,0,0,188,18.8,0,5,6,6,6.2,14506,15063,1506.3,-2539,-2534,1
928,-5900,-4872,1570.9,15709,17397,6.8,5,5,6,216,21.6,0,0,0,1,1,270,27.0,2,8,15,15,7.8,22269,21609,2160.9,4872,5900,0
929,851,327,1703.5,17035,18139,7.0,5,5,8,230,23.0,2,1,1,0,0,219,21.9,0,6,6,6,6.6,17812,16184,1618.4,-327,-851,0
930,198,726,1500.0,15000,17972,7.0,3,3,2,229,22.9,2,1,0,1,0,220,22.0,0,3,3,3,6.8,17246,14802,1480.2,-726,-198,1
931,380,-674,1842.6,18426,20198,7.6,9,9,7,240,24.0,0,0,0,1,1,211,21.1,1,6,9,9,7.6,20872,18046,1804.6,674,-380,1
932,2018,2261,1763.4,17634,19000,7.0,8,8,7,242,24.2,2,1,1,0,0,233,23.3,0,2,4,4,6.6,16739,15616,1561.6,-2261,-2018,1
933,6942,6381,2025.1,20251,20985,7.4,11,11,13,263,26.3,1,0,0,1,1,186,18.6,1,1,1,1,6.2,14604,13309,1330.9,-6381,-6942,1
934,-754,-729,1603.4,16034,16642,6.6,7,7,13,199,19.9,1,1,1,0,0,224,22.4,0,12,7,7,6.8,17371,16788,1678.8,729,754,0
935,-1400,-1716,1414.7,14147,16605,6.6,2,2,4,226,22.6,0,0,1,0,1,197,19.7,1,9,5,5,7.0,18321,15547,1554.7,1716,1400,0
936,1606,1036,1830.4,18304,19032,7.2,9,9,11,237,23.7,1,1,0,1,0,198,19.8,1,9,8,8,7.0,17996,16698,1669.8,-1036,-1606,0
937,-2130,-2032,1510.4,15104,17002,6.6,5,5,6,186,18.6,1,1,0,1,0,259,25.9,0,3,5,5,7.2,19034,17234,1723.4,2032,2130,0
938,987,642,1884.7,18847,19480,7.2,10,10,17,213,21.3,1,1,1,0,0,206,20.6,0,8,10,10,7.2,18838,17860,1786.0,-642,-987,0
939,1344,1195,1578.2,15782,18460,6.8,2,2,1,253,25.3,0,0,0,1,0,236,23.6,0,1,2,2,6.8,17265,14438,1443.8,-1195,-1344,1
940,568,1096,1689.3,16893,18950,7.0,6,6,6,238,23.8,1,1,0,1,0,231,23.1,0,6,5,5,7.0,17854,16325,1632.5,-1096,-568,1
941,2621,2001,1854.5,18545,19051,7.2,10,10,12,200,20.0,1,0,0,1,1,206,20.6,1,5,5,5,6.8,17050,15924,1592.4,-2001,-2621,0
942,-403,-575,1691.8,16918,18911,7.0,6,6,5,233,23.3,0,0,0,1,1,225,22.5,1,5,8,8,7.2,19486,17321,1732.1,575,403,0
943,3593,727,1872.2,18722,18343,6.8,13,13,14,187,18.7,1,1,1,0,0,209,20.9,0,6,4,4,6.8,17616,15129,1512.9,-727,-3593,1
944,3400,2400,1824.7,18247,18839,7.0,6,6,8,235,23.5,1,1,1,0,0,209,20.9,1,3,3,3,6.6,16439,14847,1484.7,-2400,-3400,1
945,1019,37,1747.1,17471,17895,6.8,6,6,8,217,21.7,1,1,0,1,0,206,20.6,0,4,5,5,6.8,17858,16452,1645.2,-37,-1019,0
946,1496,1352,1764.1,17641,19312,7.2,7,7,4,237,23.7,0,0,0,1,1,214,21.4,1,4,6,6,7.0,17960,16145,1614.5,-1352,-1496,1
947,-3921,-3284,1460.5,14605,16395,6.6,4,4,6,181,18.1,0,0,0,1,1,242,24.2,1,12,9,9,7.0,19679,18526,1852.6,3284,3921,0
948,675,377,1624.9,16249,17860,6.6,6,6,4,224,22.4,0,0,1,0,1,220,22.0,1,4,3,3,7.0,17483,15574,1557.4,-377,-675,1
949,-702,-2110,1715.7,17157,17928,7.0,6,6,8,226,22.6,0,0,1,0,1,208,20.8,2,5,9,9,7.6,20038,17859,1785.9,2110,702,0
950,-1286,-1695,1516.5,15165,17251,6.8,4,4,5,218,21.8,0,0,1,0,1,244,24.4,1,5,5,5,7.2,18946,16451,1645.1,1695,1286,1
951,-174,-503,1542.7,15427,17722,6.8,5,5,5,215,21.5,0,0,0,1,1,229,22.9,1,4,4,4,7.0,18225,15601,1560.1,503,174,0
952,2301,603,1787.8,17878,18248,7.0,10,10,10,214,21.4,0,0,1,0,0,203,20.3,0,5,5,5,6.8,17645,15577,1557.7,-603,-2301,1
953,2504,2361,1800.0,18000,19946,7.4,10,10,4,236,23.6,0,0,1,0,0,191,19.1,0,7,6,6,7.0,17585,15496,1549.6,-2361,-2504,0
954,-1341,445,1585.1,15851,19296,7.0,5,5,9,215,21.5,0,0,0,1,1,237,23.7,1,6,7,7,7.0,18851,17192,1719.2,-445,1341,1
955,-2174,-325,1583.2,15832,17750,6.6,5,5,3,229,22.9,1,1,0,1,0,221,22.1,0,11,9,9,7.0,18075,18006,1800.6,325,2174,0
956,1804,820,1893.1,18931,18806,7.2,10,10,14,222,22.2,1,1,1,0,0,211,21.1,0,10,10,10,7.0,17986,17127,1712.7,-820,-1804,0
957,68,-369,1615.7,16157,17238,6.8,7,7,6,201,20.1,0,0,1,0,1,213,21.3,1,7,4,4,7.0,17607,16089,1608.9,369,-68,0
958,1775,-5,1835.4,18354,17746,6.8,11,11,12,207,20.7,0,0,1,0,0,208,20.8,0,3,6,6,6.8,17751,16579,1657.9,5,-1775,1
959,424,1050,1727.4,17274,20199,7.4,7,7,10,246,24.6,0,0,0,1,1,245,24.5,1,4,5,5,7.2,19149,16850,1685.0,-1050,-424,0
960,-2585,204,1537.2,15372,17002,6.8,4,4,5,213,21.3,1,0,0,1,1,209,20.9,1,12,11,11,6.8,16798,17957,1795.7,-204,2585,0
961,1610,2488,2017.5,20175,20673,7.4,13,13,17,215,21.5,1,1,0,1,0,212,21.2,0,13,12,12,6.8,18185,18565,1856.5,-2488,-1610,1
962,904,195,1548.6,15486,17388,7.0,5,5,5,205,20.5,1,0,0,1,1,216,21.6,1,3,3,3,6.8,17193,14582,1458.2,-195,-904,0
963,-855,227,1607.4,16074,18077,7.0,4,4,4,237,23.7,1,0,1,0,1,211,21.1,1,10,9,9,7.0,17850,16929,1692.9,-227,855,1
964,1991,1977,1684.9,16849,18439,7.0,7,7,7,231,23.1,0,0,0,1,1,223,22.3,1,3,3,3,6.4,16462,14858,1485.8,-1977,-1991,1
965,-2893,-2027,1629.1,16291,17343,6.8,6,6,9,188,18.8,0,0,0,1,1,236,23.6,2,15,10,10,7.2,19370,19184,1918.4,2027,2893,0
966,-2274,-2172,1616.4,16164,17971,7.0,5,5,4,233,23.3,0,0,0,1,1,240,24.0,1,10,8,8,7.4,20143,18438,1843.8,2172,2274,0
967,-154,-612,1700.2,17002,17795,7.0,7,7,6,221,22.1,1,1,0,1,0,225,22.5,1,4,8,8,7.0,18407,17156,1715.6,612,154,1
968,-1630,-130,1534.2,15342,17286,6.8,5,5,4,194,19.4,0,0,0,1,1,216,21.6,1,12,9,9,7.0,17416,16972,1697.2,130,1630,0
969,-6878,-4956,1311.9,13119,15498,6.2,1,1,2,199,19.9,0,0,0,1,1,275,27.5,2,9,9,9,7.4,20454,19997,1999.7,4956,6878,0
970,1177,763,1747.2,17472,18967,7.2,8,8,7,224,22.4,1,1,1,0,0,183,18.3,0,7,7,7,7.2,18204,16295,1629.5,-763,-1177,1
971,919,1527,1568.1,15681,19274,7.0,3,3,1,231,23.1,0,0,0,1,1,230,23.0,1,2,2,2,7.0,17747,14762,1476.2,-1527,-919,1
972,2077,1804,1863.4,18634,19500,7.0,8,8,7,239,23.9,0,0,1,0,1,196,19.6,1,12,6,6,6.8,17696,16557,1655.7,-1804,-2077,1
973,-2973,-1940,1388.1,13881,16550,6.8,1,1,0,209,20.9,0,0,0,1,1,222,22.2,1,13,6,6,7.0,18490,16854,1685.4,1940,2973,0
974,-3228,-2075,1814.5,18145,17219,6.6,10,10,10,199,19.9,1,0,1,0,1,237,23.7,1,13,16,16,7.2,19294,21373,2137.3,2075,3228,0
975,-999,-1466,1730.8,17308,16748,6.8,9,9,16,203,20.3,1,1,1,0,0,212,21.2,1,13,10,10,7.2,18214,18307,1830.7,1466,999,1
976,-6395,-4800,1304.9,13049,14294,6.2,2,2,0,163,16.3,0,0,0,1,1,239,23.9,2,20,13,13,7.2,19094,19444,1944.4,4800,6395,0
977,5853,3870,2007.5,20075,18552,7.0,14,14,15,220,22.0,0,0,1,0,0,179,17.9,0,6,4,4,6.2,14682,14222,1422.2,-3870,-5853,1
978,-5141,-4745,1437.7,14377,15120,6.4,3,3,2,158,15.8,0,0,0,1,1,241,24.1,1,12,11,11,7.4,19865,19518,1951.8,4745,5141,0
979,2318,1656,1727.0,17270,17435,6.6,9,9,9,213,21.3,0,0,1,0,0,220,22.0,0,3,3,3,6.6,15779,14952,1495.2,-1656,-2318,1
980,3595,2595,1896.7,18967,19855,7.6,12,12,6,240,24.0,0,0,1,0,1,217,21.7,1,3,5,5,6.8,17260,15372,1537.2,-2595,-3595,1
981,-6604,-2014,1404.4,14044,16501,6.6,2,2,2,191,19.1,0,0,0,1,1,236,23.6,2,6,10,10,7.2,18515,20648,2064.8,2014,6604,0
982,-530,-123,1646.7,16467,18715,7.2,4,4,5,261,26.1,0,0,0,1,1,227,22.7,1,8,6,6,7.0,18838,16997,1699.7,123,530,0
983,-796,-594,1784.6,17846,18045,6.8,8,8,5,198,19.8,0,0,1,0,0,194,19.4,0,12,13,13,7.2,18639,18642,1864.2,594,796,1
984,3439,913,1999.3,19993,17656,7.0,12,12,17,203,20.3,2,1,1,0,0,209,20.9,0,8,6,6,6.8,16743,16554,1655.4,-913,-3439,1
985,1423,1022,1622.3,16223,19667,7.2,4,4,4,232,23.2,1,1,1,0,0,242,24.2,1,1,1,1,7.0,18645,14800,1480.0,-1022,-1423,0
986,-3952,-2015,1407.1,14071,16382,6.4,2,2,3,202,20.2,1,1,1,0,0,228,22.8,0,8,8,8,7.0,18397,18023,1802.3,2015,3952,0
987,-884,-471,1528.4,15284,18267,7.2,3,3,3,245,24.5,2,1,1,0,0,227,22.7,0,2,3,3,7.2,18738,16168,1616.8,471,884,1
988,2655,1326,1634.6,16346,19072,7.0,4,4,3,272,27.2,1,0,1,0,1,218,21.8,1,0,0,0,6.8,17746,13691,1369.1,-1326,-2655,0
989,-2031,-1121,1435.8,14358,16775,6.6,2,2,3,225,22.5,1,1,0,1,0,223,22.3,0,6,7,7,7.0,17896,16389,1638.9,1121,2031,0
990,2893,3588,1720.6,17206,20071,7.4,7,7,7,248,24.8,1,0,1,0,1,218,21.8,1,4,2,2,6.6,16483,14313,1431.3,-3588,-2893,1
991,-976,-1408,1476.7,14767,18018,7.2,2,2,3,236,23.6,0,0,1,0,0,215,21.5,1,4,4,4,7.2,19426,15743,1574.3,1408,976,1
992,2182,1012,1829.1,18291,18548,7.2,12,12,13,176,17.6,0,0,1,0,0,210,21.0,0,4,7,7,6.8,17536,16109,1610.9,-1012,-2182,1
993,-1968,-2932,1497.9,14979,17163,6.8,3,3,5,203,20.3,0,0,0,1,1,238,23.8,1,6,5,5,7.2,20095,16947,1694.7,2932,1968,0
994,-1806,123,1721.4,17214,18251,7.0,7,7,6,231,23.1,0,0,0,1,1,204,20.4,1,13,9,9,7.0,18128,19020,1902.0,-123,1806,1
995,-5941,-4097,1646.1,16461,15402,6.4,7,7,11,177,17.7,0,0,0,1,1,241,24.1,2,18,16,16,7.2,19499,22402,2240.2,4097,5941,0
996,-2105,-1815,1402.7,14027,16596,6.6,3,3,2,219,21.9,0,0,0,1,0,261,26.1,0,4,5,5,7.0,18411,16132,1613.2,1815,2105,1
997,993,593,1743.2,17432,19324,7.4,7,7,6,224,22.4,0,0,0,1,0,209,20.9,0,11,5,5,7.4,18731,16439,1643.9,-593,-993,1
998,-809,10,1596.9,15969,17938,6.8,6,6,5,231,23.1,0,0,1,0,0,216,21.6,0,8,8,8,6.6,17928,16778,1677.8,-10,809,1
999,-1903,-1398,1630.8,16308,17166,6.8,7,7,5,195,19.5,0,0,1,0,1,214,21.4,1,10,11,11,7.2,18564,18211,1821.1,1398,1903,0
1000,-2325,-2078,1411.9,14119,16231,6.6,2,2,2,216,21.6,0,0,0,1,1,235,23.5,1,9,5,5,6.8,18309,16444,1644.4,2078,2325,0
1001,-100,-1205,1604.4,16044,19133,7.2,6,6,4,214,21.4,2,1,1,0,0,234,23.4,0,2,4,4,7.6,20338,16144,1614.4,1205,100,1
1002,-4396,-2703,1501.1,15011,16617,6.6,4,4,2,183,18.3,1,1,0,1,0,245,24.5,0,16,11,11,7.2,19320,19407,1940.7,2703,4396,0
1003,-3525,-3278,1451.7,14517,15493,6.4,3,3,6,169,16.9,0,0,0,1,1,202,20.2,2,15,8,8,7.0,18771,18042,1804.2,3278,3525,0
1004,-3728,-3076,1365.3,13653,16539,6.6,1,1,2,220,22.0,0,0,0,1,0,220,22.0,0,4,6,6,7.4,19615,17381,1738.1,3076,3728,0
1005,1256,301,1783.3,17833,18351,7.0,8,8,13,191,19.1,0,0,1,0,0,193,19.3,0,7,8,8,7.0,18050,16577,1657.7,-301,-1256,0
1006,3082,3200,1775.9,17759,18824,7.0,9,9,14,228,22.8,1,1,1,0,0,168,16.8,1,4,4,4,6.2,15624,14677,1467.7,-3200,-3082,1
1007,197,1241,1615.8,16158,17652,7.0,6,6,6,240,24.0,0,0,0,1,0,205,20.5,0,10,6,6,6.6,16411,15961,1596.1,-1241,-197,0
1008,482,914,1614.7,16147,18863,7.0,4,4,3,222,22.2,1,0,0,1,1,199,19.9,1,4,5,5,7.0,17949,15665,1566.5,-914,-482,0
1009,1019,327,1706.5,17065,18634,7.0,6,6,7,220,22.0,0,0,0,1,1,233,23.3,1,7,5,5,7.0,18307,16046,1604.6,-327,-1019,0
1010,817,266,1728.7,17287,18953,7.0,8,8,6,215,21.5,2,1,1,0,0,218,21.8,0,7,7,7,7.2,18687,16470,1647.0,-266,-817,1
1011,499,2441,1599.7,15997,19158,7.2,6,6,4,195,19.5,2,1,1,0,0,210,21.0,0,4,4,4,6.6,16717,15498,1549.8,-2441,-499,1
1012,-923,-1234,1538.7,15387,18342,7.0,3,3,4,215,21.5,0,0,1,0,1,232,23.2,1,5,3,3,7.4,19576,16310,1631.0,1234,923,1
1013,-531,241,1631.3,16313,17908,7.0,5,5,6,211,21.1,1,1,0,1,0,205,20.5,1,4,8,8,6.8,17667,16844,1684.4,-241,531,1
1014,1033,372,1598.7,15987,18632,7.0,4,4,4,252,25.2,0,0,0,1,0,231,23.1,0,3,3,3,7.0,18260,14954,1495.4,-372,-1033,0
1015,-2336,-1468,1630.4,16304,16307,6.4,7,7,9,169,16.9,0,0,0,1,0,211,21.1,1,9,8,8,7.0,17775,18640,1864.0,1468,2336,1
1016,-1253,-1627,1817.7,18177,17640,6.8,10,10,11,203,20.3,1,0,1,0,1,235,23.5,1,15,12,12,7.2,19267,19430,1943.0,1627,1253,1
1017,2851,1313,1749.3,17493,18552,7.0,7,7,6,240,24.0,1,1,0,1,0,198,19.8,0,4,4,4,6.8,17239,14642,1464.2,-1313,-2851,1
1018,5349,4131,1944.3,19443,19743,7.2,12,12,16,254,25.4,1,1,1,0,0,190,19.0,0,3,3,3,6.6,15612,14094,1409.4,-4131,-5349,1
1019,-1670,-540,1492.0,14920,17571,6.6,4,4,5,186,18.6,0,0,0,1,1,233,23.3,2,1,5,5,7.0,18111,16590,1659.0,540,1670,0
1020,225,787,1751.1,17511,17230,6.8,9,9,8,216,21.6,0,0,0,1,0,206,20.6,0,14,8,8,6.6,16443,17286,1728.6,-787,-225,0
1021,459,-1147,1681.9,16819,17163,6.8,9,9,10,197,19.7,1,1,1,0,0,235,23.5,1,3,5,5,6.8,18310,16360,1636.0,1147,-459,1
1022,-2127,-1619,1470.3,14703,16970,6.8,3,3,5,198,19.8,0,0,1,0,1,233,23.3,1,10,6,6,7.0,18589,16830,1683.0,1619,2127,1
1023,575,706,1680.1,16801,18747,7.4,7,7,5,203,20.3,0,0,1,0,1,214,21.4,1,7,5,5,7.0,18041,16226,1622.6,-706,-575,1
1024,-329,-230,1625.4,16254,18913,7.2,4,4,7,248,24.8,0,0,1,0,0,272,27.2,0,5,5,5,7.2,19143,16583,1658.3,230,329,0
1025,-2375,-293,1547.8,15478,18212,6.8,4,4,4,204,20.4,1,1,0,1,0,236,23.6,0,4,6,6,7.0,18505,17853,1785.3,293,2375,1
1026,-2623,-2312,1536.3,15363,16498,6.4,5,5,4,206,20.6,0,0,0,1,0,226,22.6,1,16,10,10,7.0,18810,17986,1798.6,2312,2623,1
1027,217,434,1712.1,17121,16462,6.6,9,9,12,212,21.2,0,0,1,0,0,173,17.3,1,9,8,8,6.4,16028,16904,1690.4,-434,-217,1
1028,-4160,-6073,1506.9,15069,14655,6.2,5,5,5,172,17.2,0,0,0,1,1,231,23.1,1,10,13,13,7.4,20728,19229,1922.9,6073,4160,0
1029,-498,-1785,1589.1,15891,15926,6.4,5,5,1,179,17.9,1,1,0,1,0,196,19.6,0,4,5,5,6.8,17711,16389,1638.9,1785,498,0
1030,-4500,-2980,1331.6,13316,16245,6.6,1,1,1,188,18.8,0,0,0,1,1,215,21.5,1,11,9,9,7.2,19225,17816,1781.6,2980,4500,0
1031,-43,-1154,1595.6,15956,17199,6.8,6,6,11,215,21.5,0,0,1,0,0,226,22.6,0,4,4,4,7.2,18353,15999,1599.9,1154,43,0
1032,-643,-1199,1566.1,15661,18396,7.0,3,3,2,225,22.5,2,1,1,0,0,256,25.6,0,5,3,3,7.2,19595,16304,1630.4,1199,643,1
1033,1206,968,1678.9,16789,17947,7.0,6,6,5,198,19.8,0,0,1,0,0,192,19.2,0,5,5,5,6.6,16979,15583,1558.3,-968,-1206,1
1034,-3529,-1509,1634.7,16347,17442,6.6,5,5,5,212,21.2,2,1,1,0,0,214,21.4,0,15,12,12,7.4,18951,19876,1987.6,1509,3529,0
1035,-1123,-976,1490.1,14901,16728,6.8,3,3,3,201,20.1,0,0,0,1,1,232,23.2,1,6,6,6,6.8,17704,16024,1602.4,976,1123,0
1036,1096,120,1701.8,17018,17105,7.0,8,8,12,190,19.0,1,1,1,0,0,196,19.6,0,4,7,7,6.8,16985,15922,1592.2,-120,-1096,0
1037,-5219,-3480,1634.2,16342,16909,6.6,8,8,12,165,16.5,0,0,0,1,0,263,26.3,0,15,13,13,7.4,20389,21561,2156.1,3480,5219,0
1038,-3527,-1901,1480.1,14801,16202,6.2,5,5,3,209,20.9,1,1,0,1,0,230,23.0,0,12,11,11,7.0,18103,18328,1832.8,1901,3527,0
1039,1936,1447,1733.3,17333,17113,6.8,9,9,17,209,20.9,0,0,1,0,0,197,19.7,0,5,6,6,6.4,15666,15397,1539.7,-1447,-1936,0
1040,-1729,-1258,1505.2,15052,16945,7.0,4,4,6,194,19.4,0,0,0,1,1,226,22.6,1,8,7,7,7.0,18203,16781,1678.1,1258,1729,0
1041,-797,-843,1558.5,15585,17392,6.8,4,4,5,227,22.7,0,0,1,0,0,241,24.1,0,7,6,6,7.0,18235,16382,1638.2,843,797,1
1042,-764,-1142,1527.3,15273,17980,7.0,3,3,4,214,21.4,0,0,0,1,1,248,24.8,1,1,5,5,7.0,19122,16037,1603.7,1142,764,0
1043,-2484,-3235,1566.6,15666,15541,6.6,5,5,7,188,18.8,0,0,1,0,1,235,23.5,1,5,9,9,7.2,18776,18150,1815.0,3235,2484,0
1044,-2269,-1078,1459.1,14591,17470,6.8,2,2,0,219,21.9,1,0,0,1,1,223,22.3,1,7,8,8,7.2,18548,16860,1686.0,1078,2269,0
1045,-1753,-3324,1469.0,14690,15769,6.2,3,3,5,191,19.1,0,0,0,1,0,210,21.0,0,4,7,7,7.0,19093,16443,1644.3,3324,1753,0
1046,-1122,-926,1715.1,17151,17777,6.8,7,7,8,193,19.3,0,0,0,1,1,234,23.4,2,6,7,7,7.2,18703,18273,1827.3,926,1122,0
1047,428,-558,1637.8,16378,17819,6.8,6,6,6,211,21.1,0,0,1,0,1,216,21.6,2,6,6,6,7.0,18377,15950,1595.0,558,-428,0
1048,-945,-2334,1566.1,15661,15375,6.4,5,5,7,208,20.8,0,0,0,1,0,234,23.4,0,5,7,7,7.0,17709,16606,1660.6,2334,945,0
1049,-17,-355,1658.9,16589,18105,7.0,7,7,4,231,23.1,0,0,1,0,1,220,22.0,1,4,4,4,7.2,18460,16606,1660.6,355,17,0
1050,-1286,-995,1590.0,15900,17700,6.8,3,3,3,234,23.4,2,1,1,0,0,214,21.4,0,6,6,6,7.0,18695,17186,1718.6,995,1286,0
1051,-2614,-1880,1492.7,14927,15638,6.6,5,5,8,196,19.6,0,0,1,0,1,214,21.4,1,16,9,9,6.8,17518,17541,1754.1,1880,2614,1
1052,2231,223,1687.5,16875,18159,6.8,2,2,0,247,24.7,1,0,1,0,1,190,19.0,1,3,3,3,6.8,17936,14644,1464.4,-223,-2231,1
1053,3060,1838,1784.7,17847,18916,7.0,8,8,8,207,20.7,1,0,1,0,0,221,22.1,0,3,2,2,6.6,17078,14787,1478.7,-1838,-3060,0
1054,311,-50,1636.9,16369,18278,7.0,6,6,9,201,20.1,0,0,1,0,0,216,21.6,0,5,6,6,7.2,18328,16058,1605.8,50,-311,1
1055,2850,1646,1732.0,17320,18965,7.4,4,4,7,264,26.4,2,1,1,0,0,248,24.8,0,0,1,1,6.8,17319,14470,1447.0,-1646,-2850,1
1056,3195,1370,1853.2,18532,20134,7.4,9,9,6,231,23.1,1,1,1,0,0,223,22.3,0,1,4,4,7.2,18764,15337,1533.7,-1370,-3195,1
1057,1363,-147,1713.6,17136,18233,7.0,8,8,10,202,20.2,0,0,1,0,0,218,21.8,1,2,6,6,7.0,18380,15773,1577.3,147,-1363,0
1058,1025,-199,1713.7,17137,18448,7.2,8,8,7,192,19.2,0,0,0,1,1,187,18.7,1,4,6,6,6.8,18647,16112,1611.2,199,-1025,0
1059,2544,-21,1911.4,19114,18680,7.0,8,8,11,245,24.5,1,0,1,0,1,209,20.9,1,10,7,7,7.0,18701,16570,1657.0,21,-2544,0
1060,-6373,-5156,1355.5,13555,13939,6.0,2,2,2,150,15.0,0,0,0,1,1,242,24.2,2,9,10,10,7.2,19095,19928,1992.8,5156,6373,0
1061,-2268,-2502,1470.7,14707,16234,6.6,4,4,5,213,21.3,0,0,1,0,1,254,25.4,1,5,5,5,7.2,18736,16975,1697.5,2502,2268,1
1062,-44,-357,1602.5,16025,17956,7.0,3,3,2,214,21.4,0,0,1,0,1,220,22.0,1,5,7,7,7.0,18313,16069,1606.9,357,44,0
1063,357,-26,1677.6,16776,15799,6.4,8,8,11,196,19.6,0,0,1,0,0,186,18.6,0,7,7,7,6.2,15825,16419,1641.9,26,-357,0
1064,236,-37,1537.9,15379,17670,7.0,3,3,1,232,23.2,0,0,0,1,1,217,21.7,1,5,3,3,6.8,17707,15143,1514.3,37,-236,1
1065,2973,1440,1719.6,17196,19002,7.2,5,5,6,239,23.9,1,1,1,0,0,239,23.9,0,2,1,1,6.8,17562,14223,1422.3,-1440,-2973,1
1066,2977,3051,1720.0,17200,19346,7.2,7,7,4,234,23.4,1,1,1,0,0,211,21.1,0,1,1,1,6.6,16295,14223,1422.3,-3051,-2977,1
1067,-423,-1210,1747.2,17472,17708,7.2,9,9,11,180,18.0,1,0,0,1,1,221,22.1,1,11,8,8,7.2,18918,17895,1789.5,1210,423,0
1068,-1077,-2560,1543.5,15435,17093,6.8,4,4,5,231,23.1,0,0,1,0,0,249,24.9,0,1,5,5,7.4,19653,16512,1651.2,2560,1077,0
1069,1782,1959,1658.8,16588,19189,7.2,6,6,5,229,22.9,1,1,1,0,0,189,18.9,1,1,4,4,6.8,17230,14806,1480.6,-1959,-1782,1
1070,941,129,1678.4,16784,17848,7.0,6,6,7,228,22.8,0,0,1,0,0,176,17.6,0,4,6,6,6.8,17719,15843,1584.3,-129,-941,1
1071,-1346,-1607,1698.2,16982,18420,7.0,9,9,11,191,19.1,1,1,0,1,0,212,21.2,0,7,8,8,7.4,20027,18328,1832.8,1607,1346,1
1072,-1430,-2349,1763.5,17635,16554,6.6,9,9,11,175,17.5,0,0,1,0,1,219,21.9,1,13,13,13,7.2,18903,19065,1906.5,2349,1430,1
1073,-1091,-892,1591.3,15913,18220,6.8,5,5,2,225,22.5,0,0,0,1,1,208,20.8,1,6,8,8,7.2,19112,17004,1700.4,892,1091,0
1074,-2088,-2747,1448.7,14487,16054,6.4,4,4,6,170,17.0,1,1,0,1,0,217,21.7,0,6,7,7,7.4,18801,16575,1657.5,2747,2088,0
1075,-1045,169,1564.3,15643,18376,6.8,2,2,1,233,23.3,0,0,1,0,0,229,22.9,0,3,3,3,7.2,18207,16688,1668.8,-169,1045,0
1076,213,-583,1685.3,16853,18782,7.2,5,5,5,233,23.3,0,0,0,1,0,249,24.9,0,2,5,5,7.0,19365,16640,1664.0,583,-213,1
1077,4484,2878,1824.2,18242,17997,7.0,12,12,14,195,19.5,1,0,1,0,0,199,19.9,0,1,2,2,6.2,15119,13758,1375.8,-2878,-4484,1
1078,-1543,-523,1686.6,16866,17575,6.8,7,7,8,194,19.4,0,0,1,0,0,207,20.7,1,7,7,7,7.0,18098,18409,1840.9,523,1543,1
1079,-2599,-818,1467.3,14673,18411,7.2,2,2,2,232,23.2,0,0,0,1,1,271,27.1,1,7,5,5,7.0,19229,17272,1727.2,818,2599,0
1080,-338,-9,1546.3,15463,17936,6.8,4,4,4,215,21.5,0,0,1,0,1,217,21.7,1,6,5,5,7.2,17945,15801,1580.1,9,338,1
1081,-2047,-2330,1582.4,15824,16324,6.6,6,6,6,210,21.0,1,1,0,1,0,205,20.5,1,8,9,9,6.8,18654,17871,1787.1,2330,2047,1
1082,1192,449,1712.9,17129,17579,6.8,8,8,13,227,22.7,0,0,0,1,0,225,22.5,0,7,5,5,6.8,17130,15937,1593.7,-449,-1192,1
1083,1167,489,1633.5,16335,17761,6.8,6,6,4,236,23.6,0,0,0,1,1,206,20.6,1,1,3,3,6.8,17272,15168,1516.8,-489,-1167,1
1084,1579,1223,1709.9,17099,18702,7.0,6,6,8,208,20.8,0,0,0,1,1,228,22.8,1,3,4,4,6.8,17479,15520,1552.0,-1223,-1579,0
1085,5271,3997,1907.7,19077,20483,7.6,10,10,6,234,23.4,1,1,1,0,0,191,19.1,0,2,2,2,6.6,16486,13806,1380.6,-3997,-5271,1
1086,-1607,-1043,1498.3,14983,17958,6.8,1,1,0,271,27.1,0,0,0,1,1,212,21.2,1,10,7,7,7.0,19001,16590,1659.0,1043,1607,1
1087,280,-1018,1736.8,17368,18134,6.8,9,9,9,219,21.9,0,0,0,1,0,227,22.7,0,8,6,6,7.2,19152,17088,1708.8,1018,-280,1
1088,-2811,-2702,1528.6,15286,17397,6.8,3,3,4,225,22.5,0,0,0,1,1,247,24.7,2,11,8,8,7.6,20099,18097,1809.7,2702,2811,0
1089,-1025,-1767,1631.7,16317,17669,7.0,5,5,5,209,20.9,0,0,0,1,0,245,24.5,0,4,8,8,7.2,19436,17342,1734.2,1767,1025,0
1090,409,1681,1636.4,16364,19838,7.4,5,5,9,245,24.5,2,1,0,1,0,229,22.9,0,3,4,4,6.8,18157,15955,1595.5,-1681,-409,1
1091,-417,-1234,1462.3,14623,15613,6.6,3,3,6,173,17.3,1,1,1,0,0,207,20.7,0,4,3,3,6.8,16847,15040,1504.0,1234,417,0
1092,4534,1707,1993.8,19938,18437,7.0,10,10,12,222,22.2,0,0,1,0,1,214,21.4,1,4,5,5,6.6,16730,15404,1540.4,-1707,-4534,1
1093,-1437,-1656,1622.1,16221,17699,7.0,5,5,5,216,21.6,0,0,0,1,1,227,22.7,2,4,8,8,7.2,19355,17658,1765.8,1656,1437,0
1094,-3011,-1199,1654.4,16544,17779,6.8,7,7,5,194,19.4,1,1,1,0,0,222,22.2,0,20,12,12,7.0,18978,19555,1955.5,1199,3011,1
1095,653,430,1790.8,17908,19202,7.2,8,8,7,229,22.9,0,0,0,1,1,247,24.7,1,9,7,7,7.2,18772,17255,1725.5,-430,-653,1
1096,1134,1160,1583.1,15831,19463,7.4,2,2,1,271,27.1,0,0,0,1,1,238,23.8,1,0,2,2,7.0,18303,14697,1469.7,-1160,-1134,0
1097,1024,750,1766.8,17668,18804,7.2,9,9,9,230,23.0,0,0,1,0,0,226,22.6,0,5,7,7,7.2,18054,16644,1664.4,-750,-1024,1
1098,-1708,-677,1547.0,15470,17038,6.8,5,5,6,217,21.7,0,0,0,1,0,207,20.7,0,12,7,7,7.2,17715,17178,1717.8,677,1708,0
1099,442,541,1644.8,16448,17691,6.8,6,6,5,207,20.7,0,0,0,1,0,221,22.1,0,3,6,6,6.8,17150,16006,1600.6,-541,-442,1
1100,-1550,-1018,1487.7,14877,17258,7.0,5,5,2,205,20.5,0,0,0,1,0,211,21.1,0,8,7,7,7.0,18276,16427,1642.7,1018,1550,1
1101,4611,3311,1891.7,18917,19563,7.6,13,13,18,226,22.6,0,0,1,0,0,213,21.3,0,1,1,1,6.6,16252,14306,1430.6,-3311,-4611,1
1102,-2865,-3840,1635.6,16356,16343,6.4,6,6,8,202,20.2,0,0,1,0,1,223,22.3,2,10,9,9,7.4,20183,19221,1922.1,3840,2865,0
1103,-1563,-1232,1467.6,14676,16668,6.6,3,3,5,170,17.0,0,0,0,1,1,201,20.1,1,3,7,7,6.8,17900,16239,1623.9,1232,1563,0
1104,-4394,-3817,1312.6,13126,14222,6.0,2,2,3,175,17.5,0,0,1,0,1,195,19.5,1,11,12,12,7.0,18039,17520,1752.0,3817,4394,0
1105,1417,1116,1776.9,17769,18832,7.2,10,10,14,207,20.7,0,0,0,1,1,215,21.5,1,3,6,6,7.0,17716,16352,1635.2,-1116,-1417,1
1106,-485,-353,1605.1,16051,17315,6.8,6,6,4,199,19.9,0,0,0,1,1,199,19.9,1,8,8,8,6.8,17668,16536,1653.6,353,485,0
1107,2234,1606,1739.5,17395,18998,7.2,6,6,6,252,25.2,1,0,1,0,1,226,22.6,1,5,3,3,7.0,17392,15161,1516.1,-1606,-2234,0
1108,1896,1069,1681.9,16819,17190,6.8,8,8,12,199,19.9,1,1,1,0,0,216,21.6,0,5,4,4,6.6,16121,14923,1492.3,-1069,-1896,1
1109,199,403,1631.5,16315,17744,6.8,5,5,8,236,23.6,2,1,0,1,0,227,22.7,0,9,6,6,6.6,17341,16116,1611.6,-403,-199,0
1110,-1705,-1679,1684.6,16846,17698,6.8,7,7,8,246,24.6,1,1,1,0,0,240,24.0,1,5,6,6,7.2,19377,18551,1855.1,1679,1705,1
1111,-675,-1212,1595.1,15951,18136,7.0,2,2,1,236,23.6,1,0,1,0,0,234,23.4,0,6,5,5,7.2,19348,16626,1662.6,1212,675,0
1112,1160,1541,1685.8,16858,18658,7.0,7,7,8,228,22.8,1,1,0,1,0,244,24.4,0,6,3,3,6.6,17117,15698,1569.8,-1541,-1160,1
1113,1287,-749,1733.5,17335,16110,6.6,10,10,10,176,17.6,0,0,1,0,1,198,19.8,1,11,9,9,6.6,16859,16048,1604.8,749,-1287,1
1114,-2063,-1448,1678.1,16781,17415,6.8,7,7,7,194,19.4,0,0,1,0,0,232,23.2,0,7,7,7,7.0,18863,18844,1884.4,1448,2063,0
1115,2559,2593,1722.5,17225,18183,6.8,8,8,11,222,22.2,0,0,0,1,0,209,20.9,0,4,4,4,6.2,15590,14666,1466.6,-2593,-2559,1
1116,2346,1424,1694.8,16948,18271,7.0,6,6,4,252,25.2,0,0,0,1,1,211,21.1,1,1,4,4,6.4,16847,14602,1460.2,-1424,-2346,1
1117,-1151,-1924,1605.6,16056,16268,6.6,7,7,7,188,18.8,1,1,0,1,0,235,23.5,1,14,7,7,7.0,18192,17207,1720.7,1924,1151,0
1118,-1729,118,1544.0,15440,15725,6.4,5,5,5,180,18.0,0,0,0,1,0,185,18.5,0,8,9,9,6.4,15607,17169,1716.9,-118,1729,1
1119,-1441,-2022,1605.8,16058,15685,6.4,8,8,12,178,17.8,1,1,1,0,0,240,24.0,0,10,6,6,6.8,17707,17499,1749.9,2022,1441,0
1120,763,1243,1631.5,16315,18479,7.0,5,5,3,256,25.6,1,1,1,0,0,218,21.8,0,3,4,4,6.8,17236,15552,1555.2,-1243,-763,1
1121,1209,574,1732.6,17326,18168,6.8,9,9,16,188,18.8,1,1,1,0,0,231,23.1,0,5,4,4,6.8,17594,16117,1611.7,-574,-1209,1
1122,1706,1154,1685.1,16851,18647,7.0,5,5,5,225,22.5,0,0,0,1,1,219,21.9,1,5,3,3,7.0,17493,15145,1514.5,-1154,-1706,0
1123,2097,1569,1685.3,16853,18346,6.8,6,6,4,234,23.4,0,0,1,0,0,228,22.8,0,1,2,2,6.6,16777,14756,1475.6,-1569,-2097,1
1124,2201,1421,1755.6,17556,19338,7.4,9,9,8,211,21.1,1,1,1,0,0,227,22.7,0,3,3,3,7.0,17917,15355,1535.5,-1421,-2201,1
1125,-2425,-1827,1784.0,17840,18114,7.0,11,11,9,175,17.5,0,0,1,0,1,197,19.7,2,12,12,12,7.4,19941,20265,2026.5,1827,2425,0
1126,2376,1325,1872.5,18725,19513,7.4,10,10,9,243,24.3,0,0,1,0,0,215,21.5,0,5,6,6,7.2,18188,16349,1634.9,-1325,-2376,0
1127,679,1400,1678.1,16781,18303,6.8,5,5,5,222,22.2,0,0,1,0,1,192,19.2,1,6,6,6,6.6,16903,16102,1610.2,-1400,-679,1
1128,-4864,-3336,1537.6,15376,16791,6.6,5,5,8,206,20.6,1,1,0,1,0,247,24.7,0,11,12,12,7.6,20127,20240,2024.0,3336,4864,0
1129,-3116,-1349,1419.3,14193,17801,7.0,2,2,1,218,21.8,0,0,0,1,0,247,24.7,0,7,6,6,7.4,19150,17309,1730.9,1349,3116,0
1130,-542,-254,1686.2,16862,18123,6.8,7,7,5,206,20.6,0,0,0,1,1,222,22.2,2,8,9,9,7.2,18377,17404,1740.4,254,542,1
1131,1634,546,1700.3,17003,18427,6.8,4,4,5,239,23.9,2,1,1,0,0,261,26.1,0,4,3,3,7.0,17881,15369,1536.9,-546,-1634,1
1132,-672,-1420,1550.6,15506,17710,6.8,4,4,5,231,23.1,0,0,0,1,1,214,21.4,1,4,6,6,7.2,19130,16178,1617.8,1420,672,0
1133,622,319,1872.4,18724,18411,6.8,10,10,15,221,22.1,0,0,0,1,1,220,22.0,2,16,10,10,7.0,18092,18102,1810.2,-319,-622,0
1134,1571,560,1642.2,16422,18048,6.8,4,4,3,242,24.2,1,0,1,0,1,211,21.1,1,3,3,3,7.0,17488,14851,1485.1,-560,-1571,1
1135,3211,3640,1833.7,18337,18978,7.2,13,13,10,194,19.4,1,0,1,0,0,182,18.2,0,6,5,5,6.4,15338,15126,1512.6,-3640,-3211,1
1136,-3134,-2772,1538.5,15385,16039,6.6,6,6,6,210,21.0,1,1,1,0,0,232,23.2,0,8,10,10,7.0,18811,18519,1851.9,2772,3134,1
1137,-1951,-872,1556.6,15566,17340,6.8,6,6,6,211,21.1,0,0,0,1,1,233,23.3,1,6,5,5,7.2,18212,17517,1751.7,872,1951,0
1138,3517,2356,1832.6,18326,19015,7.2,8,8,10,239,23.9,0,0,1,0,0,203,20.3,1,4,4,4,6.6,16659,14809,1480.9,-2356,-3517,1
1139,80,-599,1629.9,16299,17800,6.8,6,6,9,226,22.6,0,0,0,1,1,210,21.0,1,4,6,6,7.2,18399,16219,1621.9,599,-80,0
1140,-1380,-581,1399.1,13991,17215,6.8,1,1,1,221,22.1,0,0,0,1,1,224,22.4,1,2,3,3,7.0,17796,15371,1537.1,581,1380,0
1141,-1115,178,1420.5,14205,16546,6.6,3,3,4,203,20.3,0,0,0,1,1,192,19.2,1,4,4,4,6.6,16368,15320,1532.0,-178,1115,1
1142,3187,880,1795.5,17955,18774,7.2,6,6,11,270,27.0,0,0,1,0,1,230,23.0,1,1,2,2,6.8,17894,14768,1476.8,-880,-3187,0
1143,6423,3767,2086.2,20862,18335,7.0,13,13,16,232,23.2,0,0,1,0,0,148,14.8,0,8,5,5,6.2,14568,14439,1443.9,-3767,-6423,1
1144,-2313,-1210,1419.7,14197,17915,6.8,0,0,0,255,25.5,0,0,0,1,0,231,23.1,0,6,6,6,7.2,19125,16510,1651.0,1210,2313,0
1145,1346,919,1678.8,16788,19474,7.2,5,5,4,264,26.4,1,0,1,0,1,242,24.2,1,6,3,3,7.2,18555,15442,1544.2,-919,-1346,0
1146,-2402,-1757,1479.8,14798,16659,6.8,3,3,4,179,17.9,1,1,0,1,0,227,22.7,0,7,6,6,6.8,18416,17200,1720.0,1757,2402,1
1147,-1293,-260,1559.8,15598,17735,6.8,3,3,4,220,22.0,0,0,0,1,1,237,23.7,1,6,7,7,7.0,17995,16891,1689.1,260,1293,0
1148,2089,1675,1665.5,16655,19541,7.2,5,5,2,238,23.8,0,0,0,1,1,224,22.4,1,3,2,2,6.8,17866,14566,1456.6,-1675,-2089,1
1149,2290,1865,1680.4,16804,18899,7.2,8,8,9,206,20.6,1,1,0,1,0,180,18.0,0,2,4,4,6.6,17034,14514,1451.4,-1865,-2290,0
1150,-1397,-1549,1597.7,15977,17653,6.8,6,6,4,198,19.8,2,1,1,0,0,230,23.0,0,6,7,7,7.2,19202,17374,1737.4,1549,1397,1
1151,-360,-61,1565.4,15654,18324,7.2,4,4,2,233,23.3,1,1,0,1,0,254,25.4,1,2,3,3,7.0,18385,16014,1601.4,61,360,0
1152,5465,3492,1903.5,19035,19265,7.4,10,10,12,239,23.9,1,1,1,0,0,190,19.0,0,2,2,2,6.4,15773,13570,1357.0,-3492,-5465,1
1153,1032,1098,1624.7,16247,19687,7.4,4,4,5,226,22.6,1,0,0,1,1,243,24.3,1,2,2,2,7.0,18589,15215,1521.5,-1098,-1032,0
1154,1887,1295,1807.4,18074,19746,7.4,8,8,11,235,23.5,0,0,1,0,0,220,22.0,0,4,5,5,7.0,18451,16187,1618.7,-1295,-1887,0
1155,3640,2348,1727.4,17274,18134,7.0,8,8,9,233,23.3,1,0,1,0,0,202,20.2,0,0,2,2,6.4,15786,13634,1363.4,-2348,-3640,1
1156,1452,689,1783.9,17839,18614,7.0,10,10,12,201,20.1,0,0,0,1,1,198,19.8,1,5,7,7,7.2,17925,16387,1638.7,-689,-1452,1
1157,1806,4,1670.0,16700,17393,7.0,6,6,11,218,21.8,0,0,1,0,1,203,20.3,1,3,6,6,6.6,17389,14894,1489.4,-4,-1806,1
1158,66,-57,1585.2,15852,17369,6.8,6,6,10,192,19.2,0,0,0,1,1,232,23.2,1,5,5,5,6.8,17426,15786,1578.6,57,-66,1
1159,-112,-812,1529.6,15296,17179,6.6,4,4,4,221,22.1,0,0,1,0,1,222,22.2,1,4,4,4,6.8,17991,15408,1540.8,812,112,1
1160,-323,-615,1442.6,14426,17085,6.8,1,1,2,219,21.9,1,1,1,0,0,243,24.3,0,2,1,1,6.6,17700,14749,1474.9,615,323,1
1161,-82,745,1585.6,15856,19023,7.0,4,4,2,248,24.8,0,0,1,0,1,254,25.4,1,4,4,4,7.0,18278,15938,1593.8,-745,82,1
1162,2088,-118,1789.5,17895,16640,6.8,11,11,17,191,19.1,0,0,1,0,1,202,20.2,1,5,6,6,6.6,16758,15807,1580.7,118,-2088,1
1163,-2701,-2275,1572.8,15728,17183,6.6,6,6,9,208,20.8,0,0,1,0,0,208,20.8,0,8,9,9,7.2,19458,18429,1842.9,2275,2701,0
1164,781,-1744,1733.3,17333,16881,6.8,5,5,5,232,23.2,0,0,1,0,0,234,23.4,1,4,5,5,7.2,18625,16552,1655.2,1744,-781,1
1165,283,608,1640.4,16404,17425,6.8,8,8,9,197,19.7,0,0,1,0,1,216,21.6,1,8,7,7,6.6,16817,16121,1612.1,-608,-283,0
1166,-360,-708,1573.8,15738,17430,7.0,6,6,6,206,20.6,1,1,0,1,0,230,23.0,1,1,6,6,7.0,18138,16098,1609.8,708,360,1
1167,-4279,-4529,1358.0,13580,16571,6.4,0,0,0,207,20.7,0,0,0,1,1,266,26.6,2,2,4,4,7.6,21100,17859,1785.9,4529,4279,0
1168,120,-1254,1677.3,16773,17641,6.8,6,6,4,237,23.7,1,1,0,1,0,224,22.4,0,5,7,7,7.2,18895,16653,1665.3,1254,-120,0
1169,-1845,-1879,1499.3,14993,16251,6.6,4,4,5,215,21.5,0,0,0,1,1,229,22.9,1,10,8,8,7.0,18130,16838,1683.8,1879,1845,0
1170,-563,-1422,1521.9,15219,17357,6.8,2,2,1,241,24.1,0,0,1,0,1,225,22.5,1,3,3,3,7.0,18779,15782,1578.2,1422,563,0
1171,-1112,-942,1604.6,16046,16986,6.6,6,6,4,203,20.3,0,0,0,1,0,220,22.0,0,7,8,8,7.0,17928,17158,1715.8,942,1112,0
1172,-1906,-1476,1568.3,15683,17335,7.0,6,6,5,186,18.6,1,1,0,1,0,240,24.0,1,9,8,8,7.0,18811,17589,1758.9,1476,1906,0
1173,-2517,-1199,1640.8,16408,17435,6.8,5,5,5,199,19.9,1,1,0,1,0,248,24.8,0,12,9,9,7.2,18634,18925,1892.5,1199,2517,0
1174,-2831,-1651,1510.4,15104,17634,6.8,3,3,2,228,22.8,1,0,0,1,1,242,24.2,1,8,7,7,7.4,19285,17935,1793.5,1651,2831,0
1175,-1063,-632,1611.3,16113,16994,6.8,6,6,7,180,18.0,1,0,1,0,0,240,24.0,0,5,5,5,6.8,17626,17176,1717.6,632,1063,0
1176,1573,-624,1889.4,18894,17942,6.8,11,11,15,219,21.9,0,0,0,1,1,220,22.0,2,7,7,7,7.0,18566,17321,1732.1,624,-1573,1
1177,-427,-13,1665.2,16652,18147,6.8,7,7,5,212,21.2,0,0,0,1,0,226,22.6,0,9,9,9,7.0,18160,17079,1707.9,13,427,0
1178,-2161,-297,1540.9,15409,17089,6.8,4,4,4,218,21.8,0,0,0,1,0,187,18.7,0,18,10,10,6.6,17386,17570,1757.0,297,2161,0
1179,479,929,1673.3,16733,19524,7.4,8,8,8,193,19.3,0,0,0,1,1,233,23.3,1,3,4,4,7.0,18595,16254,1625.4,-929,-479,1
1180,3237,2107,1730.7,17307,16818,6.4,12,12,13,189,18.9,0,0,1,0,0,158,15.8,0,4,5,5,6.2,14711,14070,1407.0,-2107,-3237,1
1181,230,-105,1528.3,15283,17676,7.0,5,5,8,223,22.3,1,1,0,1,0,212,21.2,0,5,4,4,6.8,17781,15053,1505.3,105,-230,1
1182,-1217,-539,1442.8,14428,16819,6.6,3,3,1,215,21.5,0,0,0,1,1,216,21.6,1,11,7,7,6.8,17358,15645,1564.5,539,1217,0
1183,273,87,1667.9,16679,17760,7.0,7,7,12,193,19.3,1,1,1,0,0,215,21.5,0,9,6,6,6.8,17673,16406,1640.6,-87,-273,1
1184,-2552,-2052,1540.0,15400,16607,6.6,4,4,3,188,18.8,0,0,0,1,1,212,21.2,1,13,10,10,6.8,18659,17952,1795.2,2052,2552,0
1185,-4,-139,1623.0,16230,17336,6.8,7,7,6,216,21.6,0,0,0,1,0,177,17.7,0,5,7,7,7.0,17475,16234,1623.4,139,4,0
1186,-2863,-875,1602.8,16028,19000,7.4,4,4,3,249,24.9,1,1,0,1,0,242,24.2,0,6,7,7,7.4,19875,18891,1889.1,875,2863,0
1187,-85,-632,1573.1,15731,18954,7.2,4,4,2,250,25.0,0,0,1,0,0,229,22.9,0,3,4,4,7.2,19586,15816,1581.6,632,85,1
1188,-4490,-3582,1481.6,14816,16519,6.6,4,4,1,218,21.8,0,0,0,1,1,247,24.7,2,6,10,10,7.4,20101,19306,1930.6,3582,4490,0
1189,-988,470,1586.2,15862,19244,7.2,4,4,2,229,22.9,1,0,0,1,1,232,23.2,1,6,6,6,7.0,18774,16850,1685.0,-470,988,1
1190,-1481,-1506,1414.0,14140,17249,6.6,1,1,1,241,24.1,2,1,0,1,0,228,22.8,0,5,4,4,7.0,18755,15621,1562.1,1506,1481,1
1191,1109,718,1669.9,16699,18503,7.0,6,6,7,242,24.2,2,1,0,1,0,237,23.7,0,6,4,4,6.8,17785,15590,1559.0,-718,-1109,1
1192,-5392,-2904,1340.5,13405,15189,6.4,2,2,1,182,18.2,0,0,0,1,1,231,23.1,1,19,9,9,6.8,18093,18797,1879.7,2904,5392,0
1193,238,840,1753.8,17538,18073,7.0,8,8,5,224,22.4,0,0,0,1,1,191,19.1,1,10,10,10,6.8,17233,17300,1730.0,-840,-238,1
1194,4941,4702,1903.8,19038,19801,7.2,15,15,5,261,26.1,0,0,1,0,0,190,19.0,0,5,3,3,6.2,15099,14097,1409.7,-4702,-4941,0
1195,24,235,1808.2,18082,18637,7.2,9,9,10,209,20.9,0,0,0,1,1,200,20.0,2,11,12,12,7.0,18402,18058,1805.8,-235,-24,0
1196,-1113,-1381,1400.4,14004,16302,6.4,1,1,0,217,21.7,1,1,0,1,0,212,21.2,0,5,5,5,7.0,17683,15117,1511.7,1381,1113,0
1197,754,13,1634.9,16349,18699,7.2,4,4,5,253,25.3,0,0,0,1,1,243,24.3,1,3,4,4,7.2,18686,15595,1559.5,-13,-754,1
1198,-1942,140,1537.3,15373,18734,7.2,2,2,1,252,25.2,0,0,0,1,1,226,22.6,2,10,7,7,7.2,18594,17315,1731.5,-140,1942,0
1199,-167,39,1655.9,16559,18848,7.2,7,7,7,235,23.5,2,1,1,0,0,237,23.7,0,5,7,7,7.0,18809,16726,1672.6,-39,167,1
1200,3537,2976,1651.3,16513,18070,6.8,5,5,6,203,20.3,1,1,1,0,0,186,18.6,0,2,2,2,6.4,15094,12976,1297.6,-2976,-3537,1
1201,5349,3639,1988.6,19886,20060,7.4,10,10,10,240,24.0,1,0,1,0,0,189,18.9,0,5,3,3,6.6,16421,14537,1453.7,-3639,-5349,1
1202,2793,2280,1716.7,17167,19248,7.0,6,6,4,247,24.7,2,1,1,0,0,225,22.5,0,0,2,2,6.6,16968,14374,1437.4,-2280,-2793,1
1203,2192,464,1680.9,16809,18916,7.2,5,5,9,241,24.1,1,1,1,0,0,246,24.6,0,1,1,1,6.8,18452,14617,1461.7,-464,-2192,1
1204,-286,-494,1817.8,18178,17540,6.8,10,10,12,200,20.0,0,0,0,1,1,171,17.1,1,12,13,13,6.8,18034,18464,1846.4,494,286,0
1205,-3540,-3279,1474.2,14742,15941,6.6,3,3,4,215,21.5,0,0,0,1,1,227,22.7,1,13,10,10,7.2,19220,18282,1828.2,3279,3540,0
1206,-568,-345,1512.6,15126,17342,6.8,4,4,4,207,20.7,0,0,0,1,0,231,23.1,0,2,5,5,6.8,17687,15694,1569.4,345,568,1
1207,-2975,-2542,1544.9,15449,16663,6.6,5,5,7,195,19.5,0,0,0,1,1,258,25.8,1,15,9,9,7.2,19205,18424,1842.4,2542,2975,0
1208,-3184,-2345,1523.3,15233,16168,6.6,4,4,7,208,20.8,0,0,1,0,0,218,21.8,0,14,12,12,7.0,18513,18417,1841.7,2345,3184,0
1209,-2185,-2480,1460.2,14602,17042,6.8,2,2,3,208,20.8,0,0,0,1,1,232,23.2,1,4,6,6,7.2,19522,16787,1678.7,2480,2185,0
1210,-387,879,1539.0,15390,18666,7.0,3,3,5,245,24.5,0,0,0,1,0,239,23.9,0,8,4,4,7.0,17787,15777,1577.7,-879,387,1
1211,1543,828,1676.6,16766,18538,7.0,5,5,9,231,23.1,0,0,1,0,1,208,20.8,1,2,5,5,6.8,17710,15223,1522.3,-828,-1543,1
1212,-1908,-1654,1609.3,16093,16579,6.4,6,6,6,181,18.1,0,0,0,1,0,220,22.0,1,9,10,10,7.0,18233,18001,1800.1,1654,1908,1
1213,737,-691,1557.5,15575,16473,6.6,3,3,3,220,22.0,1,1,1,0,0,201,20.1,0,4,4,4,6.6,17164,14838,1483.8,691,-737,1
1214,1073,-541,1695.3,16953,17147,6.8,7,7,12,199,19.9,0,0,1,0,1,210,21.0,1,7,5,5,7.0,17688,15880,1588.0,541,-1073,1
1215,-413,-1004,1552.9,15529,17721,7.0,6,6,7,204,20.4,1,1,0,1,0,237,23.7,1,2,5,5,7.0,18725,15942,1594.2,1004,413,0
1216,2569,2378,1683.6,16836,19773,7.2,6,6,7,242,24.2,1,0,1,0,1,228,22.8,1,1,2,2,6.8,17395,14267,1426.7,-2378,-2569,1
1217,-3996,-2986,1382.0,13820,13497,5.8,3,3,2,158,15.8,0,0,1,0,1,190,19.0,1,14,9,9,6.6,16483,17816,1781.6,2986,3996,0
1218,2574,359,1932.1,19321,18437,7.0,12,12,25,226,22.6,1,1,1,0,0,228,22.8,0,9,6,6,7.0,18078,16747,1674.7,-359,-2574,1
1219,-191,-182,1583.4,15834,18088,6.8,3,3,6,228,22.8,0,0,1,0,1,208,20.8,1,6,5,5,7.2,18270,16025,1602.5,182,191,0
1220,-536,-864,1658.5,16585,16982,6.8,7,7,10,191,19.1,1,1,0,1,0,234,23.4,0,9,7,7,6.8,17846,17121,1712.1,864,536,1
1221,-1429,-683,1548.3,15483,16690,6.8,5,5,6,174,17.4,1,1,0,1,0,225,22.5,0,10,8,8,6.8,17373,16912,1691.2,683,1429,0
1222,3797,2242,1783.4,17834,19145,7.2,6,6,5,276,27.6,1,0,1,0,1,202,20.2,1,3,2,2,6.8,16903,14037,1403.7,-2242,-3797,1
1223,2407,939,1685.8,16858,18543,7.2,5,5,7,251,25.1,1,1,1,0,0,221,22.1,0,3,2,2,6.6,17604,14451,1445.1,-939,-2407,1
1224,2828,1962,2061.9,20619,18696,7.4,17,17,19,205,20.5,0,0,0,1,1,198,19.8,1,7,9,9,6.8,16734,17791,1779.1,-1962,-2828,1
1225,2334,1246,1844.9,18449,19139,7.2,9,9,9,257,25.7,1,1,0,1,0,231,23.1,0,6,5,5,6.8,17893,16115,1611.5,-1246,-2334,1
1226,2301,3412,1735.4,17354,20449,7.4,7,7,9,224,22.4,0,0,0,1,0,240,24.0,0,4,3,3,6.6,17037,15053,1505.3,-3412,-2301,1
1227,853,363,1609.7,16097,16760,6.6,7,7,8,214,21.4,0,0,1,0,1,182,18.2,1,4,6,6,6.4,16397,15244,1524.4,-363,-853,0
1228,-243,418,1613.8,16138,17204,6.8,6,6,7,211,21.1,0,0,0,1,0,188,18.8,1,13,6,6,6.6,16786,16381,1638.1,-418,243,1
1229,4793,3669,1779.4,17794,17983,7.0,8,8,11,220,22.0,1,1,1,0,0,217,21.7,0,2,2,2,5.8,14314,13001,1300.1,-3669,-4793,1
1230,3248,2147,1921.8,19218,19389,7.0,11,11,15,197,19.7,1,1,1,0,0,205,20.5,0,4,6,6,6.8,17242,15970,1597.0,-2147,-3248,1
1231,2907,2700,1850.1,18501,19714,7.6,10,10,15,230,23.0,1,1,0,1,0,215,21.5,0,6,4,4,7.0,17014,15594,1559.4,-2700,-2907,1
1232,-1454,-616,1592.2,15922,19022,7.2,4,4,0,248,24.8,0,0,0,1,0,207,20.7,0,8,6,6,7.2,19638,17376,1737.6,616,1454,0
1233,292,-206,1611.9,16119,16372,6.6,6,6,7,203,20.3,0,0,1,0,1,206,20.6,1,6,7,7,6.6,16578,15827,1582.7,206,-292,1
1234,-2978,-2960,1462.5,14625,16487,6.6,3,3,4,200,20.0,1,1,1,0,0,190,19.0,0,12,11,11,7.4,19447,17603,1760.3,2960,2978,0
1235,-335,-681,1668.5,16685,17591,6.8,7,7,6,193,19.3,1,1,0,1,0,228,22.8,1,7,8,8,6.8,18272,17020,1702.0,681,335,0
1236,-2894,-1742,1389.5,13895,16914,6.6,2,2,1,210,21.0,1,0,0,1,1,208,20.8,1,9,8,8,7.0,18656,16789,1678.9,1742,2894,0
1237,4401,2185,1989.0,19890,17275,6.8,14,14,22,174,17.4,0,0,0,1,1,204,20.4,1,6,6,6,6.2,15090,15489,1548.9,-2185,-4401,1
1238,-4055,-2248,1516.4,15164,16581,6.4,6,6,5,190,19.0,0,0,1,0,0,236,23.6,1,10,10,10,7.2,18829,19219,1921.9,2248,4055,0
1239,2084,2869,1749.8,17498,19402,7.4,10,10,7,224,22.4,0,0,1,0,0,228,22.8,0,4,4,4,6.4,16533,15414,1541.4,-2869,-2084,0
1240,2593,3690,1945.2,19452,20776,7.6,13,13,16,212,21.2,0,0,1,0,1,213,21.3,2,7,5,5,6.8,17086,16859,1685.9,-3690,-2593,1
1241,1372,2320,1732.2,17322,18525,7.0,9,9,7,255,25.5,1,1,0,1,0,213,21.3,0,6,5,5,6.6,16205,15950,1595.0,-2320,-1372,0
1242,2803,1638,1724.3,17243,18171,6.8,8,8,6,231,23.1,1,1,1,0,0,186,18.6,0,5,3,3,6.6,16533,14440,1444.0,-1638,-2803,1
1243,-533,944,1802.0,18020,19285,7.2,8,8,8,214,21.4,1,0,0,1,0,198,19.8,0,14,10,10,7.0,18341,18553,1855.3,-944,533,0
1244,-963,-64,1628.9,16289,17723,6.8,6,6,8,208,20.8,2,1,0,1,0,230,23.0,0,11,7,7,7.0,17787,17252,1725.2,64,963,0
1245,2642,366,1830.3,18303,19140,7.2,9,9,10,263,26.3,2,1,1,0,0,231,23.1,0,2,4,4,7.0,18774,15661,1566.1,-366,-2642,1
1246,-1615,-1585,1572.8,15728,16927,6.8,4,4,6,212,21.2,0,0,1,0,0,205,20.5,0,12,10,10,7.0,18512,17343,1734.3,1585,1615,0
1247,1212,1738,1609.7,16097,18426,7.0,6,6,5,226,22.6,0,0,1,0,1,216,21.6,2,1,3,3,6.6,16688,14885,1488.5,-1738,-1212,1
1248,-2363,-2144,1441.4,14414,16249,6.4,2,2,4,215,21.5,2,1,0,1,0,233,23.3,0,10,5,5,7.2,18393,16777,1677.7,2144,2363,0
1249,-1918,-1739,1585.2,15852,17330,6.8,9,9,5,194,19.4,1,1,1,0,0,213,21.3,1,10,8,8,7.2,19069,17770,1777.0,1739,1918,1
1250,145,-729,1520.2,15202,17438,6.8,4,4,4,215,21.5,0,0,1,0,0,247,24.7,1,2,3,3,6.8,18167,15057,1505.7,729,-145,1
1251,902,860,1557.2,15572,19166,7.2,2,2,1,242,24.2,0,0,1,0,1,231,23.1,1,4,3,3,6.8,18306,14670,1467.0,-860,-902,1
1252,-870,-1120,1648.8,16488,17386,7.0,8,8,6,208,20.8,0,0,1,0,1,241,24.1,1,7,8,8,7.2,18506,17358,1735.8,1120,870,0
1253,-4550,-3483,1435.3,14353,15067,6.2,5,5,11,168,16.8,1,1,0,1,0,216,21.6,0,19,12,12,7.2,18550,18903,1890.3,3483,4550,0
1254,4238,3475,1913.3,19133,20110,7.4,13,13,11,223,22.3,1,0,0,1,1,168,16.8,1,2,3,3,6.6,16635,14895,1489.5,-3475,-4238,1
1255,-1659,-1566,1531.4,15314,18205,7.0,3,3,4,233,23.3,0,0,0,1,0,253,25.3,0,5,5,5,7.4,19771,16973,1697.3,1566,1659,0
1256,1377,2429,1769.0,17690,18278,7.2,10,10,18,192,19.2,0,0,0,1,0,194,19.4,0,5,6,6,6.6,15849,16313,1631.3,-2429,-1377,0
1257,3663,2748,2018.3,20183,20663,7.6,10,10,15,216,21.6,2,1,1,0,0,192,19.2,0,6,6,6,6.8,17915,16520,1652.0,-2748,-3663,1
1258,2969,2575,1840.8,18408,19614,7.2,9,9,9,225,22.5,1,0,1,0,0,210,21.0,0,3,5,5,6.6,17039,15439,1543.9,-2575,-2969,1
1259,-3682,-4566,1559.5,15595,15756,6.4,6,6,6,159,15.9,0,0,0,1,0,240,24.0,0,13,12,12,7.6,20322,19277,1927.7,4566,3682,0
1260,-1362,-863,1711.9,17119,18174,7.0,8,8,9,209,20.9,0,0,1,0,0,235,23.5,0,9,9,9,7.4,19037,18481,1848.1,863,1362,1
1261,108,-88,1765.8,17658,17546,7.0,9,9,9,214,21.4,0,0,1,0,0,235,23.5,1,8,9,9,7.0,17634,17550,1755.0,88,-108,0
1262,5344,3506,1960.0,19600,20132,7.4,14,14,14,218,21.8,0,0,1,0,0,194,19.4,0,1,4,4,6.8,16626,14256,1425.6,-3506,-5344,1
1263,-3908,-2704,1633.6,16336,16919,6.8,7,7,8,190,19.0,0,0,0,1,1,208,20.8,1,17,14,14,7.2,19623,20244,2024.4,2704,3908,0
1264,2984,1565,1686.0,16860,18168,6.8,7,7,5,226,22.6,1,1,1,0,0,216,21.6,0,1,2,2,6.6,16603,13876,1387.6,-1565,-2984,1
1265,-250,489,1450.1,14501,16819,6.6,3,3,2,201,20.1,2,1,1,0,0,212,21.2,0,6,4,4,6.4,16330,14751,1475.1,-489,250,1
1266,1084,658,1714.8,17148,17427,7.0,7,7,8,226,22.6,0,0,0,1,1,207,20.7,2,8,7,7,6.4,16769,16064,1606.4,-658,-1084,0
1267,2606,964,1855.9,18559,18239,7.0,10,10,10,223,22.3,0,0,1,0,1,203,20.3,1,6,6,6,6.8,17275,15953,1595.3,-964,-2606,1
1268,154,-979,1625.0,16250,16288,6.6,3,3,4,215,21.5,1,0,0,1,1,230,23.0,1,11,5,5,6.8,17267,16096,1609.6,979,-154,0
1269,960,-812,1579.1,15791,17326,7.0,4,4,3,224,22.4,1,1,1,0,0,223,22.3,0,5,3,3,7.0,18138,14831,1483.1,812,-960,1
1270,-3194,-2675,1563.4,15634,16435,6.6,5,5,5,222,22.2,0,0,0,1,0,205,20.5,1,13,12,12,7.2,19110,18828,1882.8,2675,3194,0
1271,-44,-1601,1514.8,15148,16687,6.6,3,3,3,215,21.5,0,0,1,0,0,246,24.6,0,1,2,2,7.0,18288,15192,1519.2,1601,44,1
1272,1181,-934,1789.3,17893,17157,7.0,10,10,14,206,20.6,2,1,1,0,0,182,18.2,0,6,8,8,7.0,18091,16712,1671.2,934,-1181,1
1273,-927,-736,1620.0,16200,17810,6.6,7,7,12,202,20.2,1,1,1,0,0,207,20.7,1,11,8,8,7.2,18546,17127,1712.7,736,927,1
1274,-3170,-2591,1337.1,13371,15621,6.4,2,2,0,224,22.4,0,0,0,1,1,226,22.6,1,6,7,7,6.8,18212,16541,1654.1,2591,3170,0
1275,-623,1024,1590.3,15903,18823,7.0,6,6,5,205,20.5,0,0,0,1,1,205,20.5,1,5,7,7,7.0,17799,16526,1652.6,-1024,623,0
1276,-1121,4,1571.9,15719,17801,6.8,5,5,6,202,20.2,0,0,0,1,0,236,23.6,0,5,6,6,7.0,17797,16840,1684.0,-4,1121,1
1277,-5292,-4922,1326.7,13267,14831,6.2,2,2,2,185,18.5,0,0,0,1,1,237,23.7,1,12,9,9,7.2,19753,18559,1855.9,4922,5292,0
1278,1793,929,1630.5,16305,19758,7.2,4,4,4,253,25.3,2,1,1,0,0,204,20.4,0,1,1,1,7.2,18829,14512,1451.2,-929,-1793,1
1279,3389,3465,1826.9,18269,20290,7.6,8,8,8,258,25.8,0,0,1,0,0,239,23.9,0,1,2,2,6.4,16825,14880,1488.0,-3465,-3389,1
1280,-3532,-2062,1495.6,14956,16656,6.4,4,4,3,216,21.6,0,0,0,1,0,217,21.7,0,11,11,11,7.2,18718,18488,1848.8,2062,3532,0
1281,-981,264,1618.0,16180,17570,6.8,3,3,3,229,22.9,1,0,0,1,1,230,23.0,1,11,7,7,6.8,17306,17161,1716.1,-264,981,1
1282,616,-87,1680.8,16808,16741,6.8,8,8,12,200,20.0,0,0,1,0,0,198,19.8,0,8,6,6,6.6,16828,16192,1619.2,87,-616,0
1283,3146,1518,1797.1,17971,19214,7.2,10,10,7,231,23.1,1,0,1,0,1,181,18.1,1,2,5,5,7.0,17696,14825,1482.5,-1518,-3146,0
1284,2619,1209,1699.8,16998,18708,7.2,6,6,6,236,23.6,2,1,1,0,0,217,21.7,0,2,2,2,7.0,17499,14379,1437.9,-1209,-2619,1
1285,-5065,-3552,1501.5,15015,16032,6.6,5,5,6,167,16.7,2,1,0,1,0,224,22.4,0,9,14,14,7.4,19584,20080,2008.0,3552,5065,0
1286,-856,-563,1488.1,14881,18074,7.0,4,4,1,209,20.9,0,0,1,0,0,236,23.6,0,1,4,4,7.0,18637,15737,1573.7,563,856,1
1287,739,-270,1573.0,15730,18484,7.0,4,4,10,241,24.1,1,1,1,0,0,239,23.9,0,5,3,3,7.0,18754,14991,1499.1,270,-739,1
1288,2447,247,1909.8,19098,18636,7.0,16,16,14,203,20.3,1,1,1,0,0,207,20.7,0,3,5,5,7.0,18389,16651,1665.1,-247,-2447,1
1289,561,740,1616.9,16169,18880,7.2,5,5,6,235,23.5,0,0,0,1,0,235,23.5,0,3,3,3,7.0,18140,15608,1560.8,-740,-561,1
1290,-1073,210,1695.4,16954,16923,6.8,9,9,6,197,19.7,1,1,0,1,0,176,17.6,0,16,10,10,6.6,16713,18027,1802.7,-210,1073,0
1291,193,89,1598.4,15984,17527,7.2,5,5,5,203,20.3,0,0,0,1,0,222,22.2,0,4,4,4,6.8,17438,15791,1579.1,-89,-193,0
1292,1204,306,1807.8,18078,18614,7.0,8,8,8,261,26.1,0,0,1,0,1,204,20.4,1,7,7,7,6.8,18308,16874,1687.4,-306,-1204,1
1293,948,16,1632.9,16329,16575,6.4,9,9,9,206,20.6,1,1,1,0,0,173,17.3,0,4,5,5,6.8,16559,15381,1538.1,-16,-948,1
1294,-1027,-1434,1719.3,17193,18326,7.0,9,9,5,224,22.4,0,0,1,0,0,236,23.6,0,6,10,10,7.6,19760,18220,1822.0,1434,1027,0
1295,1843,1402,1840.1,18401,18465,7.0,11,11,13,201,20.1,1,1,1,0,0,212,21.2,0,8,6,6,6.8,17063,16558,1655.8,-1402,-1843,1
1296,-3517,-1818,1470.4,14704,17930,7.0,2,2,0,227,22.7,0,0,1,0,1,235,23.5,1,7,10,10,7.6,19748,18221,1822.1,1818,3517,0
1297,-1204,-717,1636.7,16367,18191,7.2,5,5,3,254,25.4,0,0,0,1,1,218,21.8,1,8,8,8,7.0,18908,17571,1757.1,717,1204,0
1298,-3927,-3257,1290.5,12905,15457,6.2,0,0,0,195,19.5,0,0,0,1,0,211,21.1,0,5,5,5,7.0,18714,16832,1683.2,3257,3927,0
1299,-2681,-834,1396.7,13967,16908,7.0,3,3,0,197,19.7,0,0,0,1,1,193,19.3,1,6,7,7,6.6,17742,16648,1664.8,834,2681,0
1300,300,1722,1651.1,16511,18106,7.0,8,8,9,199,19.9,1,1,0,1,0,225,22.5,0,7,6,6,6.6,16384,16211,1621.1,-1722,-300,0
1301,4,1213,1749.6,17496,19884,7.4,8,8,8,232,23.2,0,0,0,1,0,259,25.9,0,8,7,7,7.2,18671,17492,1749.2,-1213,-4,0
1302,1572,829,1774.3,17743,19173,7.4,7,7,6,255,25.5,1,1,1,0,0,218,21.8,0,4,6,6,7.0,18344,16171,1617.1,-829,-1572,1
1303,856,1638,1688.8,16888,18788,7.0,8,8,8,202,20.2,1,1,0,1,0,198,19.8,1,5,6,6,6.6,17150,16032,1603.2,-1638,-856,1
1304,-2296,-1213,1374.2,13742,17269,6.8,2,2,0,208,20.8,1,0,0,1,1,250,25.0,1,1,2,2,6.8,18482,16038,1603.8,1213,2296,0
1305,-1961,-392,1779.3,17793,18271,7.0,9,9,10,187,18.7,0,0,0,1,1,173,17.3,1,19,15,15,7.0,18663,19754,1975.4,392,1961,0
1306,-1320,-687,1617.8,16178,17363,6.8,5,5,6,221,22.1,0,0,1,0,0,185,18.5,1,10,8,8,7.2,18050,17498,1749.8,687,1320,0
1307,-492,-173,1770.6,17706,18217,6.8,8,8,8,217,21.7,1,1,0,1,0,230,23.0,0,11,8,8,7.2,18390,18198,1819.8,173,492,1
1308,34,-957,1614.9,16149,16641,6.8,6,6,5,199,19.9,2,1,1,0,0,184,18.4,0,9,9,9,6.8,17598,16115,1611.5,957,-34,1
1309,-1964,-3710,1476.0,14760,16005,6.4,3,3,2,183,18.3,0,0,1,0,1,200,20.0,1,6,8,8,7.4,19715,16724,1672.4,3710,1964,0
1310,-306,-282,1582.0,15820,17793,6.8,3,3,3,220,22.0,0,0,0,1,1,222,22.2,2,8,5,5,7.0,18075,16126,1612.6,282,306,0
1311,-2354,-1337,1517.3,15173,17165,7.0,5,5,3,183,18.3,1,0,0,1,1,210,21.0,1,7,9,9,7.0,18502,17527,1752.7,1337,2354,0
1312,-1071,-843,1476.9,14769,17725,6.8,4,4,5,215,21.5,0,0,0,1,0,242,24.2,0,2,3,3,7.0,18568,15840,1584.0,843,1071,0
1313,-1009,-280,1435.3,14353,17197,6.8,4,4,6,178,17.8,0,0,0,1,1,222,22.2,1,1,3,3,6.8,17477,15362,1536.2,280,1009,0
1314,147,-712,1676.3,16763,17757,7.0,8,8,11,216,21.6,0,0,1,0,0,240,24.0,0,8,4,4,7.0,18469,16616,1661.6,712,-147,1
1315,2126,1070,1674.7,16747,19858,7.2,5,5,5,250,25.0,0,0,1,0,0,227,22.7,0,1,2,2,7.0,18788,14621,1462.1,-1070,-2126,1
1316,845,-234,1704.4,17044,17686,6.8,8,8,7,217,21.7,0,0,1,0,1,207,20.7,1,5,5,5,6.8,17920,16199,1619.9,234,-845,0
1317,-1779,-354,1553.2,15532,17908,6.8,6,6,8,190,19.0,0,0,0,1,0,242,24.2,0,4,7,7,7.0,18262,17311,1731.1,354,1779,0
1318,-1305,-1101,1734.7,17347,18118,6.6,7,7,6,222,22.2,2,1,0,1,0,218,21.8,0,15,12,12,7.4,19219,18652,1865.2,1101,1305,0
1319,2137,490,1875.8,18758,18617,7.2,9,9,8,228,22.8,1,0,1,0,0,234,23.4,0,6,6,6,6.8,18127,16621,1662.1,-490,-2137,1
1320,3673,1956,2071.1,20711,20463,7.6,13,13,13,220,22.0,1,0,0,1,1,209,20.9,1,4,8,8,7.0,18507,17038,1703.8,-1956,-3673,1
1321,1947,1396,1653.9,16539,17585,7.0,8,8,9,205,20.5,0,0,0,1,0,196,19.6,0,3,4,4,6.6,16189,14592,1459.2,-1396,-1947,1
1322,895,910,1909.6,19096,19250,7.2,11,11,13,206,20.6,1,0,1,0,0,235,23.5,0,9,9,9,7.0,18340,18201,1820.1,-910,-895,1
1323,3413,396,1793.8,17938,16164,6.6,11,11,14,199,19.9,2,1,1,0,0,195,19.5,0,3,4,4,6.6,15768,14525,1452.5,-396,-3413,1
1324,-2298,-730,1707.2,17072,17724,6.8,8,8,8,180,18.0,0,0,1,0,1,242,24.2,2,5,11,11,7.0,18454,19370,1937.0,730,2298,1
1325,5151,3496,1964.0,19640,18636,7.0,12,12,18,216,21.6,1,1,1,0,0,175,17.5,0,5,4,4,6.0,15140,14489,1448.9,-3496,-5151,1
1326,-51,373,1689.1,16891,18224,7.0,7,7,6,214,21.4,1,1,1,0,0,218,21.8,1,8,5,5,6.8,17851,16942,1694.2,-373,51,1
1327,3075,1798,1748.5,17485,18330,7.0,9,9,6,234,23.4,1,1,1,0,0,214,21.4,0,2,3,3,6.6,16532,14410,1441.0,-1798,-3075,1
1328,1945,2614,1669.6,16696,18900,7.2,7,7,5,225,22.5,0,0,0,1,0,196,19.6,0,3,2,2,6.4,16286,14751,1475.1,-2614,-1945,0
1329,2644,2337,1749.9,17499,19191,7.2,8,8,4,231,23.1,1,1,1,0,0,208,20.8,0,2,3,3,6.6,16854,14855,1485.5,-2337,-2644,1
1330,2569,1891,1828.8,18288,19569,7.2,10,10,9,245,24.5,0,0,1,0,0,220,22.0,1,4,6,6,6.8,17678,15719,1571.9,-1891,-2569,1
1331,-1434,-1409,1568.4,15684,17384,6.8,5,5,7,170,17.0,0,0,1,0,0,223,22.3,1,3,6,6,7.2,18793,17118,1711.8,1409,1434,0
1332,92,728,1473.7,14737,18532,7.0,1,1,0,229,22.9,1,0,1,0,0,199,19.9,0,0,1,1,6.8,17804,14645,1464.5,-728,-92,0
1333,1326,351,1871.5,18715,18626,7.0,11,11,13,223,22.3,1,1,1,0,0,208,20.8,0,9,9,9,7.2,18275,17389,1738.9,-351,-1326,0
1334,1850,834,1855.1,18551,18363,7.2,7,7,9,225,22.5,1,1,0,1,0,210,21.0,0,7,6,6,7.0,17529,16701,1670.1,-834,-1850,1
1335,3969,3522,1935.1,19351,20590,7.4,12,12,16,220,22.0,1,1,1,0,0,221,22.1,0,4,4,4,6.6,17068,15382,1538.2,-3522,-3969,1
1336,-266,-1524,1731.8,17318,16336,6.6,8,8,12,175,17.5,0,0,0,1,1,217,21.7,1,9,8,8,6.8,17860,17584,1758.4,1524,266,0
1337,4139,3424,1896.9,18969,20353,7.6,10,10,11,205,20.5,1,1,1,0,0,172,17.2,0,2,4,4,6.8,16929,14830,1483.0,-3424,-4139,1
1338,3278,2617,1711.3,17113,18837,7.0,8,8,14,203,20.3,1,1,1,0,0,194,19.4,0,0,1,1,6.6,16220,13835,1383.5,-2617,-3278,1
1339,-1817,-354,1720.1,17201,18755,7.2,8,8,11,207,20.7,0,0,0,1,1,201,20.1,1,13,12,12,7.4,19109,19018,1901.8,354,1817,0
1340,1152,400,1674.9,16749,17788,6.8,8,8,4,217,21.7,0,0,1,0,1,185,18.5,1,7,5,5,6.6,17388,15597,1559.7,-400,-1152,1
1341,2592,1348,1652.3,16523,18881,7.2,4,4,4,222,22.2,0,0,0,1,1,202,20.2,1,2,2,2,6.6,17533,13931,1393.1,-1348,-2592,1
1342,4581,3919,1828.5,18285,19465,7.2,11,11,9,221,22.1,0,0,1,0,0,175,17.5,0,1,2,2,6.6,15546,13704,1370.4,-3919,-4581,0
1343,149,1781,1734.6,17346,18518,7.0,10,10,7,214,21.4,1,0,0,1,0,205,20.5,0,10,9,9,6.8,16737,17197,1719.7,-1781,-149,1
1344,2786,881,1744.3,17443,19184,7.4,7,7,11,238,23.8,0,0,1,0,0,212,21.2,0,2,3,3,6.8,18303,14657,1465.7,-881,-2786,0
1345,562,249,1652.6,16526,17213,6.6,7,7,12,211,21.1,0,0,0,1,1,233,23.3,1,9,4,4,6.8,16964,15964,1596.4,-249,-562,1
1346,903,1019,1736.3,17363,17169,6.8,7,7,8,188,18.8,0,0,1,0,0,205,20.5,1,7,8,8,6.4,16150,16460,1646.0,-1019,-903,1
1347,3679,2110,1877.9,18779,19556,7.2,10,10,9,252,25.2,1,1,0,1,0,203,20.3,0,3,4,4,6.6,17446,15100,1510.0,-2110,-3679,1
1348,3899,2300,2031.7,20317,18795,7.0,13,13,14,199,19.9,0,0,1,0,1,197,19.7,1,9,6,6,6.4,16495,16418,1641.8,-2300,-3899,0
1349,1281,1111,1564.9,15649,18530,7.0,2,2,2,269,26.9,1,1,1,0,0,225,22.5,0,0,1,1,7.0,17419,14368,1436.8,-1111,-1281,1
1350,329,-994,1625.6,16256,17524,7.2,5,5,6,217,21.7,0,0,1,0,0,224,22.4,0,5,5,5,7.2,18518,15927,1592.7,994,-329,0
1351,1008,-248,1668.8,16688,18697,7.0,5,5,7,247,24.7,0,0,1,0,1,199,19.9,1,5,6,6,7.4,18945,15680,1568.0,248,-1008,1
1352,3192,3351,1772.4,17724,19917,7.4,10,10,8,210,21.0,1,0,0,1,0,205,20.5,0,2,4,4,6.6,16566,14532,1453.2,-3351,-3192,0
1353,-4348,-4019,1532.0,15320,16625,6.8,3,3,2,176,17.6,1,0,0,1,1,208,20.8,1,15,15,15,7.6,20644,19668,1966.8,4019,4348,0
1354,-689,-1431,1590.0,15900,17169,6.8,6,6,8,203,20.3,1,1,0,1,0,218,21.8,0,8,7,7,7.2,18600,16589,1658.9,1431,689,1
1355,2963,141,1837.7,18377,17762,6.8,12,12,19,193,19.3,1,1,1,0,0,221,22.1,0,1,4,4,7.0,17621,15414,1541.4,-141,-2963,1
1356,-522,-1014,1578.5,15785,17629,6.8,4,4,5,210,21.0,1,1,0,1,0,221,22.1,0,4,6,6,7.0,18643,16307,1630.7,1014,522,0
1357,514,2073,1762.5,17625,19146,7.4,10,10,13,205,20.5,0,0,0,1,0,223,22.3,0,10,7,7,6.6,17073,17111,1711.1,-2073,-514,0
1358,4375,3249,1993.1,19931,18115,7.0,15,15,15,213,21.3,0,0,0,1,0,169,16.9,0,6,6,6,6.2,14866,15556,1555.6,-3249,-4375,0
1359,4289,3990,1933.1,19331,19211,7.0,14,14,15,213,21.3,1,1,1,0,0,171,17.1,0,7,4,4,6.4,15221,15042,1504.2,-3990,-4289,0
1360,-32,848,1704.8,17048,18842,7.2,6,6,4,201,20.1,1,1,0,1,0,197,19.7,0,9,9,9,7.0,17994,17080,1708.0,-848,32,1
1361,88,-589,1791.0,17910,16867,6.8,9,9,10,207,20.7,0,0,0,1,0,197,19.7,1,11,10,10,6.8,17456,17822,1782.2,589,-88,0
1362,3295,3468,1661.4,16614,18570,7.0,7,7,4,221,22.1,1,1,1,0,0,205,20.5,0,0,1,1,6.4,15102,13319,1331.9,-3468,-3295,1
1363,-467,-1361,1594.3,15943,17366,6.6,5,5,6,229,22.9,0,0,0,1,0,235,23.5,0,5,5,5,7.0,18727,16410,1641.0,1361,467,0
1364,-2611,-1375,1492.4,14924,17139,6.8,4,4,1,207,20.7,0,0,0,1,1,218,21.8,1,5,7,7,7.0,18514,17535,1753.5,1375,2611,1
1365,-1974,-589,1506.9,15069,16824,6.6,5,5,3,198,19.8,1,1,0,1,0,216,21.6,0,12,8,8,6.8,17413,17043,1704.3,589,1974,1
1366,-963,-457,1636.6,16366,17010,6.8,8,8,13,196,19.6,0,0,0,1,0,220,22.0,0,8,7,7,7.0,17467,17329,1732.9,457,963,1
1367,-5740,-3709,1415.8,14158,16377,6.6,2,2,2,194,19.4,0,0,0,1,1,240,24.0,2,8,12,12,7.4,20086,19898,1989.8,3709,5740,0
1368,-2609,-1786,1429.1,14291,18239,7.0,2,2,1,207,20.7,0,0,0,1,1,259,25.9,1,3,4,4,7.6,20025,16900,1690.0,1786,2609,0
1369,-1018,-828,1507.8,15078,16578,6.6,5,5,7,202,20.2,0,0,0,1,1,222,22.2,1,6,6,6,6.8,17406,16096,1609.6,828,1018,0
1370,2477,1105,1723.4,17234,17496,6.6,9,9,13,195,19.5,0,0,1,0,0,194,19.4,0,3,4,4,6.6,16391,14757,1475.7,-1105,-2477,1
1371,3074,1273,1782.6,17826,18216,7.2,9,9,8,220,22.0,1,1,1,0,0,205,20.5,0,2,5,5,6.4,16943,14752,1475.2,-1273,-3074,1
1372,552,-193,1844.5,18445,18076,7.0,10,10,9,199,19.9,1,1,0,1,0,207,20.7,0,10,11,11,7.0,18269,17893,1789.3,193,-552,0
1373,-1530,-922,1581.4,15814,17161,6.8,6,6,7,205,20.5,1,1,0,1,0,252,25.2,1,6,6,6,7.0,18083,17344,1734.4,922,1530,0
1374,-2187,-2383,1673.5,16735,17923,7.0,8,8,4,202,20.2,0,0,0,1,1,208,20.8,1,15,13,13,7.2,20306,18922,1892.2,2383,2187,0
1375,-4100,-3722,1581.8,15818,16673,6.4,8,8,8,172,17.2,0,0,0,1,0,220,22.0,0,11,13,13,7.4,20395,19918,1991.8,3722,4100,0
1376,389,-279,1699.9,16999,18578,7.2,6,6,6,232,23.2,0,0,0,1,1,216,21.6,2,6,5,5,7.2,18857,16610,1661.0,279,-389,0
1377,-1806,-1253,1586.7,15867,17737,6.8,5,5,5,227,22.7,0,0,0,1,0,200,20.0,0,9,10,10,7.2,18990,17673,1767.3,1253,1806,0
1378,704,-422,1804.2,18042,17600,6.6,11,11,11,221,22.1,0,0,1,0,0,198,19.8,0,10,10,10,7.0,18022,17338,1733.8,422,-704,1
1379,2406,2284,1829.3,18293,19340,7.4,8,8,9,228,22.8,2,1,1,0,0,224,22.4,0,7,4,4,6.8,17056,15887,1588.7,-2284,-2406,1
1380,42,367,1589.5,15895,18344,7.0,5,5,6,239,23.9,0,0,1,0,1,258,25.8,1,7,4,4,6.8,17977,15853,1585.3,-367,-42,1
1381,-2889,-2106,1430.5,14305,17810,6.8,1,1,1,251,25.1,0,0,0,1,1,282,28.2,1,5,4,4,7.2,19916,17194,1719.4,2106,2889,0
1382,3131,2377,1818.6,18186,19555,7.4,8,8,16,232,23.2,1,1,1,0,0,231,23.1,0,5,2,2,6.6,17178,15055,1505.5,-2377,-3131,1
1383,-1271,-364,1629.5,16295,17588,6.8,6,6,7,222,22.2,0,0,0,1,1,219,21.9,1,10,8,8,6.8,17952,17566,1756.6,364,1271,0
1384,6783,4718,2015.1,20151,19504,7.4,17,17,23,226,22.6,1,1,1,0,0,177,17.7,0,2,1,1,6.2,14786,13368,1336.8,-4718,-6783,1
1385,-2932,-2063,1473.5,14735,16488,6.4,3,3,5,219,21.9,0,0,0,1,0,223,22.3,0,5,9,9,7.2,18551,17667,1766.7,2063,2932,0
1386,-7868,-5339,1279.8,12798,13908,5.8,1,1,1,179,17.9,1,1,0,1,0,223,22.3,0,16,16,16,7.2,19247,20666,2066.6,5339,7868,0
1387,271,22,1645.2,16452,18564,7.0,4,4,6,234,23.4,1,1,1,0,0,224,22.4,1,1,6,6,7.0,18542,16181,1618.1,-22,-271,1
1388,-732,750,1612.0,16120,18149,7.0,6,6,6,215,21.5,0,0,0,1,1,205,20.5,1,7,7,7,7.0,17399,16852,1685.2,-750,732,0
1389,1863,2270,1828.7,18287,19617,7.4,9,9,9,226,22.6,0,0,1,0,0,232,23.2,0,6,6,6,6.8,17347,16424,1642.4,-2270,-1863,1
1390,-1190,-66,1590.2,15902,17995,6.8,4,4,6,241,24.1,0,0,0,1,1,241,24.1,1,14,7,7,6.8,18061,17092,1709.2,66,1190,0
1391,-212,1212,1698.2,16982,19524,7.2,8,8,8,218,21.8,0,0,0,1,1,242,24.2,2,10,5,5,7.2,18312,17194,1719.4,-1212,212,1
1392,134,-396,1706.4,17064,18061,7.0,7,7,6,236,23.6,0,0,0,1,1,210,21.0,1,8,7,7,7.0,18457,16930,1693.0,396,-134,0
1393,-3692,-3112,1542.4,15424,16080,6.6,5,5,6,208,20.8,0,0,0,1,1,195,19.5,2,16,11,11,7.2,19192,19116,1911.6,3112,3692,0
1394,3269,2404,1836.9,18369,19417,7.2,9,9,13,210,21.0,0,0,1,0,1,213,21.3,1,1,4,4,6.8,17013,15100,1510.0,-2404,-3269,1
1395,1308,544,1756.8,17568,18166,6.8,7,7,7,236,23.6,0,0,1,0,0,207,20.7,0,6,6,6,7.0,17622,16260,1626.0,-544,-1308,1
1396,1106,470,1809.0,18090,17730,6.8,9,9,7,229,22.9,0,0,0,1,0,204,20.4,1,12,10,10,7.0,17260,16984,1698.4,-470,-1106,1
1397,-92,-1170,1578.6,15786,17823,6.8,4,4,7,207,20.7,1,1,0,1,0,215,21.5,0,3,5,5,7.4,18993,15878,1587.8,1170,92,0
1398,539,818,1659.6,16596,18596,7.0,4,4,6,252,25.2,0,0,1,0,1,236,23.6,1,2,3,3,6.6,17778,16057,1605.7,-818,-539,0
1399,-3195,-953,1609.3,16093,16927,7.0,8,8,5,154,15.4,1,0,1,0,0,213,21.3,0,13,12,12,6.8,17880,19288,1928.8,953,3195,0
1400,4338,4607,1885.8,18858,19023,7.2,7,7,8,237,23.7,2,1,1,0,0,166,16.6,0,11,4,4,6.2,14416,14520,1452.0,-4607,-4338,1
1401,-861,131,1528.8,15288,16534,6.6,5,5,9,206,20.6,1,1,1,0,0,200,20.0,0,13,7,7,6.6,16403,16149,1614.9,-131,861,0
1402,-90,102,1634.6,16346,17401,6.8,7,7,7,227,22.7,1,1,0,1,0,234,23.4,0,5,5,5,7.0,17299,16436,1643.6,-102,90,1
1403,-5698,-3675,1344.7,13447,16199,6.4,1,1,0,201,20.1,0,0,0,1,1,240,24.0,2,12,11,11,7.2,19874,19145,1914.5,3675,5698,0
1404,-569,-213,1645.3,16453,17231,6.8,8,8,8,206,20.6,1,1,1,0,0,199,19.9,1,10,8,8,7.0,17444,17022,1702.2,213,569,0
1405,1788,761,1866.9,18669,19226,7.2,12,12,16,213,21.3,0,0,0,1,1,208,20.8,1,7,6,6,7.0,18465,16881,1688.1,-761,-1788,1
1406,1056,-182,1619.2,16192,18197,6.8,5,5,8,209,20.9,0,0,1,0,1,185,18.5,1,4,5,5,7.0,18379,15136,1513.6,182,-1056,1
1407,-4095,-3017,1370.1,13701,15431,6.6,2,2,1,183,18.3,1,1,0,1,0,255,25.5,0,6,7,7,7.2,18448,17796,1779.6,3017,4095,0
1408,482,166,1676.2,16762,18180,7.0,6,6,7,242,24.2,0,0,1,0,0,231,23.1,0,8,5,5,6.8,18014,16280,1628.0,-166,-482,0
1409,-507,-790,1679.5,16795,18159,6.8,8,8,5,235,23.5,0,0,1,0,0,203,20.3,1,9,8,8,7.2,18949,17302,1730.2,790,507,0
1410,-4820,-2651,1446.4,14464,15227,6.2,4,4,1,164,16.4,0,0,0,1,0,206,20.6,0,9,12,12,7.0,17878,19284,1928.4,2651,4820,0
1411,-962,107,1692.5,16925,18087,6.6,5,5,5,233,23.3,0,0,0,1,1,213,21.3,1,16,10,10,7.0,17980,17887,1788.7,-107,962,0
1412,-3025,-2906,1430.2,14302,15878,6.6,3,3,1,211,21.1,0,0,1,0,1,212,21.2,2,9,9,9,7.2,18784,17327,1732.7,2906,3025,0
1413,-1340,-529,1478.6,14786,16676,6.6,2,2,2,233,23.3,1,0,0,1,1,205,20.5,1,6,8,8,6.8,17205,16126,1612.6,529,1340,0
1414,-168,267,1513.4,15134,18028,7.0,3,3,2,214,21.4,0,0,0,1,1,214,21.4,1,4,3,3,7.0,17761,15302,1530.2,-267,168,0
1415,-664,-549,1895.4,18954,17795,6.8,8,8,8,228,22.8,1,0,0,1,1,182,18.2,1,13,13,13,7.0,18344,19618,1961.8,549,664,1
1416,-3089,-2946,1604.3,16043,17409,7.0,6,6,7,220,22.0,1,1,1,0,0,235,23.5,0,12,12,12,7.6,20355,19132,1913.2,2946,3089,0
1417,-1573,-1171,1519.5,15195,17896,7.2,5,5,4,196,19.6,0,0,0,1,1,202,20.2,1,7,6,6,7.0,19067,16768,1676.8,1171,1573,1
1418,721,2077,1720.5,17205,18124,7.0,9,9,10,218,21.8,1,1,0,1,0,212,21.2,0,11,7,7,6.4,16047,16484,1648.4,-2077,-721,1
1419,511,-678,1602.2,16022,17853,7.0,5,5,5,219,21.9,0,0,1,0,0,242,24.2,1,9,4,4,7.0,18531,15511,1551.1,678,-511,0
1420,-1193,-819,1561.5,15615,17928,7.0,6,6,6,201,20.1,0,0,0,1,0,229,22.9,0,10,7,7,7.0,18747,16808,1680.8,819,1193,1
1421,-3215,-1656,1443.3,14433,16813,6.6,2,2,3,202,20.2,0,0,0,1,0,243,24.3,1,7,8,8,7.2,18469,17648,1764.8,1656,3215,0
1422,5227,2051,1980.7,19807,17943,6.8,13,13,13,220,22.0,2,1,1,0,0,210,21.0,0,1,3,3,6.6,15892,14580,1458.0,-2051,-5227,1
1423,1012,519,1570.4,15704,18292,6.8,4,4,5,236,23.6,1,1,1,0,0,234,23.4,0,0,2,2,7.0,17773,14692,1469.2,-519,-1012,1
1424,2002,388,1707.3,17073,17021,6.8,4,4,5,221,22.1,1,0,1,0,0,203,20.3,0,7,4,4,6.4,16633,15071,1507.1,-388,-2002,1
1425,3093,1285,1858.4,18584,18383,7.0,9,9,11,203,20.3,0,0,1,0,0,212,21.2,0,5,3,3,6.8,17098,15491,1549.1,-1285,-3093,1
1426,-2377,-2355,1618.7,16187,16701,6.4,7,7,11,216,21.6,1,1,0,1,0,206,20.6,0,14,11,11,7.0,19056,18564,1856.4,2355,2377,0
1427,-2419,-3313,1674.9,16749,16227,6.4,9,9,14,166,16.6,1,1,0,1,0,240,24.0,0,13,10,10,7.4,19540,19168,1916.8,3313,2419,0
1428,-392,462,1649.0,16490,19578,7.0,6,6,5,214,21.4,1,1,0,1,0,232,23.2,0,8,6,6,7.2,19116,16882,1688.2,-462,392,0
1429,852,1553,1669.7,16697,19170,7.2,6,6,5,236,23.6,2,1,1,0,0,214,21.4,0,7,4,4,7.0,17617,15845,1584.5,-1553,-852,1
1430,2507,3196,1797.3,17973,20040,7.2,10,10,10,196,19.6,2,1,0,1,0,209,20.9,0,5,4,4,6.6,16844,15466,1546.6,-3196,-2507,1
1431,1756,1920,1602.9,16029,17493,6.8,5,5,6,234,23.4,0,0,0,1,0,199,19.9,0,3,2,2,6.2,15573,14273,1427.3,-1920,-1756,1
1432,1064,2471,1575.2,15752,19171,7.2,4,4,4,231,23.1,2,1,0,1,0,235,23.5,0,4,2,2,6.6,16700,14688,1468.8,-2471,-1064,1
1433,1713,2145,1593.0,15930,18669,7.2,5,5,3,234,23.4,1,1,1,0,0,188,18.8,0,3,3,3,6.4,16524,14217,1421.7,-2145,-1713,1
1434,-1137,-1402,1524.1,15241,16491,6.6,6,6,10,190,19.0,0,0,0,1,1,224,22.4,2,6,6,6,6.8,17893,16378,1637.8,1402,1137,0
1435,2294,1383,1712.7,17127,18148,6.8,8,8,7,201,20.1,1,1,0,1,0,183,18.3,0,2,4,4,6.4,16765,14833,1483.3,-1383,-2294,1
1436,-4115,-2985,1351.9,13519,15833,6.4,1,1,2,188,18.8,0,0,0,1,1,251,25.1,1,9,7,7,7.0,18818,17634,1763.4,2985,4115,0
1437,2520,2092,1874.8,18748,19116,7.0,11,11,13,243,24.3,0,0,0,1,0,224,22.4,0,5,6,6,6.8,17024,16228,1622.8,-2092,-2520,1
1438,93,1195,1605.5,16055,17933,6.8,4,4,3,227,22.7,1,1,0,1,0,214,21.4,0,9,7,7,6.8,16738,15962,1596.2,-1195,-93,1
1439,1744,1187,1649.6,16496,18201,7.0,7,7,5,202,20.2,1,1,1,0,0,209,20.9,0,5,5,5,6.6,17014,14752,1475.2,-1187,-1744,1
1440,-315,-7,1721.7,17217,18979,7.0,6,6,10,222,22.2,1,1,0,1,0,218,21.8,0,11,9,9,7.0,18986,17532,1753.2,7,315,1
1441,-1335,-172,1548.2,15482,18715,7.2,4,4,4,237,23.7,0,0,0,1,1,228,22.8,2,5,5,5,7.2,18887,16817,1681.7,172,1335,0
1442,-648,728,1448.6,14486,18218,7.0,3,3,1,200,20.0,0,0,1,0,1,208,20.8,1,3,3,3,7.0,17490,15134,1513.4,-728,648,0
1443,-3854,-1813,1580.9,15809,17592,6.8,6,6,4,198,19.8,0,0,1,0,0,238,23.8,0,15,12,12,7.2,19405,19663,1966.3,1813,3854,0
1444,2585,1759,1955.6,19556,18352,7.0,11,11,8,229,22.9,1,1,1,0,0,169,16.9,0,9,8,8,6.6,16593,16971,1697.1,-1759,-2585,1
1445,2247,1668,1700.3,17003,17799,6.8,9,9,11,188,18.8,1,1,1,0,0,189,18.9,0,3,4,4,6.4,16131,14756,1475.6,-1668,-2247,1
1446,-977,143,1645.1,16451,18416,7.0,5,5,2,220,22.0,0,0,0,1,0,189,18.9,0,8,10,10,6.8,18273,17428,1742.8,-143,977,0
1447,2970,2037,1783.7,17837,19440,7.2,6,6,5,238,23.8,0,0,1,0,0,217,21.7,0,4,3,3,7.0,17403,14867,1486.7,-2037,-2970,1
1448,250,287,1805.6,18056,17829,6.8,11,11,14,195,19.5,1,1,1,0,0,210,21.0,1,7,6,6,7.0,17542,17806,1780.6,-287,-250,1
1449,-1276,-648,1624.9,16249,17245,6.8,8,8,2,189,18.9,0,0,1,0,0,193,19.3,0,11,8,8,7.0,17893,17525,1752.5,648,1276,0
1450,1482,1055,1694.6,16946,18077,6.8,7,7,9,212,21.2,0,0,1,0,1,161,16.1,1,7,7,7,7.0,17022,15464,1546.4,-1055,-1482,1
1451,428,687,1570.7,15707,17968,6.8,4,4,5,243,24.3,0,0,0,1,1,247,24.7,1,4,2,2,6.8,17281,15279,1527.9,-687,-428,0
1452,-1706,-1027,1644.3,16443,18461,7.0,7,7,7,193,19.3,0,0,1,0,0,247,24.7,0,6,6,6,7.2,19488,18149,1814.9,1027,1706,0
1453,1014,950,1782.3,17823,19752,7.4,8,8,10,215,21.5,2,1,0,1,0,219,21.9,0,5,5,5,7.0,18802,16809,1680.9,-950,-1014,1
1454,250,942,1624.1,16241,18365,7.2,2,2,2,236,23.6,0,0,0,1,1,196,19.6,1,8,6,6,6.8,17423,15991,1599.1,-942,-250,1
1455,166,395,1646.4,16464,17075,6.6,7,7,6,209,20.9,1,0,0,1,1,167,16.7,1,12,8,8,6.6,16680,16298,1629.8,-395,-166,1
1456,-465,-436,1692.4,16924,17938,6.8,6,6,7,233,23.3,0,0,0,1,0,214,21.4,0,10,8,8,7.2,18374,17389,1738.9,436,465,0
1457,-733,-541,1725.1,17251,17415,6.8,10,10,10,217,21.7,1,1,0,1,0,234,23.4,0,13,8,8,6.8,17956,17984,1798.4,541,733,1
1458,-1013,-36,1691.7,16917,18964,7.2,6,6,8,212,21.2,0,0,0,1,1,260,26.0,1,6,8,8,7.0,19000,17930,1793.0,36,1013,0
1459,3773,1957,1945.3,19453,18832,7.0,7,7,6,239,23.9,2,1,0,1,0,170,17.0,0,6,7,7,6.6,16875,15680,1568.0,-1957,-3773,1
1460,1060,1554,1689.1,16891,19197,7.4,5,5,4,207,20.7,0,0,0,1,1,211,21.1,1,4,4,4,6.8,17643,15831,1583.1,-1554,-1060,0
1461,2169,2453,1710.7,17107,19237,7.2,7,7,4,218,21.8,1,1,1,0,0,212,21.2,0,4,4,4,6.6,16784,14938,1493.8,-2453,-2169,1
1462,1019,708,1544.4,15444,17833,7.0,4,4,3,236,23.6,1,1,0,1,0,229,22.9,0,0,2,2,6.6,17125,14425,1442.5,-708,-1019,1
1463,2684,1191,1828.3,18283,18731,7.2,9,9,10,226,22.6,2,1,1,0,0,211,21.1,0,4,5,5,7.0,17540,15599,1559.9,-1191,-2684,1
1464,1362,699,1626.7,16267,18319,6.8,4,4,3,246,24.6,0,0,1,0,1,228,22.8,2,4,2,2,7.0,17620,14905,1490.5,-699,-1362,1
1465,915,1710,1724.7,17247,18845,7.0,6,6,7,233,23.3,1,0,1,0,0,214,21.4,0,9,7,7,7.0,17135,16332,1633.2,-1710,-915,1
1466,1931,1200,1864.0,18640,18015,7.0,11,11,22,226,22.6,1,0,0,1,1,232,23.2,1,10,6,6,6.6,16815,16709,1670.9,-1200,-1931,0
1467,3655,2743,1708.6,17086,19170,7.2,9,9,8,221,22.1,0,0,1,0,1,198,19.8,1,0,0,0,6.4,16427,13431,1343.1,-2743,-3655,1
1468,805,149,1650.5,16505,17567,6.8,6,6,8,205,20.5,0,0,1,0,1,256,25.6,1,4,4,4,7.0,17418,15700,1570.0,-149,-805,0
1469,478,-124,1796.1,17961,17984,6.8,12,12,20,172,17.2,0,0,0,1,1,159,15.9,1,17,10,10,6.8,18108,17483,1748.3,124,-478,1
1470,1698,2237,1941.8,19418,18520,6.8,14,14,14,204,20.4,1,1,1,0,0,167,16.7,1,11,12,12,6.6,16283,17720,1772.0,-2237,-1698,1
1471,-330,-466,1584.6,15846,18388,7.0,4,4,3,214,21.4,0,0,1,0,1,236,23.6,1,5,5,5,7.2,18854,16176,1617.6,466,330,1
1472,592,242,1693.7,16937,18194,7.0,6,6,7,221,22.1,1,0,1,0,1,215,21.5,1,4,5,5,7.2,17952,16345,1634.5,-242,-592,1
1473,-1765,-2344,1406.4,14064,16539,6.6,1,1,1,220,22.0,0,0,1,0,1,244,24.4,1,2,4,4,6.8,18883,15829,1582.9,2344,1765,0
1474,-92,-244,1509.4,15094,18255,6.8,1,1,1,246,24.6,0,0,1,0,1,226,22.6,1,3,2,2,6.8,18499,15186,1518.6,244,92,0
1475,-2947,-2189,1563.3,15633,17179,6.8,5,5,5,193,19.3,1,1,1,0,0,224,22.4,0,13,11,11,7.2,19368,18580,1858.0,2189,2947,0
1476,1982,990,1686.8,16868,18060,6.8,6,6,6,245,24.5,1,1,1,0,0,227,22.7,0,6,2,2,6.8,17070,14886,1488.6,-990,-1982,1
1477,2330,2319,1928.9,19289,19633,7.6,10,10,8,240,24.0,1,0,0,1,0,200,20.0,0,9,7,7,7.0,17314,16959,1695.9,-2319,-2330,1
1478,-105,1086,1513.8,15138,18807,7.0,3,3,4,194,19.4,1,1,0,1,0,235,23.5,0,3,3,3,7.0,17721,15243,1524.3,-1086,105,1
1479,-1215,-756,1494.2,14942,17727,7.0,1,1,1,210,21.0,2,1,0,1,0,233,23.3,0,7,5,5,7.0,18483,16157,1615.7,756,1215,1
1480,-951,-1116,1570.3,15703,16893,6.8,6,6,7,191,19.1,1,1,0,1,0,221,22.1,0,8,6,6,7.2,18009,16654,1665.4,1116,951,0
1481,134,-144,1542.7,15427,17667,6.8,5,5,7,217,21.7,2,1,1,0,0,235,23.5,0,2,3,3,7.0,17811,15293,1529.3,144,-134,1
1482,361,-672,1662.0,16620,17711,7.0,6,6,8,238,23.8,0,0,1,0,0,223,22.3,0,5,5,5,7.0,18383,16259,1625.9,672,-361,1
1483,905,1369,1592.6,15926,17186,6.8,6,6,5,209,20.9,1,1,0,1,0,180,18.0,0,10,5,5,6.4,15817,15021,1502.1,-1369,-905,1
1484,348,-1004,1685.2,16852,17417,6.6,9,9,5,210,21.0,0,0,1,0,1,216,21.6,1,6,6,6,7.0,18421,16504,1650.4,1004,-348,0
1485,-424,-630,1693.6,16936,18023,7.2,6,6,6,219,21.9,0,0,1,0,1,230,23.0,2,10,8,8,7.0,18653,17360,1736.0,630,424,0
1486,3058,1325,1791.7,17917,18904,7.2,10,10,13,212,21.2,1,1,1,0,0,222,22.2,1,2,4,4,6.8,17579,14859,1485.9,-1325,-3058,1
1487,-105,-1401,1755.8,17558,17445,6.8,7,7,11,241,24.1,1,1,1,0,0,232,23.2,1,9,8,8,6.8,18846,17663,1766.3,1401,105,0
1488,-1876,-2659,1514.9,15149,17143,6.8,3,3,3,205,20.5,0,0,0,1,1,211,21.1,1,4,8,8,7.4,19802,17025,1702.5,2659,1876,0
1489,-1031,-760,1611.2,16112,16747,6.4,5,5,8,215,21.5,1,1,0,1,0,211,21.1,0,10,7,7,6.8,17507,17143,1714.3,760,1031,0
1490,125,2058,1588.5,15885,19056,7.2,7,7,6,207,20.7,0,0,1,0,0,224,22.4,0,4,4,4,6.8,16998,15760,1576.0,-2058,-125,0
1491,-669,-502,1710.4,17104,17075,6.6,4,4,4,224,22.4,1,0,1,0,1,209,20.9,1,8,7,7,6.8,17577,17773,1777.3,502,669,1
1492,1436,-1544,1753.5,17535,15420,6.4,10,10,16,173,17.3,1,1,0,1,0,207,20.7,0,4,5,5,6.8,16964,16099,1609.9,1544,-1436,1
1493,-78,-155,1732.1,17321,18683,7.0,8,8,8,205,20.5,1,1,1,0,0,207,20.7,1,7,10,10,7.4,18838,17399,1739.9,155,78,0
1494,-713,103,1631.7,16317,18679,7.0,6,6,6,204,20.4,1,0,1,0,1,212,21.2,1,5,7,7,6.8,18576,17030,1703.0,-103,713,1
1495,-1975,-1115,1564.9,15649,18614,7.2,4,4,2,234,23.4,0,0,0,1,1,243,24.3,1,7,7,7,7.2,19729,17624,1762.4,1115,1975,0
1496,1411,766,1759.2,17592,18664,7.0,9,9,11,220,22.0,0,0,1,0,1,215,21.5,1,4,3,3,7.0,17898,16181,1618.1,-766,-1411,1
1497,661,139,1542.0,15420,18204,7.0,2,2,3,230,23.0,1,1,1,0,0,245,24.5,0,2,1,1,6.6,18065,14759,1475.9,-139,-661,1
1498,-394,-1635,1592.9,15929,17529,6.8,3,3,6,226,22.6,0,0,0,1,0,237,23.7,1,4,4,4,7.0,19164,16323,1632.3,1635,394,0
1499,-557,-832,1504.6,15046,16504,6.6,4,4,4,178,17.8,0,0,1,0,0,217,21.7,0,6,4,4,6.6,17336,15603,1560.3,832,557,0
1500,1204,2004,1673.7,16737,19857,7.4,6,6,5,243,24.3,0,0,0,1,1,250,25.0,1,2,3,3,6.8,17853,15533,1553.3,-2004,-1204,1
1501,-1966,-3189,1575.6,15756,16210,6.6,6,6,8,204,20.4,0,0,1,0,0,242,24.2,0,6,7,7,7.4,19399,17722,1772.2,3189,1966,0
1502,-1090,-1499,1544.2,15442,17518,6.8,3,3,6,238,23.8,1,1,0,1,0,233,23.3,0,6,6,6,6.8,19017,16532,1653.2,1499,1090,1
1503,-1152,-2193,1664.9,16649,15616,6.2,9,9,12,166,16.6,1,0,1,0,1,208,20.8,1,8,8,8,6.8,17809,17801,1780.1,2193,1152,0
1504,-1682,-71,1617.1,16171,17902,7.0,6,6,4,202,20.2,1,0,0,1,1,226,22.6,1,8,10,10,7.0,17973,17853,1785.3,71,1682,0
1505,1847,1084,1719.0,17190,17783,6.6,9,9,12,210,21.0,1,1,1,0,0,200,20.0,1,5,4,4,6.8,16699,15343,1534.3,-1084,-1847,1
1506,808,-236,1722.2,17222,18157,7.0,7,7,12,227,22.7,0,0,1,0,1,250,25.0,1,3,6,6,7.0,18393,16414,1641.4,236,-808,0
1507,-1332,-2004,1570.4,15704,17114,6.6,6,6,3,199,19.9,1,1,0,1,0,217,21.7,0,10,9,9,7.2,19118,17036,1703.6,2004,1332,1
1508,-3966,-2999,1633.1,16331,14886,6.4,9,9,9,162,16.2,0,0,0,1,0,169,16.9,1,16,18,18,6.8,17885,20297,2029.7,2999,3966,0
1509,1377,795,1918.6,19186,18375,7.2,10,10,11,183,18.3,1,0,0,1,1,201,20.1,1,8,7,7,7.0,17580,17809,1780.9,-795,-1377,0
1510,1493,1167,1754.6,17546,17209,6.8,7,7,10,228,22.8,1,1,1,0,0,193,19.3,1,4,3,3,6.4,16042,16053,1605.3,-1167,-1493,1
1511,-2876,-2715,1519.8,15198,17177,6.8,4,4,5,219,21.9,0,0,0,1,0,222,22.2,1,9,7,7,7.2,19892,18074,1807.4,2715,2876,0
1512,1340,-207,1790.9,17909,16512,6.4,8,8,13,165,16.5,1,1,0,1,0,201,20.1,0,10,7,7,6.6,16719,16569,1656.9,207,-1340,0
1513,-1208,-614,1504.6,15046,17140,6.6,4,4,2,208,20.8,0,0,0,1,1,227,22.7,1,5,7,7,7.0,17754,16254,1625.4,614,1208,0
1514,218,1085,1674.0,16740,19237,7.0,6,6,9,238,23.8,0,0,0,1,1,229,22.9,1,8,6,6,7.0,18152,16522,1652.2,-1085,-218,1
1515,6907,4512,2029.5,20295,19531,7.2,13,13,10,258,25.8,1,1,1,0,0,178,17.8,0,1,1,1,6.2,15019,13388,1338.8,-4512,-6907,1
1516,-594,-353,1592.1,15921,18190,7.0,4,4,7,217,21.7,0,0,0,1,1,235,23.5,2,7,5,5,7.2,18543,16515,1651.5,353,594,1
1517,-1464,-454,1714.5,17145,17904,7.0,10,10,13,192,19.2,2,1,0,1,0,226,22.6,0,5,9,9,7.2,18358,18609,1860.9,454,1464,0
1518,554,-702,1593.6,15936,18030,7.0,5,5,7,205,20.5,0,0,0,1,0,179,17.9,0,4,4,4,7.0,18732,15382,1538.2,702,-554,1
1519,1256,-295,1664.9,16649,19322,7.4,7,7,5,226,22.6,1,0,1,0,1,268,26.8,1,1,2,2,7.4,19617,15393,1539.3,295,-1256,1
1520,4373,4286,1761.8,17618,18556,7.0,10,10,14,203,20.3,1,1,1,0,0,184,18.4,0,3,2,2,6.0,14270,13245,1324.5,-4286,-4373,1
1521,-245,-278,1587.1,15871,17106,6.6,6,6,6,195,19.5,0,0,1,0,1,221,22.1,1,6,5,5,7.0,17384,16116,1611.6,278,245,1
1522,393,-215,1767.6,17676,18151,7.0,8,8,7,206,20.6,1,0,1,0,1,223,22.3,1,9,8,8,7.0,18366,17283,1728.3,215,-393,0
1523,2822,2207,1742.3,17423,19973,7.4,7,7,6,248,24.8,0,0,1,0,1,219,21.9,1,2,2,2,7.0,17766,14601,1460.1,-2207,-2822,1
1524,-5025,-2610,1341.0,13410,16059,6.4,1,1,0,210,21.0,0,0,0,1,1,228,22.8,1,16,10,10,7.2,18669,18435,1843.5,2610,5025,0
1525,-371,-172,1699.2,16992,18385,7.0,7,7,8,219,21.9,0,0,0,1,1,225,22.5,1,7,8,8,7.2,18557,17363,1736.3,172,371,1
1526,3999,2223,1867.8,18678,18538,7.0,8,8,10,231,23.1,2,1,1,0,0,193,19.3,0,5,4,4,6.6,16315,14679,1467.9,-2223,-3999,1
1527,-4157,-1724,1622.0,16220,17906,7.0,5,5,12,222,22.2,0,0,0,1,1,257,25.7,1,24,12,12,7.4,19630,20377,2037.7,1724,4157,0
1528,-5298,-4670,1493.0,14930,15593,6.0,5,5,2,169,16.9,0,0,0,1,1,242,24.2,1,14,12,12,7.4,20263,20228,2022.8,4670,5298,0
1529,-28,-63,1630.4,16304,17825,6.8,7,7,7,201,20.1,0,0,0,1,0,209,20.9,0,4,8,8,6.8,17888,16332,1633.2,63,28,0
1530,462,579,1707.5,17075,18159,7.0,7,7,14,230,23.0,1,1,0,1,0,224,22.4,0,6,5,5,6.6,17580,16613,1661.3,-579,-462,1
1531,-81,-1,1549.9,15499,17516,7.0,5,5,5,225,22.5,0,0,0,1,1,214,21.4,1,3,3,3,6.8,17517,15580,1558.0,1,81,0
1532,752,344,1697.2,16972,19577,7.4,6,6,9,218,21.8,2,1,1,0,0,247,24.7,0,3,4,4,7.2,19233,16220,1622.0,-344,-752,1
1533,-1555,-357,1525.6,15256,16464,6.6,6,6,5,189,18.9,0,0,0,1,1,182,18.2,1,12,10,10,6.8,16821,16811,1681.1,357,1555,0
1534,1188,2039,1656.8,16568,18645,7.2,6,6,9,197,19.7,0,0,0,1,1,207,20.7,2,4,3,3,6.8,16606,15380,1538.0,-2039,-1188,1
1535,1639,-213,1732.6,17326,18459,7.2,7,7,10,224,22.4,1,0,1,0,1,248,24.8,1,3,3,3,7.0,18672,15687,1568.7,213,-1639,1
1536,1552,1488,1661.9,16619,18958,7.2,6,6,7,226,22.6,0,0,0,1,0,213,21.3,0,5,4,4,6.8,17470,15067,1506.7,-1488,-1552,1
1537,41,-936,1629.5,16295,18278,7.2,4,4,4,261,26.1,0,0,0,1,1,234,23.4,1,5,5,5,7.2,19214,16254,1625.4,936,-41,0
1538,-259,-1115,1568.0,15680,17099,6.6,7,7,7,186,18.6,1,1,1,0,0,227,22.7,0,4,4,4,7.0,18214,15939,1593.9,1115,259,1
1539,367,-1025,1643.2,16432,16967,6.8,7,7,8,191,19.1,0,0,1,0,1,212,21.2,1,7,7,7,7.0,17992,16065,1606.5,1025,-367,0
1540,2941,1850,1919.7,19197,18449,7.2,10,10,9,219,21.9,2,1,0,1,0,192,19.2,0,6,6,6,6.6,16599,16256,1625.6,-1850,-2941,1
1541,1142,283,1846.8,18468,18822,7.2,10,10,8,221,22.1,1,1,1,0,0,252,25.2,0,6,7,7,7.2,18539,17326,1732.6,-283,-1142,1
1542,4051,1394,1828.0,18280,18115,7.0,9,9,10,229,22.9,0,0,1,0,1,211,21.1,1,3,5,5,6.6,16721,14229,1422.9,-1394,-4051,1
1543,-2419,-1437,1610.3,16103,17019,6.6,5,5,7,193,19.3,0,0,0,1,0,246,24.6,1,14,9,9,7.0,18456,18522,1852.2,1437,2419,1
1544,1624,1008,1683.2,16832,18675,7.2,6,6,8,221,22.1,2,1,1,0,0,238,23.8,0,5,4,4,7.0,17667,15208,1520.8,-1008,-1624,1
1545,-2254,-379,1502.8,15028,17228,6.8,3,3,5,232,23.2,1,1,0,1,0,232,23.2,0,8,8,8,7.0,17607,17282,1728.2,379,2254,0
1546,834,1853,1707.6,17076,18945,7.2,9,9,6,194,19.4,1,0,1,0,0,238,23.8,0,2,5,5,6.6,17092,16242,1624.2,-1853,-834,1
1547,2150,1104,1674.5,16745,17283,6.8,7,7,6,210,21.0,0,0,1,0,0,187,18.7,0,3,4,4,6.6,16179,14595,1459.5,-1104,-2150,1
1548,-1624,-2019,1565.8,15658,17351,6.6,4,4,4,222,22.2,1,0,0,1,1,207,20.7,1,8,8,8,7.4,19370,17282,1728.2,2019,1624,1
1549,-2072,412,1576.0,15760,18719,7.2,6,6,6,167,16.7,1,0,1,0,1,268,26.8,1,2,5,5,7.0,18307,17832,1783.2,-412,2072,1
1550,-2089,537,1462.4,14624,16881,6.8,2,2,3,210,21.0,1,0,0,1,0,215,21.5,0,10,7,7,6.6,16344,16713,1671.3,-537,2089,0
1551,542,1212,1556.8,15568,18302,7.0,2,2,1,245,24.5,0,0,0,1,1,209,20.9,1,4,3,3,6.6,17090,15026,1502.6,-1212,-542,1
1552,-226,-221,1633.1,16331,17920,7.2,6,6,4,231,23.1,1,0,0,1,0,226,22.6,0,7,7,7,7.0,18141,16557,1655.7,221,226,0
1553,316,10,1720.4,17204,18986,7.4,7,7,7,240,24.0,2,1,1,0,0,236,23.6,0,4,5,5,7.0,18976,16888,1688.8,-10,-316,1
1554,-821,-2540,1491.0,14910,15466,6.6,3,3,3,195,19.5,0,0,1,0,1,206,20.6,1,4,6,6,6.8,18006,15731,1573.1,2540,821,0
1555,4294,4438,1914.1,19141,20647,7.6,12,12,15,192,19.2,1,1,1,0,0,210,21.0,0,3,5,5,6.4,16209,14847,1484.7,-4438,-4294,1
1556,-4891,-2335,1420.8,14208,17036,7.0,2,2,1,194,19.4,0,0,0,1,0,266,26.6,1,8,8,8,7.2,19371,19099,1909.9,2335,4891,0
1557,3432,2317,1795.1,17951,18031,6.8,9,9,7,234,23.4,1,1,0,1,0,183,18.3,0,9,4,4,6.4,15714,14519,1451.9,-2317,-3432,1
1558,-563,-812,1614.2,16142,17610,6.8,7,7,8,197,19.7,1,1,1,0,0,207,20.7,0,12,8,8,7.0,18422,16705,1670.5,812,563,1
1559,60,-341,1633.3,16333,19527,7.2,4,4,5,237,23.7,0,0,0,1,1,252,25.2,1,3,4,4,7.6,19868,16273,1627.3,341,-60,1
1560,2761,680,1752.6,17526,17824,6.8,8,8,11,222,22.2,0,0,1,0,1,216,21.6,1,2,2,2,6.8,17144,14765,1476.5,-680,-2761,0
1561,1542,2179,1738.1,17381,20017,7.2,7,7,7,221,22.1,2,1,1,0,0,204,20.4,0,4,7,7,7.0,17838,15839,1583.9,-2179,-1542,1
1562,2323,2120,1785.4,17854,20383,7.4,5,5,5,230,23.0,1,0,0,1,0,219,21.9,0,2,3,3,7.0,18263,15531,1553.1,-2120,-2323,0
1563,-1143,-859,1569.8,15698,17468,7.0,6,6,4,206,20.6,1,1,1,0,0,259,25.9,1,3,5,5,7.0,18327,16841,1684.1,859,1143,0
1564,-665,-571,1603.9,16039,17942,7.0,6,6,4,195,19.5,0,0,0,1,1,231,23.1,1,5,7,7,7.0,18513,16704,1670.4,571,665,1
1565,-2520,-1932,1450.6,14506,16989,6.8,3,3,4,206,20.6,1,0,0,1,1,221,22.1,1,7,8,8,7.2,18921,17026,1702.6,1932,2520,0
1566,708,1208,1683.0,16830,18944,7.0,6,6,6,226,22.6,0,0,0,1,1,204,20.4,2,4,6,6,6.8,17736,16122,1612.2,-1208,-708,1
1567,410,720,1490.9,14909,18031,7.0,2,2,3,245,24.5,1,1,0,1,0,237,23.7,0,1,1,1,6.8,17311,14499,1449.9,-720,-410,1
1568,-4578,-3673,1293.9,12939,15958,6.4,0,0,0,201,20.1,0,0,0,1,1,259,25.9,1,5,5,5,7.4,19631,17517,1751.7,3673,4578,1
1569,1079,1586,1667.8,16678,18875,7.0,8,8,3,216,21.6,0,0,0,1,1,220,22.0,1,3,6,6,6.8,17289,15599,1559.9,-1586,-1079,0
1570,-4024,-2373,1532.2,15322,15807,6.4,5,5,3,210,21.0,0,0,0,1,1,203,20.3,1,17,14,14,6.8,18180,19346,1934.6,2373,4024,0
1571,44,170,1656.2,16562,18781,7.2,5,5,4,210,21.0,0,0,1,0,1,245,24.5,1,8,7,7,7.0,18611,16518,1651.8,-170,-44,0
1572,-560,-46,1635.3,16353,18367,7.0,6,6,5,214,21.4,1,0,1,0,1,221,22.1,1,10,8,8,7.4,18413,16913,1691.3,46,560,1
1573,-1343,-591,1699.8,16998,17282,6.6,7,7,6,207,20.7,1,0,0,1,1,191,19.1,1,15,11,11,6.8,17873,18341,1834.1,591,1343,0
1574,60,323,1505.1,15051,16743,6.6,5,5,7,188,18.8,1,1,0,1,0,206,20.6,0,4,5,5,6.8,16420,14991,1499.1,-323,-60,0
1575,-1501,-1478,1498.6,14986,17222,6.8,3,3,6,208,20.8,0,0,0,1,0,220,22.0,0,4,6,6,7.2,18700,16487,1648.7,1478,1501,0
1576,1331,1287,1700.3,17003,18007,6.6,7,7,9,214,21.4,0,0,1,0,0,190,19.0,0,8,5,5,6.8,16720,15672,1567.2,-1287,-1331,0
1577,-4864,-2818,1538.0,15380,15984,6.6,4,4,5,226,22.6,1,1,0,1,0,231,23.1,1,17,12,12,7.2,18802,20244,2024.4,2818,4864,0
1578,3821,4288,1859.9,18599,20735,7.2,9,9,8,216,21.6,2,1,1,0,0,187,18.7,0,5,3,3,6.8,16447,14778,1477.8,-4288,-3821,1
1579,-1477,-1018,1593.6,15936,17755,6.8,6,6,6,192,19.2,0,0,0,1,1,245,24.5,1,10,7,7,7.0,18773,17413,1741.3,1018,1477,1
1580,446,263,1526.5,15265,17859,6.8,3,3,2,224,22.4,0,0,1,0,0,237,23.7,0,1,2,2,6.6,17596,14819,1481.9,-263,-446,1
1581,3504,995,1817.7,18177,18965,7.0,10,10,12,219,21.9,1,1,1,0,0,214,21.4,0,4,3,3,6.8,17970,14673,1467.3,-995,-3504,1
1582,2046,584,1660.5,16605,16894,6.6,7,7,12,220,22.0,1,0,0,1,1,175,17.5,1,9,5,5,6.6,16310,14559,1455.9,-584,-2046,0
1583,-541,-1094,1474.2,14742,17515,6.8,4,4,3,203,20.3,0,0,1,0,1,230,23.0,2,5,3,3,7.2,18609,15283,1528.3,1094,541,0
1584,-3132,-1630,1444.0,14440,17275,7.0,3,3,1,194,19.4,0,0,0,1,1,220,22.0,1,6,8,8,7.0,18905,17572,1757.2,1630,3132,0
1585,-8472,-8242,1279.8,12798,12111,5.4,2,2,3,187,18.7,0,0,0,1,1,224,22.4,1,16,13,13,7.6,20353,21270,2127.0,8242,8472,0
1586,-687,-372,1569.8,15698,17663,6.6,5,5,6,201,20.1,0,0,0,1,1,230,23.0,1,8,6,6,7.0,18035,16385,1638.5,372,687,0
1587,3129,2922,1732.4,17324,19349,7.2,7,7,7,216,21.6,1,1,1,0,0,208,20.8,0,3,2,2,6.8,16427,14195,1419.5,-2922,-3129,1
1588,-2539,-943,1461.3,14613,17026,6.8,2,2,5,233,23.3,1,0,0,1,1,234,23.4,1,7,4,4,7.0,17969,17152,1715.2,943,2539,0
1589,-2167,-2507,1470.5,14705,16663,6.6,4,4,4,196,19.6,0,0,1,0,1,240,24.0,1,6,5,5,7.2,19170,16872,1687.2,2507,2167,0
1590,910,1269,1753.6,17536,19665,7.2,8,8,10,247,24.7,0,0,0,1,1,226,22.6,1,6,5,5,7.0,18396,16626,1662.6,-1269,-910,1
1591,-521,-1275,1522.6,15226,17298,6.6,5,5,3,213,21.3,1,0,0,1,1,236,23.6,1,3,5,5,7.2,18573,15747,1574.7,1275,521,0
1592,523,-1060,1605.1,16051,17771,7.0,6,6,5,197,19.7,0,0,1,0,1,226,22.6,1,4,5,5,7.2,18831,15528,1552.8,1060,-523,0
1593,-341,-1982,1515.8,15158,17197,6.8,3,3,4,236,23.6,0,0,0,1,1,219,21.9,2,5,4,4,7.0,19179,15499,1549.9,1982,341,1
1594,247,-775,1693.4,16934,16045,6.4,8,8,13,193,19.3,0,0,1,0,1,191,19.1,1,6,8,8,6.6,16820,16687,1668.7,775,-247,0
1595,-2236,-2070,1522.8,15228,16963,6.8,4,4,7,198,19.8,1,0,1,0,1,227,22.7,1,8,8,8,7.2,19033,17464,1746.4,2070,2236,0
1596,3297,2983,1771.0,17710,18758,7.0,10,10,7,205,20.5,0,0,1,0,1,183,18.3,1,3,4,4,6.4,15775,14413,1441.3,-2983,-3297,1
1597,-682,-89,1497.1,14971,18121,7.0,2,2,2,228,22.8,0,0,0,1,1,252,25.2,1,5,3,3,7.2,18210,15653,1565.3,89,682,0
1598,1923,437,1783.5,17835,18036,7.2,10,10,10,205,20.5,1,0,0,1,0,216,21.6,0,5,5,5,6.8,17599,15912,1591.2,-437,-1923,0
1599,1738,2447,1707.1,17071,19347,7.2,7,7,4,234,23.4,2,1,0,1,0,226,22.6,0,2,3,3,6.8,16900,15333,1533.3,-2447,-1738,1
1600,-3451,-2220,1624.5,16245,18044,7.0,6,6,10,208,20.8,1,1,0,1,0,235,23.5,1,10,11,11,7.6,20264,19696,1969.6,2220,3451,0
1601,2251,-284,1683.5,16835,17368,7.0,6,6,6,235,23.5,0,0,1,0,1,248,24.8,2,2,2,2,7.0,17652,14584,1458.4,284,-2251,0
1602,-884,963,1708.8,17088,18768,7.2,6,6,8,226,22.6,0,0,1,0,1,218,21.8,2,15,9,9,6.8,17805,17972,1797.2,-963,884,0
1603,864,898,1638.3,16383,19209,7.2,5,5,7,223,22.3,1,1,0,1,0,246,24.6,0,2,4,4,7.0,18311,15519,1551.9,-898,-864,0
1604,1830,-1232,1657.7,16577,17637,6.8,4,4,2,220,22.0,1,1,1,0,0,219,21.9,1,1,2,2,7.0,18869,14747,1474.7,1232,-1830,1
1605,3913,2948,1960.7,19607,19804,7.6,12,12,19,221,22.1,1,1,1,0,0,220,22.0,0,7,5,5,6.6,16856,15694,1569.4,-2948,-3913,1
1606,-2675,-1325,1577.5,15775,17200,6.6,8,8,7,149,14.9,2,1,1,0,0,231,23.1,0,11,9,9,7.0,18525,18450,1845.0,1325,2675,1
1607,-1430,147,1499.8,14998,16127,6.6,4,4,4,185,18.5,2,1,1,0,0,196,19.6,0,7,8,8,6.6,15980,16428,1642.8,-147,1430,0
1608,226,221,1690.6,16906,17910,6.8,8,8,10,207,20.7,2,1,1,0,0,176,17.6,0,4,8,8,6.8,17689,16680,1668.0,-221,-226,0
1609,4324,1705,1874.3,18743,18381,7.0,9,9,8,209,20.9,2,1,1,0,0,191,19.1,0,1,3,3,6.6,16676,14419,1441.9,-1705,-4324,1
1610,-355,279,1663.4,16634,17892,7.0,8,8,11,198,19.8,0,0,0,1,0,195,19.5,0,7,8,8,6.8,17613,16989,1698.9,-279,355,0
1611,-4529,-4665,1363.6,13636,14432,6.2,3,3,4,177,17.7,0,0,0,1,1,249,24.9,2,7,8,8,7.4,19097,18165,1816.5,4665,4529,0
1612,-4663,-3624,1374.4,13744,15449,6.4,3,3,1,167,16.7,1,1,1,0,0,219,21.9,0,11,10,10,7.2,19073,18407,1840.7,3624,4663,0
1613,-211,-1817,1582.3,15823,17501,6.8,4,4,9,230,23.0,1,1,1,0,0,233,23.3,0,4,4,4,7.2,19318,16034,1603.4,1817,211,0
1614,38,1241,1635.6,16356,19371,7.2,7,7,6,219,21.9,1,1,1,0,0,226,22.6,1,5,6,6,7.0,18130,16318,1631.8,-1241,-38,1
1615,3315,904,1980.1,19801,17196,6.6,11,11,14,195,19.5,1,0,0,1,1,147,14.7,1,12,9,9,6.4,16292,16486,1648.6,-904,-3315,0
1616,1211,-757,1820.0,18200,17815,7.0,11,11,12,202,20.2,0,0,1,0,1,211,21.1,1,10,9,9,7.2,18572,16989,1698.9,757,-1211,0
1617,-188,270,1533.5,15335,18648,6.8,4,4,2,230,23.0,0,0,0,1,1,248,24.8,1,2,3,3,7.0,18378,15523,1552.3,-270,188,0
1618,1852,2113,1679.2,16792,18901,7.2,6,6,4,238,23.8,0,0,1,0,0,218,21.8,0,5,4,4,6.6,16788,14940,1494.0,-2113,-1852,1
1619,3059,1408,2008.6,20086,18345,7.0,12,12,13,232,23.2,1,1,1,0,0,207,20.7,1,8,8,8,6.4,16937,17027,1702.7,-1408,-3059,0
1620,-2552,-2268,1385.8,13858,16054,6.4,1,1,1,232,23.2,0,0,0,1,1,239,23.9,2,6,4,4,7.0,18322,16410,1641.0,2268,2552,0
1621,-1566,-1852,1619.0,16190,17505,7.0,5,5,9,222,22.2,0,0,1,0,1,258,25.8,1,6,7,7,7.2,19357,17756,1775.6,1852,1566,0
1622,-2967,-758,1611.2,16112,18155,7.0,7,7,5,202,20.2,0,0,1,0,0,238,23.8,0,10,10,10,7.2,18913,19079,1907.9,758,2967,0
1623,-98,-169,1729.8,17298,17146,6.8,9,9,10,198,19.8,1,0,0,1,1,182,18.2,1,13,11,11,7.0,17315,17396,1739.6,169,98,1
1624,-1972,-1177,1459.3,14593,17874,6.6,2,2,3,240,24.0,0,0,0,1,0,253,25.3,0,5,4,4,7.2,19051,16565,1656.5,1177,1972,0
1625,557,-1383,1772.3,17723,17913,6.8,10,10,17,201,20.1,1,1,1,0,0,204,20.4,0,9,8,8,7.4,19296,17166,1716.6,1383,-557,1
1626,1217,309,1656.5,16565,17417,6.8,8,8,11,204,20.4,1,0,1,0,0,214,21.4,0,2,3,3,6.6,17108,15348,1534.8,-309,-1217,0
1627,-27,394,1630.1,16301,19215,7.2,4,4,7,254,25.4,0,0,0,1,1,234,23.4,1,6,5,5,7.2,18821,16328,1632.8,-394,27,1
1628,865,2685,1669.8,16698,19972,7.2,6,6,5,238,23.8,1,0,1,0,1,213,21.3,1,8,5,5,6.8,17287,15833,1583.3,-2685,-865,1
1629,-1653,-1289,1487.8,14878,18414,7.0,1,1,1,235,23.5,0,0,0,1,1,258,25.8,1,4,4,4,7.2,19703,16531,1653.1,1289,1653,0
1630,1932,2097,1649.4,16494,19149,7.0,5,5,3,255,25.5,1,1,0,1,0,182,18.2,0,3,3,3,6.6,17052,14562,1456.2,-2097,-1932,0
1631,-3386,-2729,1546.3,15463,17005,7.0,5,5,4,206,20.6,0,0,1,0,0,234,23.4,0,13,9,9,7.0,19734,18849,1884.9,2729,3386,0
1632,-5097,-3482,1543.5,15435,15816,6.6,6,6,9,161,16.1,0,0,0,1,1,226,22.6,1,16,15,15,7.4,19298,20532,2053.2,3482,5097,0
1633,1321,1735,1616.5,16165,18233,6.8,5,5,8,215,21.5,2,1,1,0,0,245,24.5,0,2,1,1,6.6,16498,14844,1484.4,-1735,-1321,0
1634,-276,-1424,1664.0,16640,17949,7.2,6,6,9,233,23.3,1,1,1,0,0,220,22.0,0,8,6,6,7.4,19373,16916,1691.6,1424,276,0
1635,-19,-1122,1642.2,16422,17507,7.0,6,6,6,212,21.2,1,0,1,0,0,256,25.6,0,2,4,4,7.0,18629,16441,1644.1,1122,19,0
1636,2590,1850,1786.3,17863,19086,7.2,8,8,7,256,25.6,0,0,1,0,0,218,21.8,0,4,4,4,7.0,17236,15273,1527.3,-1850,-2590,1
1637,510,-601,1697.0,16970,17201,6.8,8,8,8,226,22.6,0,0,1,0,1,230,23.0,1,10,6,6,6.8,17802,16460,1646.0,601,-510,0
1638,103,412,1486.6,14866,17470,6.8,4,4,7,191,19.1,0,0,0,1,0,239,23.9,1,3,2,2,6.8,17058,14763,1476.3,-412,-103,0
1639,-237,-500,1776.1,17761,18196,7.0,9,9,10,229,22.9,0,0,1,0,1,200,20.0,1,13,10,10,7.2,18696,17998,1799.8,500,237,1
1640,-612,549,1665.0,16650,18854,7.0,7,7,5,233,23.3,0,0,0,1,1,232,23.2,2,5,4,4,7.0,18305,17262,1726.2,-549,612,1
1641,4488,3191,1860.7,18607,20228,7.4,8,8,6,264,26.4,1,0,1,0,1,210,21.0,1,1,1,1,6.6,17037,14119,1411.9,-3191,-4488,0
1642,335,675,1623.7,16237,17830,6.8,8,8,6,209,20.9,0,0,0,1,1,192,19.2,1,5,5,5,6.8,17155,15902,1590.2,-675,-335,0
1643,-814,-418,1427.3,14273,17164,6.8,2,2,2,220,22.0,1,1,0,1,0,224,22.4,1,2,3,3,6.6,17582,15087,1508.7,418,814,0
1644,-39,464,1590.6,15906,17700,7.0,6,6,7,232,23.2,1,1,1,0,0,197,19.7,0,9,5,5,6.6,17236,15945,1594.5,-464,39,1
1645,80,-609,1608.3,16083,18268,6.8,4,4,3,264,26.4,0,0,1,0,1,225,22.5,1,8,5,5,7.2,18877,16003,1600.3,609,-80,1
1646,-1975,-888,1503.4,15034,17176,7.0,2,2,2,204,20.4,2,1,0,1,0,201,20.1,0,11,8,8,7.0,18064,17009,1700.9,888,1975,0
1647,1723,970,1666.0,16660,18967,7.2,5,5,7,257,25.7,0,0,1,0,1,227,22.7,2,5,3,3,7.0,17997,14937,1493.7,-970,-1723,0
1648,-5763,-4731,1394.5,13945,14302,5.8,5,5,2,155,15.5,1,1,1,0,0,203,20.3,1,11,9,9,7.4,19033,19708,1970.8,4731,5763,0
1649,-6050,-4081,1499.1,14991,17279,6.6,3,3,6,207,20.7,0,0,0,1,0,273,27.3,0,16,13,13,7.6,21360,21041,2104.1,4081,6050,0
1650,1152,-29,1665.3,16653,18507,7.0,3,3,6,261,26.1,1,1,1,0,0,228,22.8,0,6,3,3,7.2,18536,15501,1550.1,29,-1152,0
1651,3822,2980,1755.7,17557,18193,7.0,7,7,9,209,20.9,1,0,1,0,0,224,22.4,0,1,2,2,6.0,15213,13735,1373.5,-2980,-3822,1
1652,-2975,-2024,1443.9,14439,16198,6.6,4,4,4,196,19.6,1,1,0,1,0,235,23.5,0,10,8,8,7.0,18222,17414,1741.4,2024,2975,0
1653,1526,472,1856.7,18567,18176,7.0,12,12,18,227,22.7,1,1,1,0,0,203,20.3,0,7,5,5,6.8,17704,17041,1704.1,-472,-1526,1
1654,3916,2599,1707.9,17079,17962,7.0,9,9,9,229,22.9,1,1,1,0,0,191,19.1,0,0,1,1,6.6,15363,13163,1316.3,-2599,-3916,1
1655,8776,8348,2105.1,21051,20745,7.4,6,6,2,276,27.6,2,1,1,0,0,176,17.6,0,1,1,1,5.4,12397,12275,1227.5,-8348,-8776,1
1656,-4493,-3830,1522.9,15229,16071,6.4,8,8,4,213,21.3,0,0,0,1,1,218,21.8,2,10,10,10,7.4,19901,19722,1972.2,3830,4493,0
1657,1018,-1023,1649.0,16490,18411,7.0,5,5,3,214,21.4,1,1,1,0,0,204,20.4,1,2,4,4,7.2,19434,15472,1547.2,1023,-1018,1
1658,-97,165,1704.7,17047,17601,7.0,8,8,7,200,20.0,0,0,1,0,1,198,19.8,1,6,9,9,6.8,17436,17144,1714.4,-165,97,1
1659,-933,-636,1484.4,14844,17089,7.0,4,4,4,187,18.7,0,0,0,1,0,217,21.7,1,6,6,6,7.0,17725,15777,1577.7,636,933,0
1660,-4322,-1588,1638.2,16382,18090,7.2,8,8,10,206,20.6,0,0,0,1,0,244,24.4,1,8,10,10,7.2,19678,20704,2070.4,1588,4322,0
1661,1350,524,1811.3,18113,19187,7.2,7,7,11,231,23.1,0,0,0,1,0,262,26.2,0,6,4,4,7.0,18663,16763,1676.3,-524,-1350,1
1662,-5490,-2476,1393.3,13933,16583,6.6,1,1,0,194,19.4,0,0,0,1,1,225,22.5,1,8,9,9,7.2,19059,19423,1942.3,2476,5490,0
1663,-730,58,1635.2,16352,17749,6.8,8,8,9,214,21.4,1,1,0,1,0,191,19.1,0,10,8,8,7.0,17691,17082,1708.2,-58,730,0
1664,-631,337,1509.8,15098,19226,7.0,2,2,0,239,23.9,0,0,1,0,1,258,25.8,1,2,2,2,7.2,18889,15729,1572.9,-337,631,1
1665,-183,254,1638.4,16384,18938,7.4,5,5,4,244,24.4,1,0,1,0,1,243,24.3,1,3,4,4,7.0,18684,16567,1656.7,-254,183,0
1666,-2250,-1591,1713.2,17132,16777,6.6,7,7,9,198,19.8,1,0,1,0,1,196,19.6,1,17,11,11,7.0,18368,19382,1938.2,1591,2250,0
1667,493,-699,1611.6,16116,18086,6.8,5,5,6,249,24.9,1,1,1,0,0,250,25.0,0,3,3,3,7.2,18785,15623,1562.3,699,-493,0
1668,-211,-626,1720.1,17201,18871,7.0,7,7,11,230,23.0,0,0,1,0,1,222,22.2,1,10,7,7,7.2,19497,17412,1741.2,626,211,0
1669,-1611,97,1522.4,15224,18728,7.0,3,3,4,228,22.8,0,0,0,1,0,247,24.7,0,11,6,6,7.2,18631,16835,1683.5,-97,1611,1
1670,-1343,-768,1533.4,15334,16172,6.4,6,6,3,203,20.3,0,0,0,1,1,204,20.4,1,5,8,8,6.6,16940,16677,1667.7,768,1343,0
1671,5512,3244,2101.6,21016,20144,7.4,12,12,17,272,27.2,2,1,1,0,0,212,21.2,0,6,3,3,6.6,16900,15504,1550.4,-3244,-5512,1
1672,-3590,-1683,1581.2,15812,17646,6.8,7,7,9,186,18.6,0,0,0,1,1,216,21.6,1,10,13,13,7.2,19329,19402,1940.2,1683,3590,0
1673,-406,-1748,1544.7,15447,15691,6.2,5,5,10,194,19.4,1,0,1,0,0,219,21.9,0,6,5,5,7.0,17439,15853,1585.3,1748,406,1
1674,-2150,-1215,1581.2,15812,16319,6.6,5,5,6,209,20.9,0,0,1,0,1,175,17.5,1,18,11,11,6.8,17534,17962,1796.2,1215,2150,0
1675,-679,-1331,1430.1,14301,17056,6.8,1,1,1,214,21.4,1,1,0,1,0,216,21.6,0,2,5,5,7.0,18387,14980,1498.0,1331,679,0
1676,-3114,-2569,1474.9,14749,16489,6.6,2,2,1,204,20.4,1,0,0,1,0,224,22.4,0,5,10,10,7.2,19058,17863,1786.3,2569,3114,1
1677,1564,668,1760.5,17605,19964,7.4,7,7,6,254,25.4,0,0,0,1,1,214,21.4,1,3,6,6,7.2,19296,16041,1604.1,-668,-1564,1
1678,-4205,-1540,1553.5,15535,17403,6.8,5,5,5,207,20.7,1,1,0,1,0,251,25.1,0,10,9,9,7.4,18943,19740,1974.0,1540,4205,0
1679,4172,1918,1876.1,18761,19378,7.2,11,11,13,230,23.0,0,0,1,0,0,259,25.9,0,1,1,1,6.8,17460,14589,1458.9,-1918,-4172,1
1680,-2672,-2811,1685.5,16855,16841,6.4,8,8,5,216,21.6,1,1,1,0,0,204,20.4,0,19,12,12,7.4,19652,19527,1952.7,2811,2672,1
1681,4287,3938,2135.2,21352,20771,7.6,18,18,15,224,22.4,1,1,1,0,0,135,13.5,0,11,10,10,6.8,16833,17065,1706.5,-3938,-4287,1
1682,811,881,1599.0,15990,18712,7.2,5,5,7,221,22.1,1,1,1,0,0,235,23.5,0,1,1,1,7.0,17831,15179,1517.9,-881,-811,0
1683,-585,-809,1501.5,15015,16819,6.4,5,5,3,184,18.4,1,1,1,0,0,248,24.8,1,2,4,4,6.8,17628,15600,1560.0,809,585,1
1684,-1042,-2030,1543.2,15432,16542,6.6,5,5,3,223,22.3,1,0,0,1,1,221,22.1,1,8,6,6,7.0,18572,16474,1647.4,2030,1042,0
1685,163,1490,1540.4,15404,18235,7.0,4,4,4,236,23.6,0,0,0,1,1,238,23.8,1,3,3,3,6.8,16745,15241,1524.1,-1490,-163,0
1686,1697,1110,1622.4,16224,18401,7.2,5,5,5,233,23.3,1,1,1,0,0,238,23.8,0,1,1,1,6.6,17291,14527,1452.7,-1110,-1697,0
1687,1059,180,1743.7,17437,17146,7.0,10,10,15,177,17.7,1,1,1,0,0,186,18.6,1,5,7,7,6.8,16966,16378,1637.8,-180,-1059,0
1688,1498,149,1778.3,17783,19374,7.6,6,6,5,236,23.6,1,0,1,0,1,213,21.3,1,7,6,6,7.4,19225,16285,1628.5,-149,-1498,0
1689,457,692,1761.8,17618,19023,7.2,8,8,5,227,22.7,0,0,0,1,1,225,22.5,1,5,8,8,7.0,18331,17161,1716.1,-692,-457,1
1690,4620,2871,1898.4,18984,20083,7.4,9,9,16,254,25.4,1,1,0,1,0,171,17.1,0,3,2,2,6.6,17212,14364,1436.4,-2871,-4620,1
1691,1117,-637,1810.4,18104,17404,6.8,11,11,8,205,20.5,1,1,1,0,0,168,16.8,0,6,10,10,6.8,18041,16987,1698.7,637,-1117,1
1692,929,1352,1725.0,17250,19462,7.0,5,5,2,251,25.1,0,0,1,0,1,211,21.1,1,9,6,6,7.2,18110,16321,1632.1,-1352,-929,1
1693,459,1309,1622.2,16222,18814,7.0,5,5,7,243,24.3,2,1,0,1,0,234,23.4,0,1,4,4,7.0,17505,15763,1576.3,-1309,-459,0
1694,-2537,-1603,1517.9,15179,17994,7.0,3,3,2,238,23.8,0,0,0,1,1,216,21.6,1,6,8,8,7.2,19597,17716,1771.6,1603,2537,0
1695,-4882,-4505,1389.6,13896,13354,5.6,3,3,2,197,19.7,0,0,1,0,1,204,20.4,1,18,13,13,6.8,17859,18778,1877.8,4505,4882,0
1696,1014,688,1791.1,17911,17981,6.8,8,8,11,218,21.8,0,0,0,1,0,191,19.1,1,12,8,8,6.6,17293,16897,1689.7,-688,-1014,0
1697,3039,2255,1858.2,18582,18818,7.0,11,11,10,217,21.7,0,0,0,1,0,203,20.3,0,8,5,5,6.6,16563,15543,1554.3,-2255,-3039,1
1698,650,511,1909.9,19099,17642,6.8,13,13,18,207,20.7,2,1,1,0,0,204,20.4,0,8,10,10,6.6,17131,18449,1844.9,-511,-650,1
1699,-905,-709,1587.9,15879,17163,6.8,6,6,8,187,18.7,1,0,1,0,1,183,18.3,1,10,9,9,7.0,17872,16784,1678.4,709,905,1
1700,966,969,1735.4,17354,18013,6.8,9,9,4,239,23.9,0,0,0,1,1,208,20.8,1,4,7,7,6.8,17044,16388,1638.8,-969,-966,1
1701,-429,-1821,1676.0,16760,16615,6.6,6,6,9,186,18.6,1,0,1,0,0,242,24.2,0,10,8,8,7.2,18436,17189,1718.9,1821,429,0
1702,1211,355,1683.9,16839,17206,6.6,7,7,8,209,20.9,2,1,1,0,0,191,19.1,0,9,5,5,6.8,16851,15628,1562.8,-355,-1211,1
1703,53,-114,1618.6,16186,18472,7.0,6,6,6,225,22.5,1,1,1,0,0,205,20.5,0,5,5,5,6.8,18586,16133,1613.3,114,-53,0
1704,649,-103,1691.5,16915,17888,7.0,9,9,10,198,19.8,1,1,1,0,0,197,19.7,0,5,5,5,6.8,17991,16266,1626.6,103,-649,0
1705,-135,-1288,1795.1,17951,16342,6.2,9,9,7,207,20.7,0,0,0,1,1,190,19.0,1,11,11,11,6.6,17630,18086,1808.6,1288,135,0
1706,1137,-609,1772.2,17722,18555,7.2,8,8,7,224,22.4,1,1,1,0,0,225,22.5,1,6,7,7,7.2,19164,16585,1658.5,609,-1137,1
1707,3951,2490,1838.1,18381,19201,7.0,9,9,9,249,24.9,1,1,1,0,0,214,21.4,0,0,1,1,6.6,16711,14430,1443.0,-2490,-3951,1
1708,-859,-2114,1608.4,16084,17317,6.8,5,5,5,219,21.9,0,0,0,1,1,244,24.4,1,5,6,6,7.4,19431,16943,1694.3,2114,859,0
1709,-962,612,1505.4,15054,18364,7.2,2,2,0,239,23.9,0,0,0,1,1,233,23.3,1,6,6,6,6.8,17752,16016,1601.6,-612,962,0
1710,2554,1453,1783.8,17838,17217,6.8,12,12,17,194,19.4,0,0,1,0,0,215,21.5,0,5,5,5,6.4,15764,15284,1528.4,-1453,-2554,1
1711,1158,-618,1741.5,17415,18304,6.8,8,8,8,239,23.9,0,0,1,0,1,184,18.4,1,4,7,7,7.2,18922,16257,1625.7,618,-1158,0
1712,-2963,-1630,1502.5,15025,17533,6.6,3,3,3,234,23.4,1,1,0,1,0,252,25.2,1,6,6,6,7.2,19163,17988,1798.8,1630,2963,0
1713,-1894,-2184,1536.2,15362,15828,6.2,4,4,4,206,20.6,0,0,0,1,0,196,19.6,1,4,7,7,7.0,18012,17256,1725.6,2184,1894,0
1714,-1535,-716,1503.8,15038,17152,6.8,4,4,1,230,23.0,0,0,0,1,1,215,21.5,1,8,7,7,6.8,17868,16573,1657.3,716,1535,0
1715,1654,1097,1772.6,17726,18294,7.2,8,8,11,218,21.8,0,0,0,1,0,219,21.9,0,5,4,4,6.8,17197,16072,1607.2,-1097,-1654,1
1716,-516,266,1568.5,15685,18609,7.0,3,3,3,232,23.2,2,1,0,1,0,208,20.8,0,8,6,6,6.8,18343,16201,1620.1,-266,516,0
1717,2577,2592,1753.0,17530,19895,7.2,6,6,7,221,22.1,1,0,1,0,1,196,19.6,1,3,4,4,6.8,17303,14953,1495.3,-2592,-2577,1
1718,-402,-520,1626.0,16260,17516,6.8,6,6,10,205,20.5,0,0,1,0,0,219,21.9,1,7,6,6,7.0,18036,16662,1666.2,520,402,0
1719,-4404,-3165,1566.8,15668,16531,6.8,5,5,5,183,18.3,0,0,0,1,1,256,25.6,1,9,10,10,7.2,19696,20072,2007.2,3165,4404,0
1720,-2922,-1424,1651.1,16511,18667,7.2,7,7,7,209,20.9,1,0,0,1,0,212,21.2,0,13,10,10,7.4,20091,19433,1943.3,1424,2922,0
1721,-659,-701,1696.5,16965,17225,6.8,8,8,13,200,20.0,1,1,1,0,0,220,22.0,0,15,11,11,6.8,17926,17624,1762.4,701,659,1
1722,1924,1938,1821.2,18212,18286,7.0,11,11,17,201,20.1,0,0,1,0,0,212,21.2,0,5,6,6,6.6,16348,16288,1628.8,-1938,-1924,0
1723,-2075,-738,1504.2,15042,17849,7.0,4,4,2,207,20.7,0,0,0,1,1,236,23.6,2,5,7,7,7.0,18587,17117,1711.7,738,2075,0
1724,-1055,-1236,1566.1,15661,17735,6.8,4,4,2,235,23.5,0,0,1,0,0,222,22.2,0,8,6,6,7.2,18971,16716,1671.6,1236,1055,0
1725,3239,2494,1798.6,17986,18856,7.0,10,10,11,218,21.8,1,0,1,0,0,198,19.8,0,4,3,3,6.6,16362,14747,1474.7,-2494,-3239,1
1726,-2765,-2677,1377.6,13776,16664,6.8,0,0,0,218,21.8,1,0,0,1,1,256,25.6,1,6,5,5,7.2,19341,16541,1654.1,2677,2765,0
1727,-1183,-1425,1533.0,15330,15016,6.2,7,7,6,186,18.6,0,0,0,1,1,199,19.9,1,10,8,8,6.6,16441,16513,1651.3,1425,1183,0
1728,-1012,-1528,1472.7,14727,17726,7.0,4,4,0,197,19.7,0,0,1,0,1,238,23.8,1,7,4,4,7.2,19254,15739,1573.9,1528,1012,0
1729,3245,307,1765.1,17651,18454,6.8,7,7,8,229,22.9,1,1,1,0,0,179,17.9,0,3,4,4,6.8,18147,14406,1440.6,-307,-3245,1
1730,-157,-269,1549.6,15496,16654,6.6,5,5,10,184,18.4,0,0,1,0,1,229,22.9,1,4,3,3,6.6,16923,15653,1565.3,269,157,0
1731,2862,1862,1839.5,18395,19262,7.4,9,9,10,242,24.2,1,1,1,0,0,200,20.0,0,4,6,6,6.8,17400,15533,1553.3,-1862,-2862,1
1732,789,-1212,1686.6,16866,17217,6.8,7,7,8,220,22.0,1,1,1,0,0,224,22.4,0,5,4,4,6.8,18429,16077,1607.7,1212,-789,1
1733,-986,-484,1644.9,16449,18091,7.0,7,7,12,211,21.1,0,0,0,1,1,238,23.8,1,13,7,7,7.2,18575,17435,1743.5,484,986,0
1734,-812,-202,1614.2,16142,18926,7.0,5,5,4,218,21.8,1,1,0,1,0,233,23.3,0,2,8,8,7.2,19128,16954,1695.4,202,812,1
1735,-3196,-3217,1509.9,15099,17573,6.6,4,4,2,205,20.5,0,0,1,0,1,226,22.6,1,10,7,7,7.4,20790,18295,1829.5,3217,3196,0
1736,738,1289,1804.4,18044,18900,7.2,9,9,7,207,20.7,1,1,1,0,0,188,18.8,0,11,8,8,6.8,17611,17306,1730.6,-1289,-738,1
1737,1144,464,1624.8,16248,18554,7.2,5,5,6,251,25.1,0,0,1,0,0,199,19.9,0,5,5,5,7.0,18090,15104,1510.4,-464,-1144,1
1738,246,759,1518.2,15182,17949,7.0,5,5,5,205,20.5,1,1,0,1,0,230,23.0,1,2,2,2,7.0,17190,14936,1493.6,-759,-246,1
1739,-919,-483,1565.1,15651,17769,6.8,6,6,5,195,19.5,0,0,0,1,1,203,20.3,1,5,6,6,7.0,18252,16570,1657.0,483,919,0
1740,805,691,1591.7,15917,18370,7.0,5,5,1,211,21.1,2,1,1,0,0,187,18.7,0,4,4,4,6.8,17679,15112,1511.2,-691,-805,1
1741,-1656,-453,1388.9,13889,16733,6.8,2,2,2,193,19.3,0,0,0,1,1,229,22.9,1,8,5,5,6.6,17186,15545,1554.5,453,1656,0
1742,1153,930,1685.8,16858,18305,7.0,7,7,5,241,24.1,0,0,1,0,1,211,21.1,1,11,5,5,7.0,17375,15705,1570.5,-930,-1153,0
1743,740,-692,1811.9,18119,16050,6.4,9,9,17,204,20.4,0,0,1,0,1,210,21.0,1,18,8,8,6.8,16742,17379,1737.9,692,-740,1
1744,2841,858,1735.2,17352,17199,6.8,8,8,9,207,20.7,0,0,1,0,1,198,19.8,1,4,2,2,6.6,16341,14511,1451.1,-858,-2841,0
1745,449,-260,1792.4,17924,16556,6.6,11,11,15,219,21.9,0,0,0,1,0,182,18.2,0,10,9,9,6.8,16816,17475,1747.5,260,-449,0
1746,-1759,-2019,1449.0,14490,17534,6.8,3,3,2,226,22.6,0,0,1,0,1,247,24.7,1,1,4,4,7.2,19553,16249,1624.9,2019,1759,0
1747,-1257,333,1617.2,16172,18147,6.8,6,6,10,189,18.9,0,0,0,1,1,226,22.6,1,11,8,8,7.0,17814,17429,1742.9,-333,1257,0
1748,-1824,-613,1455.5,14555,17217,6.8,1,1,1,239,23.9,0,0,0,1,0,204,20.4,1,6,6,6,7.0,17830,16379,1637.9,613,1824,0
1749,-843,147,1535.5,15355,17702,7.2,6,6,6,197,19.7,0,0,0,1,1,223,22.3,1,7,5,5,7.0,17555,16198,1619.8,-147,843,0
1750,-2618,-1567,1439.5,14395,16209,6.4,4,4,3,175,17.5,1,1,1,0,0,213,21.3,0,11,8,8,7.0,17776,17013,1701.3,1567,2618,0
1751,253,-453,1663.0,16630,18540,7.0,6,6,7,225,22.5,1,1,1,0,0,213,21.3,0,3,6,6,7.0,18993,16377,1637.7,453,-253,0
1752,1229,1913,1698.4,16984,18842,7.2,8,8,9,225,22.5,0,0,0,1,0,214,21.4,0,3,5,5,6.8,16929,15755,1575.5,-1913,-1229,0
1753,-938,-1180,1667.5,16675,17477,7.0,7,7,9,205,20.5,1,1,0,1,0,199,19.9,0,12,9,9,7.2,18657,17613,1761.3,1180,938,0
1754,-487,764,1625.8,16258,18355,7.0,7,7,6,207,20.7,0,0,0,1,0,207,20.7,1,4,4,4,6.6,17591,16745,1674.5,-764,487,0
1755,-1431,-648,1557.1,15571,18029,7.2,3,3,3,212,21.2,0,0,0,1,1,241,24.1,1,9,7,7,7.0,18677,17002,1700.2,648,1431,0
1756,4498,4087,1974.0,19740,19505,7.4,12,12,13,228,22.8,1,1,1,0,0,183,18.3,0,6,5,5,6.2,15418,15242,1524.2,-4087,-4498,1
1757,-3574,-3171,1374.9,13749,16076,6.2,1,1,0,208,20.8,1,1,0,1,0,222,22.2,0,9,7,7,7.2,19247,17323,1732.3,3171,3574,1
1758,693,-204,1623.1,16231,18511,7.2,4,4,3,271,27.1,2,1,1,0,0,245,24.5,0,1,1,1,7.2,18715,15538,1553.8,204,-693,1
1759,-915,3,1573.6,15736,17285,7.0,6,6,5,188,18.8,0,0,0,1,1,199,19.9,1,4,7,7,7.0,17282,16651,1665.1,-3,915,1
1760,1847,1663,1709.9,17099,19019,7.2,6,6,8,222,22.2,0,0,0,1,1,210,21.0,2,5,3,3,6.8,17356,15252,1525.2,-1663,-1847,0
1761,2978,-438,1762.0,17620,17878,6.8,8,8,10,236,23.6,0,0,1,0,0,180,18.0,0,4,2,2,7.2,18316,14642,1464.2,438,-2978,1
1762,1245,1084,1625.0,16250,17489,6.6,5,5,6,231,23.1,0,0,0,1,0,216,21.6,0,5,4,4,6.6,16405,15005,1500.5,-1084,-1245,1
1763,-1632,562,1713.6,17136,17495,7.0,8,8,11,207,20.7,1,1,0,1,0,173,17.3,1,17,10,10,6.8,16933,18768,1876.8,-562,1632,0
1764,8657,7609,2222.8,22228,18219,7.2,13,13,10,234,23.4,1,1,1,0,0,107,10.7,0,9,7,7,4.8,10610,13571,1357.1,-7609,-8657,1
1765,2197,233,1884.7,18847,19097,7.0,9,9,15,218,21.8,0,0,1,0,1,236,23.6,1,8,6,6,7.4,18864,16650,1665.0,-233,-2197,1
1766,-9152,-8290,1346.2,13462,12212,5.4,2,2,2,130,13.0,0,0,0,1,0,247,24.7,0,12,15,15,7.4,20502,22614,2261.4,8290,9152,0
1767,687,-291,1636.4,16364,18941,7.2,7,7,7,239,23.9,0,0,0,1,1,232,23.2,1,7,4,4,7.2,19232,15677,1567.7,291,-687,0
1768,220,-740,1727.9,17279,17886,6.8,6,6,9,233,23.3,0,0,0,1,1,211,21.1,1,10,8,8,7.2,18626,17059,1705.9,740,-220,1
1769,-96,-1063,1465.4,14654,16892,6.8,1,1,1,225,22.5,0,0,1,0,0,240,24.0,0,1,2,2,7.0,17955,14750,1475.0,1063,96,1
1770,-3746,-3014,1521.1,15211,16421,6.4,6,6,8,187,18.7,0,0,0,1,1,230,23.0,1,18,12,12,7.2,19435,18957,1895.7,3014,3746,0
1771,629,1496,1707.6,17076,19064,7.4,5,5,11,223,22.3,1,1,1,0,0,215,21.5,0,11,6,6,6.8,17568,16447,1644.7,-1496,-629,1
1772,-1476,-346,1453.6,14536,17837,7.0,1,1,2,214,21.4,1,0,0,1,1,253,25.3,1,4,4,4,7.0,18183,16012,1601.2,346,1476,1
1773,-575,-1680,1730.8,17308,17903,6.8,7,7,7,198,19.8,1,1,0,1,0,227,22.7,0,6,9,9,7.0,19583,17883,1788.3,1680,575,0
1774,-635,-1525,1620.3,16203,17228,6.8,4,4,4,205,20.5,1,0,1,0,1,206,20.6,1,8,6,6,7.2,18753,16838,1683.8,1525,635,0
1775,149,447,1613.0,16130,17004,6.8,6,6,4,235,23.5,1,1,1,0,0,241,24.1,0,3,5,5,6.6,16557,15981,1598.1,-447,-149,1
1776,657,-1141,1573.9,15739,16738,7.0,2,2,3,223,22.3,1,0,1,0,1,199,19.9,1,5,4,4,6.8,17879,15082,1508.2,1141,-657,0
1777,-958,264,1749.8,17498,18569,7.2,9,9,13,228,22.8,0,0,0,1,1,200,20.0,1,18,11,11,7.2,18305,18456,1845.6,-264,958,0
1778,-2922,-2165,1494.7,14947,16859,6.6,6,6,3,165,16.5,0,0,0,1,1,239,23.9,1,6,9,9,7.2,19024,17869,1786.9,2165,2922,1
1779,-3410,-3134,1489.3,14893,16350,6.4,3,3,3,217,21.7,0,0,0,1,1,240,24.0,1,13,11,11,7.4,19484,18303,1830.3,3134,3410,0
1780,311,559,1881.7,18817,17845,7.0,11,11,11,192,19.2,1,0,0,1,0,228,22.8,0,6,8,8,6.8,17286,18506,1850.6,-559,-311,1
1781,1792,1373,1770.4,17704,18715,7.0,9,9,10,197,19.7,1,0,1,0,1,205,20.5,1,2,6,6,6.6,17342,15912,1591.2,-1373,-1792,1
1782,-856,-2269,1571.7,15717,16927,6.6,1,1,1,241,24.1,1,0,0,1,1,245,24.5,1,11,6,6,7.2,19196,16573,1657.3,2269,856,0
1783,1154,999,1725.2,17252,18227,7.0,10,10,9,212,21.2,1,1,1,0,0,220,22.0,0,5,6,6,7.0,17228,16098,1609.8,-999,-1154,1
1784,-2124,-1109,1479.4,14794,17179,6.8,3,3,3,185,18.5,0,0,0,1,1,217,21.7,1,7,7,7,7.0,18288,16918,1691.8,1109,2124,0
1785,-982,36,1475.1,14751,17562,6.8,3,3,5,217,21.7,0,0,0,1,1,210,21.0,1,6,4,4,6.8,17526,15733,1573.3,-36,982,0
1786,467,-298,1543.0,15430,18761,7.0,2,2,2,246,24.6,1,1,1,0,0,236,23.6,0,2,2,2,7.0,19059,14963,1496.3,298,-467,1
1787,-3389,-1855,1426.6,14266,17850,6.8,1,1,0,222,22.2,0,0,0,1,1,231,23.1,2,9,7,7,7.4,19705,17655,1765.5,1855,3389,0
1788,-1003,-491,1616.8,16168,17184,6.8,6,6,4,204,20.4,2,1,1,0,0,220,22.0,0,7,8,8,6.8,17675,17171,1717.1,491,1003,0
1789,572,417,1730.3,17303,18417,7.0,6,6,3,224,22.4,1,1,1,0,0,205,20.5,0,7,7,7,7.0,18000,16731,1673.1,-417,-572,1
1790,-1556,-1808,1611.1,16111,17170,6.8,6,6,7,204,20.4,1,1,0,1,0,241,24.1,0,5,8,8,7.2,18978,17667,1766.7,1808,1556,0
1791,2323,1699,1802.9,18029,18791,7.2,8,8,10,199,19.9,0,0,0,1,0,192,19.2,0,5,6,6,6.8,17092,15706,1570.6,-1699,-2323,1
1792,1486,1605,1669.5,16695,18868,7.2,7,7,7,222,22.2,0,0,1,0,1,229,22.9,1,3,4,4,6.8,17263,15209,1520.9,-1605,-1486,0
1793,3755,2662,1775.5,17755,19720,7.2,8,8,7,228,22.8,1,0,1,0,0,183,18.3,0,3,2,2,6.6,17058,14000,1400.0,-2662,-3755,1
1794,1327,-741,1738.8,17388,16792,6.6,8,8,12,214,21.4,1,1,0,1,0,190,19.0,0,6,8,8,6.6,17533,16061,1606.1,741,-1327,0
1795,2929,2507,1687.4,16874,19010,7.2,6,6,7,260,26.0,2,1,1,0,0,239,23.9,0,0,0,0,6.6,16503,13945,1394.5,-2507,-2929,1
1796,536,-18,1559.1,15591,17801,7.0,3,3,3,239,23.9,0,0,1,0,0,234,23.4,1,2,2,2,7.0,17819,15055,1505.5,18,-536,0
1797,3575,1394,1756.2,17562,17702,7.0,8,8,12,237,23.7,1,1,1,0,0,176,17.6,1,1,3,3,6.6,16308,13987,1398.7,-1394,-3575,1
1798,4801,2127,1962.8,19628,18889,7.2,12,12,16,229,22.9,1,1,1,0,0,198,19.8,0,4,4,4,6.8,16762,14827,1482.7,-2127,-4801,1
1799,-2201,-2344,1587.1,15871,16751,6.6,5,5,5,202,20.2,0,0,0,1,1,221,22.1,1,9,12,12,7.2,19095,18072,1807.2,2344,2201,0
1800,2785,1671,1779.2,17792,18238,7.0,9,9,8,222,22.2,0,0,1,0,1,204,20.4,1,1,5,5,6.6,16567,15007,1500.7,-1671,-2785,0
1801,-692,-736,1616.8,16168,16435,6.8,7,7,8,193,19.3,1,0,1,0,0,207,20.7,0,6,8,8,6.8,17171,16860,1686.0,736,692,0
1802,-4406,-2504,1578.6,15786,17495,6.6,4,4,3,217,21.7,1,1,0,1,0,233,23.3,0,15,11,11,7.2,19999,20192,2019.2,2504,4406,1
1803,1792,1300,1788.9,17889,19337,7.2,8,8,6,235,23.5,2,1,0,1,0,180,18.0,0,7,8,8,7.0,18037,16097,1609.7,-1300,-1792,1
1804,-6717,-4767,1361.2,13612,15504,6.4,2,2,3,181,18.1,1,0,0,1,1,226,22.6,1,17,14,14,7.6,20271,20329,2032.9,4767,6717,0
1805,-193,-634,1621.8,16218,16863,6.8,5,5,4,204,20.4,0,0,1,0,1,202,20.2,2,10,7,7,6.8,17497,16411,1641.1,634,193,0
1806,1667,3434,1818.8,18188,20313,7.4,8,8,6,252,25.2,0,0,0,1,1,188,18.8,1,8,6,6,6.4,16879,16521,1652.1,-3434,-1667,1
1807,-1860,-2194,1578.6,15786,16737,6.6,5,5,5,219,21.9,1,1,1,0,0,231,23.1,1,11,8,8,7.2,18931,17646,1764.6,2194,1860,0
1808,-3324,-3139,1441.9,14419,16385,6.2,1,1,1,235,23.5,1,1,1,0,0,246,24.6,0,7,7,7,7.4,19524,17743,1774.3,3139,3324,0
1809,-1655,-1744,1657.5,16575,17151,6.8,7,7,10,194,19.4,0,0,1,0,1,208,20.8,1,7,11,11,7.2,18895,18230,1823.0,1744,1655,0
1810,-321,272,1506.8,15068,17487,6.8,5,5,4,203,20.3,0,0,0,1,1,211,21.1,2,5,5,5,6.6,17215,15389,1538.9,-272,321,0
1811,4947,2051,1922.5,19225,20071,7.4,10,10,9,253,25.3,1,1,1,0,0,200,20.0,1,1,1,1,6.8,18020,14278,1427.8,-2051,-4947,1
1812,3424,3153,1868.8,18688,18613,7.2,10,10,10,218,21.8,0,0,1,0,0,170,17.0,0,7,6,6,6.2,15460,15264,1526.4,-3153,-3424,1
1813,3028,1818,1865.0,18650,18563,7.2,10,10,10,236,23.6,1,1,1,0,0,216,21.6,0,4,5,5,6.8,16745,15622,1562.2,-1818,-3028,1
1814,-211,843,1520.7,15207,18559,7.0,3,3,3,234,23.4,2,1,1,0,0,211,21.1,0,4,2,2,7.0,17716,15418,1541.8,-843,211,0
1815,2123,1612,1752.2,17522,18787,7.0,11,11,8,204,20.4,1,1,1,0,0,194,19.4,0,3,5,5,7.0,17175,15399,1539.9,-1612,-2123,1
1816,1025,439,1813.1,18131,17297,7.0,12,12,13,193,19.3,0,0,0,1,1,213,21.3,1,13,9,9,6.8,16858,17106,1710.6,-439,-1025,0
1817,2343,2878,1820.9,18209,18851,7.2,10,10,9,209,20.9,1,0,0,1,1,170,17.0,1,8,7,7,6.4,15973,15866,1586.6,-2878,-2343,1
1818,-565,738,1616.2,16162,18589,7.0,5,5,4,230,23.0,0,0,0,1,0,234,23.4,0,12,7,7,7.0,17851,16727,1672.7,-738,565,0
1819,-1785,-1131,1680.5,16805,18285,7.0,7,7,4,229,22.9,0,0,1,0,1,248,24.8,2,12,10,10,7.4,19416,18590,1859.0,1131,1785,1
1820,-873,-1792,1574.2,15742,18244,7.0,3,3,3,220,22.0,1,0,0,1,0,215,21.5,0,6,6,6,7.4,20036,16615,1661.5,1792,873,1
1821,1641,1386,1864.9,18649,19509,7.2,11,11,8,207,20.7,0,0,1,0,0,199,19.9,0,9,9,9,7.0,18123,17008,1700.8,-1386,-1641,1
1822,-1111,-1185,1664.3,16643,15836,6.6,4,4,4,202,20.2,1,0,0,1,1,188,18.8,1,15,12,12,6.4,17021,17754,1775.4,1185,1111,1
1823,-2390,-1796,1650.0,16500,17896,7.0,5,5,6,238,23.8,0,0,0,1,1,240,24.0,1,11,9,9,7.2,19692,18890,1889.0,1796,2390,1
1824,1807,733,1697.2,16972,18412,7.0,7,7,8,221,22.1,1,1,1,0,0,211,21.1,1,3,6,6,7.0,17679,15165,1516.5,-733,-1807,0
1825,-5003,-4682,1449.6,14496,16377,6.4,3,3,5,215,21.5,0,0,1,0,1,208,20.8,1,17,11,11,7.6,21059,19499,1949.9,4682,5003,0
1826,651,1744,1679.0,16790,19460,7.6,7,7,5,241,24.1,1,1,1,0,0,186,18.6,0,10,5,5,6.8,17716,16139,1613.9,-1744,-651,1
1827,928,955,1570.4,15704,18700,7.2,3,3,5,240,24.0,1,1,0,1,0,232,23.2,0,1,3,3,7.0,17745,14776,1477.6,-955,-928,1
1828,4649,3488,1828.5,18285,20035,7.4,7,7,8,259,25.9,1,1,1,0,0,215,21.5,0,0,0,0,6.4,16547,13636,1363.6,-3488,-4649,1
1829,-4743,-2650,1441.4,14414,16744,6.4,3,3,4,173,17.3,0,0,0,1,1,245,24.5,2,10,11,11,7.4,19394,19157,1915.7,2650,4743,0
1830,1775,1652,1698.1,16981,20082,7.2,3,3,3,269,26.9,0,0,1,0,1,256,25.6,2,2,1,1,7.0,18430,15206,1520.6,-1652,-1775,1
1831,2019,674,1851.6,18516,19255,7.0,10,10,12,240,24.0,1,1,1,0,0,214,21.4,0,8,6,6,7.2,18581,16497,1649.7,-674,-2019,1
1832,1402,2404,1559.4,15594,20342,7.4,3,3,0,241,24.1,1,1,0,1,0,215,21.5,0,1,1,1,6.8,17938,14192,1419.2,-2404,-1402,1
1833,240,399,1725.9,17259,18116,7.0,8,8,5,214,21.4,0,0,1,0,1,223,22.3,1,14,9,9,6.8,17717,17019,1701.9,-399,-240,1
1834,2281,546,1774.1,17741,17857,7.0,10,10,9,208,20.8,0,0,1,0,1,183,18.3,1,5,7,7,6.8,17311,15460,1546.0,-546,-2281,1
1835,764,2490,1786.7,17867,19316,7.2,8,8,6,226,22.6,2,1,1,0,0,178,17.8,0,6,7,7,6.6,16826,17103,1710.3,-2490,-764,1
1836,7579,4666,2146.2,21462,18193,6.8,15,15,16,208,20.8,0,0,1,0,0,139,13.9,0,7,4,4,5.8,13527,13883,1388.3,-4666,-7579,1
1837,-112,398,1554.8,15548,17592,6.8,4,4,3,221,22.1,0,0,0,1,1,232,23.2,2,3,4,4,6.8,17194,15660,1566.0,-398,112,1
1838,1198,197,1740.5,17405,19297,7.2,8,8,8,229,22.9,1,1,0,1,0,237,23.7,0,1,5,5,7.2,19100,16207,1620.7,-197,-1198,1
1839,2199,1291,1711.2,17112,18205,7.0,9,9,12,204,20.4,2,1,0,1,0,197,19.7,0,9,5,5,7.0,16914,14913,1491.3,-1291,-2199,1
1840,2992,258,1791.7,17917,17609,6.8,8,8,9,239,23.9,0,0,1,0,0,205,20.5,0,3,4,4,6.8,17351,14925,1492.5,-258,-2992,1
1841,-4292,-4133,1546.5,15465,14469,6.0,5,5,8,169,16.9,0,0,1,0,0,230,23.0,0,13,13,13,7.2,18602,19757,1975.7,4133,4292,0
1842,-1407,-1305,1602.0,16020,17044,6.8,5,5,6,240,24.0,0,0,1,0,1,226,22.6,1,12,8,8,7.2,18349,17427,1742.7,1305,1407,0
1843,1860,1500,1670.8,16708,18529,7.2,8,8,9,230,23.0,0,0,1,0,0,226,22.6,0,3,2,2,6.6,17029,14848,1484.8,-1500,-1860,1
1844,-1554,-704,1438.4,14384,16893,6.8,3,3,3,206,20.6,0,0,0,1,1,197,19.7,1,6,5,5,7.0,17597,15938,1593.8,704,1554,0
1845,-1004,-515,1842.0,18420,19093,7.2,11,11,10,225,22.5,0,0,0,1,0,205,20.5,0,14,14,14,7.2,19608,19424,1942.4,515,1004,0
1846,258,-298,1480.4,14804,17782,7.0,3,3,3,223,22.3,0,0,1,0,1,200,20.0,1,3,2,2,7.0,18080,14546,1454.6,298,-258,0
1847,190,-57,1627.9,16279,18977,7.0,6,6,3,234,23.4,0,0,1,0,1,218,21.8,2,6,5,5,7.2,19034,16089,1608.9,57,-190,1
1848,7413,4895,2171.1,21711,19183,7.4,15,15,16,247,24.7,1,1,1,0,0,136,13.6,0,5,4,4,5.8,14288,14298,1429.8,-4895,-7413,1
1849,1315,63,1712.4,17124,16900,6.4,8,8,8,207,20.7,1,0,1,0,0,209,20.9,0,6,6,6,6.6,16837,15809,1580.9,-63,-1315,0
1850,688,872,1589.5,15895,18881,7.2,5,5,2,229,22.9,0,0,1,0,0,231,23.1,0,3,4,4,7.0,18009,15207,1520.7,-872,-688,0
1851,664,185,1596.0,15960,17046,6.8,6,6,5,180,18.0,1,0,1,0,1,205,20.5,1,1,3,3,6.6,16861,15296,1529.6,-185,-664,0
1852,1754,433,1767.8,17678,18832,7.4,10,10,6,189,18.9,1,1,1,0,0,207,20.7,0,4,7,7,6.8,18399,15924,1592.4,-433,-1754,1
1853,1083,554,1819.3,18193,16895,6.6,12,12,15,182,18.2,0,0,1,0,1,225,22.5,1,8,7,7,6.8,16341,17110,1711.0,-554,-1083,1
1854,-4728,-3668,1464.3,14643,17019,6.8,2,2,1,230,23.0,1,1,0,1,0,236,23.6,0,14,11,11,7.6,20687,19371,1937.1,3668,4728,0
1855,1015,1543,1684.0,16840,18289,7.2,8,8,9,185,18.5,1,1,1,0,0,195,19.5,1,7,5,5,6.6,16746,15825,1582.5,-1543,-1015,1
1856,-410,-194,1470.7,14707,18199,7.0,2,2,2,209,20.9,1,1,0,1,0,201,20.1,0,3,4,4,7.0,18393,15117,1511.7,194,410,1
1857,-1663,-1174,1446.7,14467,16468,6.6,4,4,1,222,22.2,1,1,1,0,0,186,18.6,0,5,7,7,6.8,17642,16130,1613.0,1174,1663,1
1858,3373,2234,1763.3,17633,17885,6.6,7,7,8,226,22.6,0,0,1,0,0,205,20.5,0,2,2,2,6.6,15651,14260,1426.0,-2234,-3373,1
1859,-1044,-2760,1483.7,14837,15974,6.6,3,3,3,200,20.0,0,0,1,0,1,183,18.3,1,7,5,5,7.2,18734,15881,1588.1,2760,1044,0
1860,-2803,-1709,1582.6,15826,17438,6.8,4,4,6,235,23.5,0,0,0,1,1,238,23.8,1,12,11,11,7.0,19147,18629,1862.9,1709,2803,0
1861,3346,3707,1835.7,18357,19718,7.0,8,8,7,269,26.9,2,1,1,0,0,176,17.6,0,4,5,5,6.6,16011,15011,1501.1,-3707,-3346,1
1862,1561,-87,1646.0,16460,18260,7.0,7,7,6,241,24.1,1,0,1,0,1,197,19.7,1,0,4,4,7.2,18347,14899,1489.9,87,-1561,0
1863,-3304,-3201,1605.4,16054,16044,6.4,7,7,6,176,17.6,0,0,1,0,1,170,17.0,1,8,14,14,7.2,19245,19358,1935.8,3201,3304,0
1864,-3238,-2465,1389.9,13899,16444,6.4,3,3,1,202,20.2,0,0,0,1,1,261,26.1,1,7,6,6,7.2,18909,17137,1713.7,2465,3238,0
1865,-357,221,1591.1,15911,18170,7.0,3,3,6,231,23.1,2,1,0,1,0,224,22.4,0,7,5,5,7.0,17949,16268,1626.8,-221,357,1
1866,-714,233,1521.5,15215,18360,6.8,2,2,4,231,23.1,0,0,1,0,1,208,20.8,1,6,4,4,7.0,18127,15929,1592.9,-233,714,1
1867,2806,1391,1803.6,18036,18597,7.0,9,9,11,236,23.6,1,0,1,0,1,232,23.2,1,7,4,4,6.6,17206,15230,1523.0,-1391,-2806,1
1868,205,-1306,1630.4,16304,17328,6.8,6,6,5,212,21.2,0,0,1,0,1,203,20.3,2,5,4,4,7.0,18634,16099,1609.9,1306,-205,0
1869,-392,-995,1526.7,15267,17987,6.8,2,2,4,226,22.6,0,0,0,1,1,254,25.4,1,1,3,3,7.4,18982,15659,1565.9,995,392,0
1870,-1176,-1456,1605.5,16055,17241,6.8,4,4,5,252,25.2,0,0,1,0,1,225,22.5,1,9,8,8,7.0,18697,17231,1723.1,1456,1176,0
1871,-882,-740,1740.4,17404,18717,7.0,8,8,8,204,20.4,0,0,0,1,1,253,25.3,1,9,7,7,7.4,19457,18286,1828.6,740,882,1
1872,-2955,-2776,1374.1,13741,15605,6.4,1,1,1,179,17.9,1,0,0,1,1,220,22.0,1,7,7,7,7.0,18381,16696,1669.6,2776,2955,0
1873,194,-220,1640.2,16402,17710,7.0,5,5,6,223,22.3,0,0,0,1,0,195,19.5,0,8,7,7,7.0,17930,16208,1620.8,220,-194,1
1874,-3251,-3208,1493.3,14933,16470,6.6,2,2,1,225,22.5,0,0,0,1,0,241,24.1,0,7,9,9,7.4,19678,18184,1818.4,3208,3251,0
1875,-1761,-1206,1466.5,14665,17020,6.8,3,3,4,192,19.2,1,0,0,1,1,213,21.3,1,10,7,7,7.0,18226,16426,1642.6,1206,1761,0
1876,1342,13,1937.2,19372,18802,7.0,14,14,15,180,18.0,1,0,1,0,0,229,22.9,0,9,8,8,7.4,18789,18030,1803.0,-13,-1342,1
1877,690,998,1631.0,16310,18578,7.0,6,6,7,235,23.5,0,0,1,0,1,230,23.0,1,5,3,3,6.8,17580,15620,1562.0,-998,-690,0
1878,-4073,-3038,1464.3,14643,17028,6.8,6,6,4,154,15.4,0,0,0,1,1,207,20.7,1,11,14,14,7.4,20066,18716,1871.6,3038,4073,0
1879,2296,2033,1642.6,16426,19543,7.4,3,3,3,251,25.1,1,1,1,0,0,236,23.6,0,2,1,1,6.8,17510,14130,1413.0,-2033,-2296,1
1880,-1081,-953,1633.1,16331,18513,7.0,6,6,3,229,22.9,0,0,0,1,1,235,23.5,1,9,9,9,7.2,19466,17412,1741.2,953,1081,0
1881,-1664,-602,1589.5,15895,16900,6.6,6,6,4,222,22.2,0,0,0,1,1,218,21.8,1,10,10,10,7.0,17502,17559,1755.9,602,1664,1
1882,2287,376,1817.6,18176,18682,7.0,10,10,15,216,21.6,1,1,1,0,0,202,20.2,0,3,6,6,7.2,18306,15889,1588.9,-376,-2287,1
1883,2821,2755,1756.6,17566,19634,7.2,7,7,11,243,24.3,1,1,1,0,0,234,23.4,0,3,1,1,6.8,16879,14745,1474.5,-2755,-2821,1
1884,-6240,-4315,1383.2,13832,16157,6.6,2,2,3,203,20.3,0,0,0,1,1,233,23.3,2,11,11,11,7.6,20472,20072,2007.2,4315,6240,0
1885,1570,643,1775.1,17751,19165,7.2,8,8,7,238,23.8,1,1,1,0,0,226,22.6,0,1,6,6,7.0,18522,16181,1618.1,-643,-1570,1
1886,39,238,1538.2,15382,18298,7.0,3,3,5,239,23.9,1,1,0,1,0,225,22.5,0,7,4,4,7.0,18060,15343,1534.3,-238,-39,0
1887,1132,269,1732.6,17326,19014,7.2,9,9,11,226,22.6,0,0,1,0,1,203,20.3,1,5,4,4,7.2,18745,16194,1619.4,-269,-1132,1
1888,-1429,-1521,1675.6,16756,16405,6.8,8,8,11,192,19.2,0,0,1,0,0,209,20.9,1,11,10,10,6.8,17926,18185,1818.5,1521,1429,0
1889,-1764,-1997,1628.9,16289,17304,6.8,4,4,3,223,22.3,1,1,1,0,0,244,24.4,0,11,9,9,7.2,19301,18053,1805.3,1997,1764,1
1890,-172,-21,1658.1,16581,17538,6.8,7,7,7,197,19.7,0,0,1,0,1,196,19.6,1,9,9,9,7.0,17559,16753,1675.3,21,172,1
1891,201,303,1655.5,16555,18712,7.2,7,7,6,204,20.4,0,0,0,1,1,210,21.0,1,6,5,5,7.2,18409,16354,1635.4,-303,-201,1
1892,-2185,-2444,1570.0,15700,17393,7.0,3,3,4,250,25.0,0,0,1,0,0,216,21.6,0,9,9,9,7.6,19837,17885,1788.5,2444,2185,0
1893,-5020,-4792,1349.4,13494,14660,5.8,2,2,2,213,21.3,0,0,0,1,1,246,24.6,1,9,11,11,7.4,19452,18514,1851.4,4792,5020,0
1894,-5694,-3457,1387.6,13876,15218,6.2,3,3,2,183,18.3,1,0,1,0,0,204,20.4,0,15,9,9,6.8,18675,19570,1957.0,3457,5694,0
1895,-2781,-1104,1666.8,16668,17267,6.8,7,7,6,193,19.3,0,0,1,0,0,205,20.5,1,15,12,12,7.2,18371,19449,1944.9,1104,2781,0
1896,565,2073,1600.9,16009,19116,7.2,5,5,3,206,20.6,1,0,0,1,0,218,21.8,0,4,5,5,6.8,17043,15444,1544.4,-2073,-565,1
1897,508,-183,1632.1,16321,18950,7.0,4,4,7,250,25.0,1,1,0,1,0,225,22.5,0,7,3,3,7.0,19133,15813,1581.3,183,-508,1
1898,2154,2068,1675.5,16755,16362,6.8,9,9,7,179,17.9,0,0,1,0,0,199,19.9,0,3,5,5,5.8,14294,14601,1460.1,-2068,-2154,1
1899,1063,1501,1640.7,16407,18954,7.0,7,7,5,189,18.9,0,0,1,0,0,205,20.5,0,0,5,5,6.8,17453,15344,1534.4,-1501,-1063,1
1900,-1805,-2303,1506.1,15061,16082,6.4,5,5,6,203,20.3,0,0,1,0,1,201,20.1,1,8,9,9,7.0,18385,16866,1686.6,2303,1805,0
1901,-1026,-982,1655.2,16552,17597,7.0,6,6,9,215,21.5,0,0,0,1,1,234,23.4,1,7,9,9,7.0,18579,17578,1757.8,982,1026,0
1902,1664,1691,1653.8,16538,19266,7.4,8,8,5,238,23.8,0,0,0,1,1,190,19.0,1,1,5,5,6.8,17575,14874,1487.4,-1691,-1664,0
1903,-84,-22,1595.8,15958,16741,6.6,5,5,6,233,23.3,0,0,0,1,0,190,19.0,0,9,8,8,6.6,16763,16042,1604.2,22,84,0
1904,936,386,1685.1,16851,18450,7.2,7,7,7,221,22.1,1,0,1,0,1,253,25.3,1,2,5,5,7.0,18064,15915,1591.5,-386,-936,0
1905,2631,2349,1675.3,16753,18695,7.4,6,6,8,201,20.1,1,1,0,1,0,207,20.7,1,1,2,2,6.4,16346,14122,1412.2,-2349,-2631,1
1906,-1183,-2491,1460.7,14607,16424,6.6,2,2,2,222,22.2,1,1,1,0,0,228,22.8,0,1,3,3,7.0,18915,15790,1579.0,2491,1183,0
1907,-312,37,1716.0,17160,19481,7.2,5,5,8,245,24.5,1,1,0,1,0,231,23.1,0,12,8,8,7.2,19444,17472,1747.2,-37,312,0
1908,-833,-773,1636.0,16360,16891,6.6,7,7,4,187,18.7,1,0,0,1,1,197,19.7,1,13,9,9,6.8,17664,17193,1719.3,773,833,0
1909,-1308,-564,1528.8,15288,17567,6.6,5,5,5,192,19.2,1,0,0,1,1,223,22.3,1,6,7,7,7.0,18131,16596,1659.6,564,1308,0
1910,2862,3250,1841.5,18415,20355,7.4,11,11,7,221,22.1,0,0,0,1,0,223,22.3,0,7,5,5,7.0,17105,15553,1555.3,-3250,-2862,1
1911,-1449,313,1519.0,15190,18530,7.0,3,3,3,231,23.1,0,0,0,1,1,264,26.4,2,4,4,4,7.0,18217,16639,1663.9,-313,1449,1
1912,2010,1365,1718.8,17188,19483,7.2,7,7,9,244,24.4,0,0,1,0,0,226,22.6,0,0,3,3,6.8,18118,15178,1517.8,-1365,-2010,1
1913,-52,258,1690.0,16900,18173,6.8,10,10,9,170,17.0,0,0,1,0,1,222,22.2,1,5,7,7,7.0,17915,16952,1695.2,-258,52,1
1914,-315,-1874,1620.8,16208,16287,6.4,8,8,5,190,19.0,0,0,1,0,1,242,24.2,1,5,5,5,7.0,18161,16523,1652.3,1874,315,0
1915,-1579,-655,1547.7,15477,17532,7.0,3,3,3,223,22.3,0,0,0,1,0,192,19.2,1,12,9,9,7.0,18187,17056,1705.6,655,1579,1
1916,-616,-1349,1557.4,15574,17489,7.0,4,4,5,219,21.9,0,0,0,1,1,232,23.2,1,3,5,5,7.2,18838,16190,1619.0,1349,616,0
1917,-1262,614,1537.7,15377,18315,7.2,4,4,3,215,21.5,1,1,0,1,0,225,22.5,0,5,6,6,7.0,17701,16639,1663.9,-614,1262,0
1918,-2564,-2920,1364.9,13649,14620,6.0,1,1,0,189,18.9,0,0,0,1,0,213,21.3,0,6,4,4,6.8,17540,16213,1621.3,2920,2564,0
1919,2587,1759,1923.9,19239,19698,7.6,11,11,11,209,20.9,1,1,1,0,0,195,19.5,0,4,8,8,6.8,17939,16652,1665.2,-1759,-2587,0
1920,5491,5335,2018.6,20186,19725,7.2,15,15,18,216,21.6,1,1,1,0,0,159,15.9,0,2,4,4,6.0,14390,14695,1469.5,-5335,-5491,1
1921,4051,3552,1903.4,19034,19369,7.4,9,9,9,240,24.0,1,1,0,1,0,178,17.8,0,6,7,7,6.6,15817,14983,1498.3,-3552,-4051,1
1922,5712,4581,2018.3,20183,20925,7.6,13,13,13,239,23.9,0,0,1,0,0,208,20.8,0,3,3,3,6.6,16344,14471,1447.1,-4581,-5712,1
1923,-1232,-659,1587.7,15877,17848,6.8,3,3,3,234,23.4,1,1,0,1,0,221,22.1,0,7,9,9,7.0,18507,17109,1710.9,659,1232,0
1924,-1071,-1667,1682.3,16823,17411,6.8,9,9,8,219,21.9,0,0,0,1,1,210,21.0,1,10,8,8,7.2,19078,17894,1789.4,1667,1071,0
1925,1262,413,1652.5,16525,18498,7.0,5,5,4,230,23.0,1,1,0,1,0,212,21.2,0,3,5,5,7.0,18085,15263,1526.3,-413,-1262,1
1926,-1761,-881,1510.3,15103,18559,7.0,2,2,2,246,24.6,1,1,0,1,0,268,26.8,1,6,5,5,7.4,19440,16864,1686.4,881,1761,1
1927,-420,138,1489.9,14899,18183,7.0,1,1,1,228,22.8,0,0,0,1,1,234,23.4,2,1,4,4,6.8,18045,15319,1531.9,-138,420,1
1928,888,1005,1660.2,16602,17918,7.0,7,7,7,211,21.1,0,0,1,0,0,227,22.7,0,4,5,5,7.0,16913,15714,1571.4,-1005,-888,1
1929,-3926,-1387,1450.4,14504,16897,6.8,4,4,3,191,19.1,0,0,0,1,0,211,21.1,0,11,11,11,6.8,18284,18430,1843.0,1387,3926,0
1930,1711,1235,1733.2,17332,18045,7.0,10,10,10,195,19.5,0,0,0,1,0,203,20.3,0,3,6,6,6.6,16810,15621,1562.1,-1235,-1711,1
1931,-2320,-1204,1674.9,16749,17223,6.8,7,7,8,226,22.6,0,0,1,0,1,207,20.7,2,12,11,11,6.8,18427,19069,1906.9,1204,2320,1
1932,-1900,-1052,1642.3,16423,16900,6.8,6,6,5,204,20.4,1,1,0,1,0,215,21.5,1,10,8,8,7.0,17952,18323,1832.3,1052,1900,1
1933,-1634,-1916,1513.5,15135,17280,6.6,4,4,1,240,24.0,0,0,1,0,0,220,22.0,0,7,8,8,7.4,19196,16769,1676.9,1916,1634,0
1934,1002,-743,1670.4,16704,18000,7.0,7,7,5,225,22.5,0,0,1,0,1,212,21.2,2,8,5,5,7.4,18743,15702,1570.2,743,-1002,1
1935,1568,1001,1783.5,17835,18791,7.0,10,10,14,212,21.2,1,1,0,1,0,209,20.9,0,7,6,6,6.8,17790,16267,1626.7,-1001,-1568,1
1936,-1758,-2010,1534.2,15342,15988,6.6,6,6,4,221,22.1,0,0,0,1,1,226,22.6,1,10,8,8,7.0,17998,17100,1710.0,2010,1758,0
1937,-3063,-1676,1602.2,16022,17899,6.8,6,6,5,206,20.6,1,0,0,1,1,240,24.0,1,12,8,8,7.2,19575,19085,1908.5,1676,3063,0
1938,-1859,-1340,1567.8,15678,17592,6.6,6,6,10,181,18.1,1,1,0,1,0,214,21.4,0,6,8,8,7.2,18932,17537,1753.7,1340,1859,0
1939,-1696,-1187,1651.3,16513,17530,7.0,7,7,6,197,19.7,0,0,0,1,1,218,21.8,1,12,11,11,7.2,18717,18209,1820.9,1187,1696,0
1940,-986,-1163,1609.5,16095,17497,6.8,7,7,10,228,22.8,0,0,0,1,0,237,23.7,0,6,7,7,7.2,18660,17081,1708.1,1163,986,0
1941,822,25,1589.2,15892,18043,6.8,5,5,5,216,21.6,0,0,1,0,1,229,22.9,2,3,3,3,7.2,18018,15070,1507.0,-25,-822,0
1942,-369,-1242,1680.6,16806,17623,6.6,7,7,6,218,21.8,0,0,1,0,1,200,20.0,1,6,9,9,7.2,18865,17175,1717.5,1242,369,1
1943,1255,2754,1684.7,16847,18705,7.2,8,8,8,195,19.5,0,0,0,1,0,247,24.7,0,2,3,3,6.4,15951,15592,1559.2,-2754,-1255,1
1944,317,639,1637.3,16373,19296,7.2,5,5,3,247,24.7,0,0,0,1,1,254,25.4,1,1,4,4,7.2,18657,16056,1605.6,-639,-317,1
1945,-7285,-4379,1329.9,13299,15911,6.4,1,1,2,189,18.9,0,0,0,1,1,251,25.1,1,17,9,9,7.6,20290,20584,2058.4,4379,7285,0
1946,1909,-108,1824.9,18249,18327,7.0,9,9,17,222,22.2,1,1,1,0,0,231,23.1,0,10,6,6,7.0,18435,16340,1634.0,108,-1909,1
1947,1446,446,1664.1,16641,18364,7.2,6,6,9,213,21.3,0,0,0,1,1,218,21.8,1,3,4,4,7.0,17918,15195,1519.5,-446,-1446,1
1948,917,-90,1635.9,16359,18199,7.0,5,5,7,210,21.0,1,1,1,0,0,218,21.8,0,4,4,4,7.0,18289,15442,1544.2,90,-917,1
1949,1712,1983,1695.6,16956,19127,7.0,7,7,4,234,23.4,1,1,1,0,0,236,23.6,1,5,3,3,6.8,17144,15244,1524.4,-1983,-1712,1
1950,1582,1344,1699.2,16992,18716,7.0,7,7,9,224,22.4,0,0,1,0,1,209,20.9,1,6,4,4,7.0,17372,15410,1541.0,-1344,-1582,1
1951,-2129,-2255,1615.4,16154,18081,6.8,5,5,4,216,21.6,0,0,0,1,0,206,20.6,0,12,12,12,7.4,20336,18283,1828.3,2255,2129,0
1952,5240,5663,1975.5,19755,20163,7.4,13,13,13,207,20.7,2,1,1,0,0,220,22.0,0,2,4,4,6.0,14500,14515,1451.5,-5663,-5240,1
1953,873,-52,1618.1,16181,18426,7.0,4,4,4,261,26.1,0,0,1,0,1,249,24.9,2,2,2,2,7.2,18478,15308,1530.8,52,-873,1
1954,-2548,-2906,1526.3,15263,16941,6.8,4,4,6,203,20.3,0,0,1,0,1,232,23.2,1,14,8,8,7.2,19847,17811,1781.1,2906,2548,0
1955,3136,2512,1888.9,18889,19825,7.4,10,10,9,257,25.7,1,1,1,0,0,175,17.5,0,6,5,5,6.8,17313,15753,1575.3,-2512,-3136,0
1956,5082,2398,1963.0,19630,20181,7.2,8,8,10,246,24.6,1,1,1,0,0,226,22.6,0,2,2,2,6.8,17783,14548,1454.8,-2398,-5082,1
1957,-1867,555,1617.2,16172,18087,6.8,4,4,1,219,21.9,0,0,0,1,0,202,20.2,0,18,10,10,6.8,17532,18039,1803.9,-555,1867,1
1958,179,953,1734.5,17345,19182,7.0,7,7,6,226,22.6,0,0,1,0,0,252,25.2,0,5,7,7,7.0,18229,17166,1716.6,-953,-179,0
1959,1937,2816,1768.8,17688,19492,7.2,10,10,15,197,19.7,0,0,0,1,0,192,19.2,0,4,5,5,6.8,16676,15751,1575.1,-2816,-1937,1
1960,-520,-1073,1485.9,14859,17412,6.8,1,1,1,225,22.5,0,0,1,0,1,228,22.8,1,3,3,3,7.0,18485,15379,1537.9,1073,520,0
1961,1834,281,1814.4,18144,18210,6.8,9,9,15,224,22.4,1,1,1,0,0,231,23.1,0,4,4,4,7.0,17929,16310,1631.0,-281,-1834,1
1962,492,-1509,1640.0,16400,17409,6.8,5,5,6,222,22.2,0,0,0,1,1,220,22.0,1,6,4,4,7.2,18918,15908,1590.8,1509,-492,0
1963,-1024,-571,1477.9,14779,16944,6.6,2,2,3,214,21.4,0,0,1,0,1,227,22.7,1,5,4,4,7.0,17515,15803,1580.3,571,1024,0
1964,822,363,1612.8,16128,17286,7.0,5,5,5,226,22.6,1,0,1,0,0,229,22.9,0,5,3,3,6.6,16923,15306,1530.6,-363,-822,0
1965,7482,6466,2141.6,21416,21031,7.6,18,18,14,235,23.5,2,1,1,0,0,144,14.4,0,3,4,4,6.0,14565,13934,1393.4,-6466,-7482,1
1966,-2168,-1356,1459.2,14592,17915,7.0,2,2,3,217,21.7,0,0,0,1,1,221,22.1,1,7,4,4,7.2,19271,16760,1676.0,1356,2168,1
1967,1232,-128,1748.3,17483,18392,7.2,8,8,11,215,21.5,0,0,1,0,0,233,23.3,0,7,6,6,7.2,18520,16251,1625.1,128,-1232,1
1968,-3102,-2025,1620.5,16205,17509,6.8,4,4,5,234,23.4,0,0,0,1,1,235,23.5,1,12,10,10,7.4,19534,19307,1930.7,2025,3102,0
1969,321,368,1836.3,18363,18592,7.2,8,8,6,224,22.4,0,0,0,1,0,215,21.5,0,12,9,9,7.0,18224,18042,1804.2,-368,-321,1
1970,506,620,1840.1,18401,18207,7.0,9,9,19,237,23.7,1,1,1,0,0,239,23.9,0,13,8,8,7.0,17587,17895,1789.5,-620,-506,1
1971,709,946,1639.1,16391,17693,6.8,6,6,5,222,22.2,0,0,0,1,0,188,18.8,0,6,5,5,6.8,16747,15682,1568.2,-946,-709,1
1972,1261,2149,1640.9,16409,19634,7.4,7,7,7,215,21.5,1,1,0,1,0,242,24.2,0,4,3,3,7.0,17485,15148,1514.8,-2149,-1261,1
1973,1630,1005,1673.9,16739,19178,7.4,8,8,5,218,21.8,0,0,1,0,0,196,19.6,0,3,3,3,7.0,18173,15109,1510.9,-1005,-1630,1
1974,-46,-1226,1598.6,15986,17620,6.8,4,4,5,212,21.2,0,0,1,0,1,229,22.9,1,4,6,6,7.2,18846,16032,1603.2,1226,46,1
1975,-1190,-762,1426.7,14267,17033,6.6,3,3,4,186,18.6,1,1,0,1,0,206,20.6,0,3,4,4,7.0,17795,15457,1545.7,762,1190,0
1976,-1488,-572,1469.2,14692,16959,6.8,2,2,4,226,22.6,1,1,1,0,0,234,23.4,0,6,5,5,6.8,17531,16180,1618.0,572,1488,0
1977,848,129,1704.5,17045,18787,7.2,6,6,4,245,24.5,0,0,1,0,0,192,19.2,0,8,6,6,7.0,18658,16197,1619.7,-129,-848,0
1978,-5800,-3960,1363.3,13633,16221,6.4,1,1,0,202,20.2,0,0,0,1,1,245,24.5,1,15,7,7,7.6,20181,19433,1943.3,3960,5800,0
1979,981,42,1859.2,18592,17780,6.8,11,11,13,213,21.3,0,0,0,1,1,197,19.7,1,13,11,11,7.0,17738,17611,1761.1,-42,-981,0
1980,-2642,-1908,1515.4,15154,17363,6.6,4,4,5,170,17.0,0,0,0,1,1,258,25.8,1,7,6,6,7.2,19271,17796,1779.6,1908,2642,1
1981,-794,-1320,1604.5,16045,17984,7.0,4,4,6,229,22.9,0,0,1,0,0,228,22.8,0,6,7,7,7.2,19304,16839,1683.9,1320,794,0
1982,-718,-1666,1713.7,17137,17147,6.8,8,8,8,195,19.5,1,1,0,1,0,215,21.5,0,8,8,8,7.0,18813,17855,1785.5,1666,718,1
1983,-1833,-2171,1455.9,14559,16634,6.8,4,4,5,200,20.0,1,1,0,1,0,215,21.5,0,4,7,7,7.4,18805,16392,1639.2,2171,1833,0
1984,-1369,-1808,1475.8,14758,16974,6.8,2,2,2,237,23.7,0,0,0,1,0,242,24.2,1,2,5,5,7.2,18782,16127,1612.7,1808,1369,0
1985,2625,1026,1850.8,18508,19340,7.4,9,9,11,239,23.9,0,0,1,0,0,207,20.7,1,3,6,6,7.0,18314,15883,1588.3,-1026,-2625,0
1986,-2818,-3710,1597.8,15978,15862,6.2,3,3,5,192,19.2,0,0,0,1,1,211,21.1,1,11,12,12,7.2,19572,18796,1879.6,3710,2818,0
1987,2450,216,1775.9,17759,18407,7.2,8,8,9,232,23.2,0,0,1,0,1,174,17.4,1,5,5,5,6.8,18191,15309,1530.9,-216,-2450,1
1988,3618,1086,1859.0,18590,18032,6.6,8,8,10,237,23.7,1,1,1,0,0,238,23.8,0,1,2,2,6.6,16946,14972,1497.2,-1086,-3618,1
1989,-645,-2890,1674.9,16749,16518,6.4,9,9,4,172,17.2,1,0,1,0,1,202,20.2,1,7,9,9,7.0,19408,17394,1739.4,2890,645,0
1990,3307,1705,1731.4,17314,18785,7.2,7,7,8,207,20.7,0,0,1,0,1,195,19.5,2,3,2,2,7.0,17080,14007,1400.7,-1705,-3307,1
1991,2457,255,1898.3,18983,17893,6.8,11,11,12,211,21.1,1,0,0,1,1,175,17.5,1,10,12,12,7.0,17638,16526,1652.6,-255,-2457,1
1992,-852,-2912,1632.5,16325,16171,6.4,6,6,6,199,19.9,0,0,1,0,1,203,20.3,1,4,9,9,7.2,19083,17177,1717.7,2912,852,0
1993,-2153,-2381,1447.8,14478,16879,6.6,3,3,2,205,20.5,0,0,0,1,1,215,21.5,2,8,8,8,7.2,19260,16631,1663.1,2381,2153,0
1994,-3938,-2767,1409.9,14099,16884,6.6,2,2,2,201,20.1,1,1,0,1,0,218,21.8,0,8,11,11,7.2,19651,18037,1803.7,2767,3938,0
1995,-449,-83,1623.4,16234,18544,7.0,4,4,6,218,21.8,2,1,0,1,0,202,20.2,0,5,7,7,7.2,18627,16683,1668.3,83,449,0
1996,273,1428,1789.2,17892,18922,7.2,7,7,5,205,20.5,1,1,0,1,0,191,19.1,0,14,11,11,6.8,17494,17619,1761.9,-1428,-273,0
1997,0,845,1630.4,16304,17968,6.8,7,7,6,230,23.0,1,1,0,1,0,234,23.4,0,8,5,5,6.6,17123,16304,1630.4,-845,0,0
1998,-1198,-768,1668.8,16688,17007,6.8,8,8,10,201,20.1,1,0,0,1,1,209,20.9,1,14,10,10,7.2,17775,17886,1788.6,768,1198,1
1999,3536,1244,1889.4,18894,17315,6.8,11,11,14,201,20.1,2,1,1,0,0,187,18.7,0,5,6,6,6.6,16071,15358,1535.8,-1244,-3536,1
2000,-1632,-1461,1576.1,15761,16587,6.8,5,5,3,200,20.0,0,0,1,0,0,212,21.2,0,7,9,9,7.0,18048,17393,1739.3,1461,1632,0
2001,-3472,-2256,1502.8,15028,17417,6.8,4,4,4,207,20.7,0,0,0,1,1,230,23.0,1,5,10,10,7.4,19673,18500,1850.0,2256,3472,0
2002,3497,3543,1723.9,17239,19459,7.2,9,9,9,232,23.2,1,1,1,0,0,223,22.3,0,2,1,1,6.4,15916,13742,1374.2,-3543,-3497,1
2003,-2489,-1271,1418.1,14181,17487,6.8,1,1,1,234,23.4,0,0,0,1,0,253,25.3,0,7,5,5,7.0,18758,16670,1667.0,1271,2489,0
2004,-4197,-2772,1555.7,15557,16910,6.6,5,5,3,190,19.0,0,0,1,0,1,228,22.8,1,20,13,13,7.2,19682,19754,1975.4,2772,4197,0
2005,841,-1456,1606.7,16067,16652,6.4,6,6,7,218,21.8,1,1,1,0,0,246,24.6,0,1,3,3,7.0,18108,15226,1522.6,1456,-841,0
2006,742,-654,1638.6,16386,17424,6.6,6,6,10,216,21.6,1,1,0,1,0,255,25.5,0,3,4,4,6.8,18078,15644,1564.4,654,-742,0
2007,3087,2543,1799.7,17997,20432,7.6,9,9,8,210,21.0,0,0,1,0,1,225,22.5,1,4,3,3,7.2,17889,14910,1491.0,-2543,-3087,0
2008,-2066,3,1596.1,15961,16916,6.6,5,5,3,199,19.9,0,0,0,1,1,200,20.0,1,14,11,11,6.8,16913,18027,1802.7,-3,2066,0
2009,-3275,-3254,1339.5,13395,16282,6.8,0,0,0,207,20.7,0,0,0,1,0,257,25.7,0,5,6,6,7.2,19536,16670,1667.0,3254,3275,0
2010,1337,885,1704.8,17048,18886,7.2,5,5,3,249,24.9,1,0,0,1,0,199,19.9,0,4,5,5,7.0,18001,15711,1571.1,-885,-1337,0
2011,1258,-124,1692.4,16924,17168,6.6,8,8,14,194,19.4,1,1,1,0,0,220,22.0,0,5,4,4,6.8,17292,15666,1566.6,124,-1258,1
2012,-1186,-892,1490.2,14902,17656,7.0,2,2,1,242,24.2,1,1,1,0,0,215,21.5,0,6,5,5,7.0,18548,16088,1608.8,892,1186,0
2013,-5295,-3863,1434.1,14341,16688,6.6,3,3,4,184,18.4,0,0,0,1,1,260,26.0,1,10,11,11,7.6,20551,19636,1963.6,3863,5295,0
2014,2086,1202,1798.4,17984,18275,7.2,10,10,7,229,22.9,0,0,0,1,0,189,18.9,0,5,7,7,6.8,17073,15898,1589.8,-1202,-2086,0
2015,-3909,-1904,1589.3,15893,17285,6.8,5,5,7,202,20.2,0,0,0,1,0,228,22.8,1,13,12,12,7.2,19189,19802,1980.2,1904,3909,0
2016,-732,-813,1613.8,16138,16397,6.6,5,5,10,208,20.8,1,1,0,1,0,218,21.8,1,4,5,5,6.8,17210,16870,1687.0,813,732,1
2017,1481,528,1626.0,16260,17559,6.8,6,6,9,224,22.4,2,1,0,1,0,195,19.5,0,5,2,2,6.6,17031,14779,1477.9,-528,-1481,0
2018,-1613,-836,1593.1,15931,17903,7.0,6,6,10,202,20.2,2,1,0,1,0,217,21.7,0,10,7,7,7.2,18739,17544,1754.4,836,1613,0
2019,2123,1219,1669.3,16693,16725,6.4,8,8,16,187,18.7,2,1,1,0,0,172,17.2,0,1,5,5,6.2,15506,14570,1457.0,-1219,-2123,1
2020,2756,2028,1820.0,18200,19696,7.2,9,9,6,247,24.7,2,1,1,0,0,208,20.8,0,5,4,4,7.0,17668,15444,1544.4,-2028,-2756,1
2021,-1091,-1990,1577.1,15771,16977,6.8,5,5,6,237,23.7,0,0,0,1,0,226,22.6,0,5,6,6,7.2,18967,16862,1686.2,1990,1091,0
2022,-970,-482,1668.2,16682,17677,6.8,6,6,8,197,19.7,1,1,1,0,0,227,22.7,0,8,7,7,7.0,18159,17652,1765.2,482,970,1
2023,3941,2200,1907.4,19074,17514,6.6,15,15,17,191,19.1,0,0,1,0,0,199,19.9,0,3,5,5,6.6,15314,15133,1513.3,-2200,-3941,1
2024,3754,2642,1905.2,19052,19366,7.2,10,10,14,226,22.6,1,1,1,0,0,215,21.5,0,7,5,5,6.8,16724,15298,1529.8,-2642,-3754,1
2025,-3679,-3273,1522.0,15220,16145,6.4,5,5,7,174,17.4,0,0,0,1,0,266,26.6,0,11,9,9,7.0,19418,18899,1889.9,3273,3679,1
2026,2998,3108,1860.4,18604,20075,7.4,11,11,9,214,21.4,1,1,0,1,0,203,20.3,0,4,5,5,7.0,16967,15606,1560.6,-3108,-2998,1
2027,-735,46,1513.1,15131,17618,6.8,4,4,3,223,22.3,1,1,0,1,0,221,22.1,0,5,5,5,7.0,17572,15866,1586.6,-46,735,1
2028,-6470,-5355,1278.9,12789,15191,6.4,1,1,1,157,15.7,0,0,0,1,1,256,25.6,1,13,11,11,7.4,20546,19259,1925.9,5355,6470,0
2029,319,1558,1758.6,17586,18812,7.2,9,9,10,227,22.7,1,1,0,1,0,232,23.2,0,6,8,8,6.8,17254,17267,1726.7,-1558,-319,0
2030,-1247,-835,1607.2,16072,16342,6.6,8,8,7,214,21.4,0,0,0,1,1,229,22.9,1,12,8,8,6.6,17177,17319,1731.9,835,1247,1
2031,1179,-736,1747.3,17473,18577,7.0,8,8,8,228,22.8,1,0,1,0,0,225,22.5,0,5,5,5,7.4,19313,16294,1629.4,736,-1179,1
2032,-1285,-2097,1569.3,15693,17493,6.8,5,5,4,230,23.0,0,0,1,0,1,236,23.6,2,7,6,6,7.4,19590,16978,1697.8,2097,1285,0
2033,752,1388,1607.9,16079,18772,7.0,4,4,5,221,22.1,0,0,0,1,1,223,22.3,1,5,3,3,6.6,17384,15327,1532.7,-1388,-752,1
2034,2006,2256,1710.9,17109,18272,7.2,8,8,8,247,24.7,0,0,0,1,0,200,20.0,0,7,5,5,6.6,16016,15103,1510.3,-2256,-2006,1
2035,-902,-1082,1589.0,15890,16918,6.6,6,6,9,170,17.0,0,0,1,0,0,227,22.7,0,5,5,5,7.0,18000,16792,1679.2,1082,902,1
2036,1590,971,1741.0,17410,18496,7.2,7,7,11,239,23.9,2,1,1,0,0,216,21.6,0,8,6,6,7.0,17525,15820,1582.0,-971,-1590,1
2037,2599,3321,1749.1,17491,19706,7.2,9,9,8,216,21.6,1,1,0,1,0,189,18.9,0,3,5,5,6.4,16385,14892,1489.2,-3321,-2599,1
2038,4590,3681,1788.7,17887,19263,7.2,8,8,9,221,22.1,1,0,1,0,0,213,21.3,0,1,1,1,6.4,15582,13297,1329.7,-3681,-4590,1
2039,1207,1638,1703.0,17030,19832,7.2,7,7,5,250,25.0,1,1,1,0,0,234,23.4,0,8,4,4,7.0,18194,15823,1582.3,-1638,-1207,0
2040,229,398,1576.2,15762,19056,7.2,4,4,3,240,24.0,1,1,1,0,0,239,23.9,0,4,3,3,7.2,18658,15533,1553.3,-398,-229,0
2041,-1501,-878,1444.4,14444,16768,6.4,3,3,2,231,23.1,1,1,0,1,0,215,21.5,0,4,5,5,7.0,17646,15945,1594.5,878,1501,0
2042,3903,1239,2029.4,20294,17966,7.0,13,13,14,216,21.6,0,0,0,1,0,171,17.1,0,5,7,7,6.8,16727,16391,1639.1,-1239,-3903,1
2043,1709,880,1659.2,16592,19045,7.0,7,7,7,220,22.0,0,0,0,1,1,203,20.3,1,1,3,3,7.2,18165,14883,1488.3,-880,-1709,1
2044,-699,-580,1629.1,16291,17415,6.8,5,5,7,211,21.1,1,1,0,1,0,218,21.8,1,3,5,5,6.8,17995,16990,1699.0,580,699,0
2045,-2862,-3209,1463.9,14639,16690,6.6,2,2,1,222,22.2,0,0,1,0,1,237,23.7,1,12,7,7,7.6,19899,17501,1750.1,3209,2862,0
2046,-1422,345,1644.7,16447,19247,7.4,7,7,5,215,21.5,0,0,0,1,1,244,24.4,1,10,8,8,7.2,18902,17869,1786.9,-345,1422,1
2047,-666,-290,1614.7,16147,17632,6.6,7,7,9,201,20.1,1,1,1,0,0,217,21.7,0,7,6,6,7.2,17922,16813,1681.3,290,666,1
2048,991,1570,1575.1,15751,18853,7.0,3,3,4,252,25.2,0,0,1,0,0,222,22.2,0,2,2,2,6.8,17283,14760,1476.0,-1570,-991,1
2049,-2177,-2726,1474.2,14742,16872,6.8,1,1,1,219,21.9,0,0,1,0,1,197,19.7,2,15,8,8,7.2,19598,16919,1691.9,2726,2177,0
2050,1354,1326,1661.8,16618,17463,6.8,6,6,12,192,19.2,1,1,0,1,0,203,20.3,0,12,6,6,6.6,16137,15264,1526.4,-1326,-1354,1
2051,-1988,-616,1749.2,17492,19413,7.2,9,9,7,189,18.9,0,0,0,1,1,204,20.4,2,17,15,15,7.4,20029,19480,1948.0,616,1988,0
2052,3199,2629,1820.8,18208,19838,7.4,11,11,13,219,21.9,1,1,1,0,0,209,20.9,0,2,3,3,6.8,17209,15009,1500.9,-2629,-3199,1
2053,639,-470,1558.4,15584,17413,6.8,3,3,2,230,23.0,1,1,0,1,0,215,21.5,1,2,3,3,7.0,17883,14945,1494.5,470,-639,1
2054,1509,-543,1709.4,17094,17845,6.8,8,8,11,202,20.2,2,1,1,0,0,220,22.0,0,4,4,4,7.0,18388,15585,1558.5,543,-1509,1
2055,-660,-922,1530.7,15307,15025,6.4,6,6,8,175,17.5,1,1,1,0,0,171,17.1,0,12,7,7,6.4,15947,15967,1596.7,922,660,0
2056,-3063,-2326,1388.0,13880,15178,6.2,1,1,2,191,19.1,0,0,0,1,1,187,18.7,1,9,8,8,6.8,17504,16943,1694.3,2326,3063,0
2057,-1521,-2185,1605.9,16059,18190,7.0,4,4,4,221,22.1,0,0,1,0,1,246,24.6,1,14,8,8,7.4,20375,17580,1758.0,2185,1521,1
2058,-814,1199,1547.1,15471,18538,7.2,2,2,3,228,22.8,1,1,0,1,0,225,22.5,0,10,6,6,6.8,17339,16285,1628.5,-1199,814,0
2059,3024,2225,1919.8,19198,17559,6.6,12,12,17,199,19.9,1,1,0,1,0,176,17.6,0,15,8,8,6.4,15334,16174,1617.4,-2225,-3024,1
2060,-1147,-1294,1657.6,16576,17437,7.0,8,8,7,226,22.6,1,1,1,0,0,210,21.0,0,11,10,10,7.2,18731,17723,1772.3,1294,1147,1
2061,1113,1392,1607.6,16076,18079,7.0,3,3,3,238,23.8,1,0,0,1,1,185,18.5,1,2,3,3,6.6,16687,14963,1496.3,-1392,-1113,1
2062,550,1023,1604.1,16041,18070,6.8,6,6,7,223,22.3,0,0,0,1,1,214,21.4,1,5,4,4,6.6,17047,15491,1549.1,-1023,-550,1
2063,589,675,1571.4,15714,17817,7.0,4,4,8,230,23.0,1,1,0,1,0,199,19.9,1,6,3,3,6.8,17142,15125,1512.5,-675,-589,0
2064,-7480,-4460,1460.8,14608,15029,6.0,4,4,4,188,18.8,1,0,0,1,1,218,21.8,1,15,14,14,7.4,19489,22088,2208.8,4460,7480,0
2065,-685,-1871,1500.1,15001,17799,7.0,3,3,3,218,21.8,0,0,1,0,0,214,21.4,1,2,5,5,7.2,19670,15686,1568.6,1871,685,0
2066,-2251,-2427,1445.9,14459,14990,6.4,5,5,5,182,18.2,0,0,0,1,1,198,19.8,1,10,7,7,6.8,17417,16710,1671.0,2427,2251,0
2067,401,95,1478.3,14783,16564,6.6,3,3,5,205,20.5,1,0,1,0,1,209,20.9,1,4,2,2,6.8,16469,14382,1438.2,-95,-401,0
2068,-834,-1333,1521.1,15211,18224,6.8,3,3,2,234,23.4,0,0,1,0,1,217,21.7,1,2,4,4,7.4,19557,16045,1604.5,1333,834,0
2069,-1535,-2054,1558.9,15589,16619,6.6,6,6,4,181,18.1,0,0,0,1,0,210,21.0,1,10,8,8,7.0,18673,17124,1712.4,2054,1535,0
2070,-2086,-1696,1622.3,16223,17597,6.8,4,4,1,222,22.2,1,1,1,0,0,228,22.8,0,8,9,9,7.0,19293,18309,1830.9,1696,2086,0
2071,-270,-1095,1637.5,16375,18784,7.2,7,7,6,217,21.7,1,1,1,0,0,209,20.9,1,4,7,7,7.4,19879,16645,1664.5,1095,270,1
2072,4069,3954,1819.0,18190,20017,7.6,11,11,18,225,22.5,1,1,1,0,0,224,22.4,0,1,1,1,6.6,16063,14121,1412.1,-3954,-4069,1
2073,2171,1375,1912.0,19120,19644,7.0,8,8,7,248,24.8,1,0,1,0,1,217,21.7,1,7,7,7,7.0,18269,16949,1694.9,-1375,-2171,0
2074,151,878,1653.2,16532,18522,6.8,3,3,2,245,24.5,1,0,0,1,1,215,21.5,1,9,7,7,7.0,17644,16381,1638.1,-878,-151,0
2075,4674,2219,1922.4,19224,20086,7.6,8,8,4,225,22.5,1,0,1,0,1,189,18.9,1,4,3,3,7.0,17867,14550,1455.0,-2219,-4674,0
2076,-961,-1080,1399.3,13993,16977,6.6,1,1,1,213,21.3,0,0,1,0,0,235,23.5,1,2,2,2,7.0,18057,14954,1495.4,1080,961,0
2077,-1089,378,1523.5,15235,17736,6.8,4,4,8,208,20.8,0,0,0,1,1,208,20.8,1,8,6,6,6.6,17358,16324,1632.4,-378,1089,1
2078,1278,816,1783.9,17839,18147,7.0,12,12,12,158,15.8,0,0,0,1,0,200,20.0,0,2,6,6,7.0,17331,16561,1656.1,-816,-1278,1
2079,2545,1922,1693.2,16932,19607,7.4,6,6,8,243,24.3,0,0,0,1,0,240,24.0,0,1,1,1,6.8,17685,14387,1438.7,-1922,-2545,1
2080,-1800,-1035,1599.0,15990,16813,6.4,6,6,7,191,19.1,1,1,0,1,0,217,21.7,0,11,11,11,7.0,17848,17790,1779.0,1035,1800,1
2081,-383,-667,1650.1,16501,15376,6.2,8,8,15,190,19.0,1,1,0,1,0,229,22.9,0,9,6,6,6.6,16043,16884,1688.4,667,383,0
2082,-420,1215,1619.3,16193,19464,7.4,4,4,4,225,22.5,1,1,0,1,0,207,20.7,0,8,8,8,7.2,18249,16613,1661.3,-1215,420,1
2083,-1033,-1797,1469.6,14696,14840,6.2,3,3,3,185,18.5,0,0,0,1,0,217,21.7,0,5,3,3,6.8,16637,15729,1572.9,1797,1033,0
2084,-1860,-1622,1398.0,13980,16415,6.8,2,2,1,221,22.1,1,1,0,1,0,210,21.0,0,7,5,5,7.2,18037,15840,1584.0,1622,1860,0
2085,-1487,-473,1513.2,15132,17330,6.8,4,4,5,197,19.7,0,0,0,1,0,235,23.5,0,4,3,3,7.0,17803,16619,1661.9,473,1487,0
2086,-3214,-2318,1492.7,14927,16626,6.6,5,5,8,194,19.4,1,0,1,0,1,239,23.9,1,11,9,9,7.0,18944,18141,1814.1,2318,3214,0
2087,-14,-776,1739.4,17394,18465,7.0,6,6,10,213,21.3,0,0,0,1,1,215,21.5,2,8,8,8,7.2,19241,17408,1740.8,776,14,0
2088,33,817,1496.1,14961,18313,7.0,3,3,2,230,23.0,0,0,0,1,1,191,19.1,1,3,4,4,7.0,17496,14928,1492.8,-817,-33,0
2089,-1857,-2651,1525.6,15256,16807,6.6,5,5,3,192,19.2,1,1,1,0,0,209,20.9,0,10,8,8,7.4,19458,17113,1711.3,2651,1857,0
2090,-1126,-601,1623.5,16235,18790,7.2,5,5,2,213,21.3,1,0,1,0,1,230,23.0,1,6,9,9,7.2,19391,17361,1736.1,601,1126,0
2091,-4562,-3519,1553.6,15536,15213,6.4,6,6,9,179,17.9,0,0,0,1,1,226,22.6,2,14,11,11,7.2,18732,20098,2009.8,3519,4562,0
2092,11,64,1680.5,16805,18793,7.0,6,6,14,230,23.0,1,1,1,0,0,223,22.3,0,7,6,6,7.2,18729,16794,1679.4,-64,-11,1
2093,-2797,-2649,1568.4,15684,17047,6.6,4,4,5,240,24.0,0,0,1,0,1,220,22.0,1,9,10,10,7.4,19696,18481,1848.1,2649,2797,0
2094,519,-748,1720.7,17207,17379,6.8,10,10,14,179,17.9,0,0,1,0,0,188,18.8,0,5,10,10,7.2,18127,16688,1668.8,748,-519,0
2095,1192,779,1710.6,17106,17729,7.0,8,8,12,206,20.6,0,0,1,0,0,217,21.7,0,9,6,6,6.8,16950,15914,1591.4,-779,-1192,1
2096,3761,2092,1800.2,18002,19467,7.2,5,5,6,254,25.4,1,1,1,0,0,248,24.8,0,1,1,1,6.8,17375,14241,1424.1,-2092,-3761,1
2097,1279,384,1672.5,16725,18674,7.0,5,5,9,228,22.8,0,0,1,0,1,251,25.1,1,1,3,3,7.0,18290,15446,1544.6,-384,-1279,0
2098,-883,-1495,1704.5,17045,17969,7.0,7,7,15,214,21.4,0,0,1,0,0,250,25.0,0,7,7,7,7.2,19464,17928,1792.8,1495,883,0
2099,-4535,-3079,1390.2,13902,16677,6.6,2,2,3,173,17.3,1,1,0,1,0,240,24.0,0,10,12,12,7.2,19756,18437,1843.7,3079,4535,0
2100,7242,4995,2198.6,21986,20283,7.4,13,13,12,263,26.3,1,1,1,0,0,168,16.8,1,5,4,4,6.2,15288,14744,1474.4,-4995,-7242,1
2101,-546,760,1567.3,15673,18504,7.2,3,3,3,234,23.4,0,0,0,1,1,237,23.7,2,3,5,5,6.8,17744,16219,1621.9,-760,546,0
2102,-4917,-4426,1495.8,14958,15925,6.2,4,4,4,192,19.2,0,0,0,1,0,241,24.1,0,9,12,12,7.4,20351,19875,1987.5,4426,4917,0
2103,5041,3633,1840.8,18408,19945,7.4,10,10,8,243,24.3,0,0,1,0,0,202,20.2,0,0,0,0,6.6,16312,13367,1336.7,-3633,-5041,1
2104,2152,2575,1724.7,17247,19189,7.2,7,7,2,249,24.9,1,1,0,1,0,178,17.8,0,7,5,5,6.8,16614,15095,1509.5,-2575,-2152,1
2105,1783,2066,1759.0,17590,18788,7.2,9,9,10,200,20.0,1,1,0,1,0,183,18.3,0,6,6,6,6.8,16722,15807,1580.7,-2066,-1783,1
2106,545,1033,1765.7,17657,19166,7.2,9,9,8,227,22.7,1,0,0,1,1,198,19.8,1,9,8,8,7.0,18133,17112,1711.2,-1033,-545,1
2107,-5521,-3591,1409.4,14094,15768,6.2,2,2,3,197,19.7,0,0,0,1,1,258,25.8,1,14,10,10,7.4,19359,19615,1961.5,3591,5521,0
2108,-1623,-951,1462.9,14629,17474,6.8,3,3,1,184,18.4,0,0,1,0,1,243,24.3,2,7,4,4,7.0,18425,16252,1625.2,951,1623,1
2109,-4684,-3216,1279.1,12791,16317,6.6,1,1,0,173,17.3,0,0,0,1,1,239,23.9,1,3,8,8,7.2,19533,17475,1747.5,3216,4684,0
2110,-29,1014,1687.9,16879,19265,7.4,6,6,7,203,20.3,0,0,1,0,1,249,24.9,2,7,5,5,7.0,18251,16908,1690.8,-1014,29,0
2111,-1313,-1424,1600.5,16005,17737,6.8,5,5,5,218,21.8,0,0,0,1,0,239,23.9,0,8,7,7,7.0,19161,17318,1731.8,1424,1313,1
2112,3210,3591,1887.6,18876,18737,7.0,12,12,10,218,21.8,0,0,1,0,0,184,18.4,0,6,5,5,6.0,15146,15666,1566.6,-3591,-3210,1
2113,5774,2869,2031.9,20319,18956,7.2,14,14,13,216,21.6,0,0,0,1,0,218,21.8,0,1,4,4,6.4,16087,14545,1454.5,-2869,-5774,1
2114,1843,518,1997.5,19975,20209,7.4,12,12,6,213,21.3,2,1,1,0,0,183,18.3,0,9,12,12,7.2,19691,18132,1813.2,-518,-1843,0
2115,-1400,-2239,1376.1,13761,16433,6.6,2,2,4,187,18.7,0,0,0,1,1,247,24.7,1,1,3,3,7.0,18672,15161,1516.1,2239,1400,0
2116,1995,345,1694.0,16940,18209,7.0,7,7,8,238,23.8,1,1,1,0,0,193,19.3,1,4,5,5,7.2,17864,14945,1494.5,-345,-1995,1
2117,-1321,-274,1458.5,14585,16310,6.6,3,3,2,225,22.5,0,0,0,1,1,185,18.5,2,4,8,8,6.8,16584,15906,1590.6,274,1321,0
2118,1904,892,1680.6,16806,17149,6.8,7,7,7,217,21.7,1,0,0,1,0,200,20.0,0,4,4,4,6.4,16257,14902,1490.2,-892,-1904,0
2119,-612,-1300,1537.1,15371,16868,6.8,5,5,5,224,22.4,1,1,1,0,0,194,19.4,0,7,5,5,7.2,18168,15983,1598.3,1300,612,0
2120,1030,705,1808.6,18086,17120,6.8,12,12,8,190,19.0,0,0,1,0,0,174,17.4,0,9,9,9,6.6,16415,17056,1705.6,-705,-1030,1
2121,-5112,-2602,1424.6,14246,16141,6.4,4,4,5,189,18.9,0,0,1,0,1,200,20.0,1,19,12,12,7.0,18743,19358,1935.8,2602,5112,0
2122,-2475,-2226,1522.0,15220,16809,6.4,4,4,4,236,23.6,0,0,1,0,0,247,24.7,0,9,7,7,7.2,19035,17695,1769.5,2226,2475,0
2123,1619,1470,1644.8,16448,19635,7.2,5,5,4,245,24.5,1,1,1,0,0,209,20.9,1,3,3,3,6.8,18165,14829,1482.9,-1470,-1619,1
2124,-538,1677,1694.7,16947,18862,7.0,8,8,6,184,18.4,0,0,0,1,1,198,19.8,2,8,6,6,6.8,17185,17485,1748.5,-1677,538,1
2125,-1558,-1472,1451.6,14516,17487,6.8,2,2,1,229,22.9,1,1,0,1,0,255,25.5,0,3,3,3,7.0,18959,16074,1607.4,1472,1558,1
2126,-2781,-2752,1493.3,14933,16336,6.6,4,4,2,190,19.0,1,0,0,1,1,204,20.4,1,8,6,6,7.2,19088,17714,1771.4,2752,2781,0
2127,1642,878,1779.5,17795,18241,7.0,9,9,6,220,22.0,0,0,1,0,1,216,21.6,1,5,5,5,6.8,17363,16153,1615.3,-878,-1642,1
2128,-80,-155,1613.7,16137,17271,6.6,5,5,7,219,21.9,1,0,1,0,1,205,20.5,1,9,8,8,7.0,17426,16217,1621.7,155,80,1
2129,-1423,-1150,1539.0,15390,17104,6.8,6,6,8,194,19.4,1,1,0,1,0,218,21.8,0,3,7,7,7.2,18254,16813,1681.3,1150,1423,0
2130,-4911,-2529,1399.8,13998,16659,6.4,3,3,3,171,17.1,0,0,0,1,1,236,23.6,1,13,11,11,7.4,19188,18909,1890.9,2529,4911,0
2131,-2787,-1507,1620.3,16203,16391,6.4,6,6,7,203,20.3,1,0,1,0,1,209,20.9,1,23,12,12,7.0,17898,18990,1899.0,1507,2787,0
2132,865,-933,1508.1,15081,17517,6.6,2,2,2,240,24.0,1,1,1,0,0,252,25.2,0,0,0,0,6.8,18450,14216,1421.6,933,-865,1
2133,901,-1138,1616.1,16161,17916,6.8,4,4,5,230,23.0,0,0,1,0,1,246,24.6,1,3,2,2,7.0,19054,15260,1526.0,1138,-901,1
2134,-2078,-188,1566.4,15664,17373,6.8,4,4,5,208,20.8,1,0,0,1,1,214,21.4,1,10,9,9,7.0,17561,17742,1774.2,188,2078,0
2135,-1603,-2388,1689.6,16896,17253,7.0,9,9,9,187,18.7,0,0,0,1,1,250,25.0,1,12,9,9,7.2,19641,18499,1849.9,2388,1603,0
2136,6535,5732,2229.6,22296,21451,7.8,17,17,17,251,25.1,1,1,0,1,0,177,17.7,0,8,6,6,6.4,15719,15761,1576.1,-5732,-6535,1
2137,-2302,-1871,1528.5,15285,15530,6.6,5,5,7,185,18.5,1,0,1,0,1,165,16.5,1,14,11,11,6.8,17401,17587,1758.7,1871,2302,0
2138,-2543,-1202,1458.4,14584,16798,6.8,3,3,4,220,22.0,0,0,0,1,1,258,25.8,1,7,7,7,7.0,18000,17127,1712.7,1202,2543,0
2139,-1711,-1201,1520.6,15206,17404,6.8,3,3,3,205,20.5,0,0,1,0,1,217,21.7,1,11,8,8,7.0,18605,16917,1691.7,1201,1711,0
2140,-3426,-997,1374.5,13745,16710,6.6,1,1,1,198,19.8,0,0,0,1,1,212,21.2,1,9,7,7,7.0,17707,17171,1717.1,997,3426,0
2141,1169,564,1621.0,16210,19051,6.8,4,4,3,261,26.1,0,0,1,0,1,232,23.2,1,1,1,1,7.0,18487,15041,1504.1,-564,-1169,1
2142,1857,1385,1649.8,16498,18910,7.2,6,6,6,233,23.3,1,1,1,0,0,204,20.4,0,4,3,3,7.0,17525,14641,1464.1,-1385,-1857,1
2143,-1829,-1429,1577.8,15778,17304,6.8,5,5,6,235,23.5,0,0,0,1,1,244,24.4,1,3,7,7,6.8,18733,17607,1760.7,1429,1829,1
2144,-3221,-2950,1434.7,14347,15496,6.4,3,3,5,182,18.2,0,0,0,1,1,192,19.2,1,14,9,9,7.2,18446,17568,1756.8,2950,3221,0
2145,-1514,-1142,1666.3,16663,17192,6.8,7,7,4,214,21.4,0,0,1,0,1,217,21.7,1,19,10,10,7.0,18334,18177,1817.7,1142,1514,1
2146,409,2037,1658.0,16580,20102,7.6,4,4,6,236,23.6,0,0,0,1,0,211,21.1,0,6,5,5,7.0,18065,16171,1617.1,-2037,-409,0
2147,2083,1282,1603.6,16036,17948,6.8,6,6,7,200,20.0,1,1,1,0,0,221,22.1,0,2,1,1,6.8,16666,13953,1395.3,-1282,-2083,1
2148,-3826,-2595,1329.8,13298,16659,6.6,2,2,4,192,19.2,0,0,0,1,1,250,25.0,1,5,4,4,7.2,19254,17124,1712.4,2595,3826,0
2149,1788,1922,1695.9,16959,19195,7.2,9,9,8,199,19.9,0,0,1,0,0,187,18.7,0,2,5,5,6.6,17273,15171,1517.1,-1922,-1788,1
2150,3036,1949,1817.3,18173,18943,7.0,11,11,12,218,21.8,0,0,0,1,0,203,20.3,0,4,4,4,6.8,16994,15137,1513.7,-1949,-3036,1
2151,-221,1274,1612.2,16122,19143,7.2,5,5,5,236,23.6,2,1,0,1,0,225,22.5,0,7,5,5,7.0,17869,16343,1634.3,-1274,221,1
2152,380,-239,1658.2,16582,18262,6.8,5,5,5,216,21.6,1,0,1,0,1,246,24.6,1,6,4,4,6.8,18501,16202,1620.2,239,-380,1
2153,-4864,-2252,1512.6,15126,16897,6.8,5,5,3,206,20.6,0,0,0,1,0,217,21.7,0,11,13,13,7.4,19149,19990,1999.0,2252,4864,0
2154,2405,3251,1766.6,17666,19949,7.4,11,11,9,218,21.8,1,0,0,1,1,204,20.4,1,4,4,4,6.6,16698,15261,1526.1,-3251,-2405,1
2155,-1260,-2264,1617.2,16172,15969,6.4,6,6,7,191,19.1,0,0,1,0,1,207,20.7,1,12,10,10,6.8,18233,17432,1743.2,2264,1260,1
2156,-2569,-2934,1560.9,15609,16832,6.8,7,7,3,182,18.2,0,0,1,0,0,212,21.2,0,9,9,9,7.6,19766,18178,1817.8,2934,2569,1
2157,-503,-896,1589.7,15897,17465,7.2,5,5,8,216,21.6,1,1,1,0,0,225,22.5,0,7,7,7,7.0,18361,16400,1640.0,896,503,0
2158,5189,2522,1881.0,18810,19127,7.0,8,8,12,261,26.1,0,0,1,0,1,194,19.4,1,1,1,1,6.6,16605,13621,1362.1,-2522,-5189,1
2159,-183,-779,1575.9,15759,17815,7.0,3,3,2,245,24.5,1,0,0,1,1,230,23.0,1,3,4,4,7.4,18594,15942,1594.2,779,183,0
2160,-43,-152,1541.1,15411,17827,7.0,5,5,6,215,21.5,0,0,1,0,0,224,22.4,0,3,4,4,7.0,17979,15454,1545.4,152,43,1
2161,-2720,-2680,1652.6,16526,18130,7.0,8,8,10,174,17.4,1,1,1,0,0,239,23.9,0,7,10,10,7.6,20810,19246,1924.6,2680,2720,1
2162,2359,1828,1778.1,17781,19581,7.2,11,11,8,225,22.5,1,0,1,0,0,215,21.5,0,3,4,4,6.8,17753,15422,1542.2,-1828,-2359,0
2163,4887,2100,2002.8,20028,18736,7.0,13,13,17,213,21.3,1,1,1,0,0,207,20.7,0,2,4,4,6.6,16636,15141,1514.1,-2100,-4887,1
2164,4073,1397,1872.5,18725,19463,7.2,10,10,7,248,24.8,1,1,1,0,0,225,22.5,0,1,2,2,6.8,18066,14652,1465.2,-1397,-4073,1
2165,-1519,-1284,1536.5,15365,18102,6.8,3,3,6,216,21.6,0,0,0,1,0,245,24.5,0,5,5,5,7.4,19386,16884,1688.4,1284,1519,0
2166,-4245,-3455,1572.7,15727,17147,6.8,5,5,4,198,19.8,0,0,0,1,0,227,22.7,0,20,15,15,7.4,20602,19972,1997.2,3455,4245,0
2167,-376,-71,1554.1,15541,18700,7.0,3,3,3,236,23.6,0,0,1,0,1,226,22.6,1,5,6,6,7.0,18771,15917,1591.7,71,376,0
2168,-4625,-1753,1418.3,14183,17123,7.0,2,2,1,221,22.1,0,0,0,1,1,248,24.8,1,12,8,8,7.0,18876,18808,1880.8,1753,4625,0
2169,1247,2354,1713.5,17135,19855,7.6,8,8,7,216,21.6,1,1,1,0,0,196,19.6,0,9,6,6,6.8,17501,15888,1588.8,-2354,-1247,1
2170,2712,1161,1663.7,16637,18095,7.0,5,5,4,250,25.0,0,0,1,0,1,215,21.5,1,0,0,0,7.0,16934,13925,1392.5,-1161,-2712,1
2171,-1972,-1064,1553.6,15536,16788,6.6,4,4,6,234,23.4,1,0,0,1,1,223,22.3,1,14,7,7,7.0,17852,17508,1750.8,1064,1972,1
2172,-4136,-3444,1575.5,15755,16436,6.4,5,5,7,203,20.3,0,0,0,1,1,222,22.2,1,12,14,14,7.4,19880,19891,1989.1,3444,4136,0
2173,187,1356,1579.5,15795,18512,7.2,5,5,2,201,20.1,1,0,0,1,0,204,20.4,0,3,5,5,7.0,17156,15608,1560.8,-1356,-187,0
2174,-3089,-1857,1359.0,13590,15723,6.6,2,2,2,170,17.0,1,1,0,1,0,215,21.5,0,6,6,6,6.8,17580,16679,1667.9,1857,3089,0
2175,266,-282,1626.0,16260,18128,6.8,4,4,6,225,22.5,1,0,1,0,1,224,22.4,1,10,5,5,7.2,18410,15994,1599.4,282,-266,0
2176,-947,-2043,1585.9,15859,16551,6.8,6,6,13,209,20.9,0,0,1,0,0,218,21.8,0,6,5,5,6.8,18594,16806,1680.6,2043,947,0
2177,4177,2615,1813.7,18137,18617,7.0,11,11,12,207,20.7,1,0,1,0,0,205,20.5,0,0,1,1,6.4,16002,13960,1396.0,-2615,-4177,1
2178,2470,1058,1745.1,17451,17118,6.8,8,8,14,210,21.0,1,1,1,0,0,219,21.9,0,3,4,4,6.6,16060,14981,1498.1,-1058,-2470,1
2179,812,237,1567.9,15679,16202,6.6,5,5,5,224,22.4,0,0,1,0,0,220,22.0,0,7,4,4,6.4,15965,14867,1486.7,-237,-812,1
2180,2010,2112,1850.2,18502,19709,7.2,9,9,8,212,21.2,1,0,0,1,1,194,19.4,1,11,7,7,6.6,17597,16492,1649.2,-2112,-2010,0
2181,938,2052,1512.0,15120,16751,6.8,4,4,5,218,21.8,1,1,0,1,0,178,17.8,0,3,3,3,5.8,14699,14182,1418.2,-2052,-938,1
2182,-1337,-1246,1553.9,15539,16163,6.4,5,5,4,163,16.3,1,0,0,1,0,190,19.0,0,9,9,9,7.0,17409,16876,1687.6,1246,1337,0
2183,-2967,-3336,1387.9,13879,16319,6.6,3,3,2,148,14.8,1,1,0,1,0,223,22.3,0,2,6,6,7.2,19655,16846,1684.6,3336,2967,0
2184,-1567,-232,1564.0,15640,17472,7.0,6,6,4,195,19.5,0,0,0,1,1,216,21.6,1,13,9,9,7.0,17704,17207,1720.7,232,1567,0
2185,3660,577,1873.8,18738,18081,7.0,9,9,9,246,24.6,0,0,1,0,1,196,19.6,1,5,4,4,6.8,17504,15078,1507.8,-577,-3660,1
2186,3602,274,1850.9,18509,18932,7.0,8,8,13,270,27.0,0,0,1,0,1,217,21.7,1,3,3,3,7.0,18658,14907,1490.7,-274,-3602,0
2187,329,601,1544.1,15441,18222,7.0,3,3,5,226,22.6,0,0,1,0,1,203,20.3,2,3,5,5,6.8,17621,15112,1511.2,-601,-329,1
2188,231,-446,1588.7,15887,16554,6.8,5,5,6,201,20.1,0,0,1,0,0,210,21.0,0,4,4,4,6.4,17000,15656,1565.6,446,-231,1
2189,2156,2101,1624.2,16242,17867,7.0,7,7,5,218,21.8,1,0,1,0,0,212,21.2,0,3,2,2,6.4,15766,14086,1408.6,-2101,-2156,1
2190,1378,-144,1571.4,15714,17384,7.0,4,4,5,210,21.0,1,0,1,0,1,259,25.9,1,0,0,0,6.8,17528,14336,1433.6,144,-1378,0
2191,-523,-224,1508.7,15087,17316,7.0,3,3,1,250,25.0,0,0,0,1,0,203,20.3,0,7,4,4,6.8,17540,15610,1561.0,224,523,0
2192,-72,-118,1668.0,16680,17712,6.8,7,7,4,196,19.6,1,0,0,1,0,223,22.3,0,5,6,6,7.0,17830,16752,1675.2,118,72,0
2193,-887,-501,1763.9,17639,16561,6.6,8,8,8,194,19.4,0,0,0,1,1,198,19.8,1,20,13,13,6.8,17062,18526,1852.6,501,887,1
2194,796,290,1800.0,18000,18178,7.0,9,9,16,204,20.4,0,0,1,0,0,187,18.7,0,17,7,7,6.8,17888,17204,1720.4,-290,-796,1
2195,-3241,-2297,1344.3,13443,15718,6.4,2,2,3,192,19.2,0,0,0,1,1,217,21.7,2,3,7,7,6.8,18015,16684,1668.4,2297,3241,0
2196,833,-523,1812.1,18121,19091,7.4,10,10,18,230,23.0,0,0,1,0,1,217,21.7,2,7,8,8,7.2,19614,17288,1728.8,523,-833,0
2197,-2462,-558,1476.5,14765,16630,6.4,3,3,2,200,20.0,1,1,1,0,0,205,20.5,0,15,9,9,6.8,17188,17227,1722.7,558,2462,1
2198,-2112,-582,1747.4,17474,18038,7.2,8,8,7,226,22.6,2,1,0,1,0,223,22.3,0,14,12,12,7.2,18620,19586,1958.6,582,2112,1
2199,4634,2354,2017.6,20176,18972,7.0,12,12,18,218,21.8,2,1,1,0,0,217,21.7,0,3,5,5,6.6,16618,15542,1554.2,-2354,-4634,1
2200,4279,3408,1957.4,19574,20323,7.6,9,9,6,237,23.7,0,0,1,0,0,234,23.4,0,6,3,3,6.8,16915,15295,1529.5,-3408,-4279,1
2201,-635,-2299,1586.6,15866,16957,6.6,5,5,4,222,22.2,0,0,1,0,1,215,21.5,1,5,7,7,7.2,19256,16501,1650.1,2299,635,0
2202,4185,3858,1931.3,19313,21625,7.8,12,12,8,237,23.7,0,0,1,0,0,182,18.2,0,2,5,5,7.2,17767,15128,1512.8,-3858,-4185,1
2203,-1770,-1069,1512.5,15125,17716,6.8,2,2,1,241,24.1,0,0,0,1,0,250,25.0,0,5,5,5,7.0,18785,16895,1689.5,1069,1770,0
2204,-750,-906,1648.5,16485,18589,7.2,6,6,4,220,22.0,0,0,1,0,1,242,24.2,1,6,6,6,7.4,19495,17235,1723.5,906,750,0
2205,-931,1384,1481.5,14815,18080,7.0,2,2,1,233,23.3,1,0,0,1,0,209,20.9,0,4,5,5,6.6,16696,15746,1574.6,-1384,931,0
2206,-676,359,1517.6,15176,17215,6.6,4,4,4,227,22.7,0,0,0,1,1,225,22.5,2,6,5,5,6.8,16856,15852,1585.2,-359,676,1
2207,-5793,-4650,1358.9,13589,16161,6.6,1,1,0,207,20.7,1,0,0,1,1,250,25.0,1,12,10,10,7.8,20811,19382,1938.2,4650,5793,0
2208,1595,-63,1701.2,17012,17924,7.0,7,7,11,226,22.6,0,0,0,1,1,230,23.0,1,3,4,4,6.8,17987,15417,1541.7,63,-1595,1
2209,1936,448,1712.6,17126,17880,6.8,5,5,7,248,24.8,1,1,0,1,0,230,23.0,0,2,2,2,6.8,17432,15190,1519.0,-448,-1936,1
2210,-2173,-2274,1510.2,15102,17421,6.8,4,4,4,214,21.4,0,0,0,1,1,212,21.2,1,9,9,9,7.4,19695,17275,1727.5,2274,2173,0
2211,1554,727,1733.8,17338,18403,7.0,8,8,16,214,21.4,1,1,1,0,0,239,23.9,0,6,5,5,6.6,17676,15784,1578.4,-727,-1554,1
2212,2067,2098,1740.2,17402,19335,7.4,5,5,6,246,24.6,1,0,1,0,1,230,23.0,1,4,4,4,7.0,17237,15335,1533.5,-2098,-2067,1
2213,-1386,-450,1451.4,14514,17851,7.0,2,2,2,211,21.1,1,1,1,0,0,242,24.2,0,1,5,5,6.8,18301,15900,1590.0,450,1386,0
2214,4401,2408,1844.2,18442,18882,7.0,9,9,13,256,25.6,1,1,0,1,0,193,19.3,0,5,2,2,6.6,16474,14041,1404.1,-2408,-4401,1
2215,-13,-378,1523.1,15231,18127,7.0,1,1,2,262,26.2,0,0,0,1,1,232,23.2,1,3,2,2,7.0,18505,15244,1524.4,378,13,0
2216,1336,1171,1732.8,17328,20229,7.2,6,6,4,245,24.5,0,0,0,1,1,224,22.4,2,5,6,6,7.2,19058,15992,1599.2,-1171,-1336,0
2217,163,-368,1776.7,17767,18168,7.4,10,10,12,194,19.4,0,0,1,0,0,211,21.1,0,13,8,8,7.0,18536,17604,1760.4,368,-163,0
2218,-1930,-1452,1538.9,15389,17782,6.8,3,3,5,231,23.1,0,0,1,0,1,276,27.6,2,4,3,3,7.2,19234,17319,1731.9,1452,1930,0
2219,-960,-1574,1529.8,15298,17815,6.8,3,3,4,223,22.3,0,0,0,1,1,240,24.0,1,4,7,7,7.2,19389,16258,1625.8,1574,960,0
2220,2021,-274,1765.9,17659,18422,7.0,5,5,5,225,22.5,0,0,1,0,1,196,19.6,1,7,6,6,7.0,18696,15638,1563.8,274,-2021,0
2221,1820,1893,1720.1,17201,19652,7.2,6,6,8,239,23.9,0,0,0,1,1,219,21.9,1,5,4,4,7.0,17759,15381,1538.1,-1893,-1820,1
2222,265,682,1565.6,15656,17712,6.8,2,2,2,240,24.0,0,0,0,1,1,201,20.1,2,6,3,3,6.6,17030,15391,1539.1,-682,-265,0
2223,505,-255,1688.9,16889,17536,6.8,6,6,10,240,24.0,0,0,1,0,1,230,23.0,1,6,6,6,7.0,17791,16384,1638.4,255,-505,0
2224,2413,2181,1852.0,18520,18859,7.2,11,11,13,204,20.4,1,1,1,0,0,206,20.6,0,8,6,6,6.6,16678,16107,1610.7,-2181,-2413,1
2225,-1966,-1998,1456.4,14564,16320,6.6,3,3,4,209,20.9,0,0,1,0,1,220,22.0,1,8,6,6,7.0,18318,16530,1653.0,1998,1966,0
2226,799,239,1663.5,16635,18522,7.0,5,5,6,217,21.7,2,1,1,0,0,240,24.0,0,9,4,4,6.8,18283,15836,1583.6,-239,-799,0
2227,-2169,-1630,1523.0,15230,17421,6.6,4,4,2,192,19.2,1,1,0,1,0,218,21.8,0,7,9,9,7.2,19051,17399,1739.9,1630,2169,0
2228,-2361,-1663,1490.6,14906,17928,6.8,2,2,1,229,22.9,1,1,0,1,0,230,23.0,1,10,8,8,7.0,19591,17267,1726.7,1663,2361,1
2229,3588,1289,1770.6,17706,17285,6.8,8,8,9,221,22.1,2,1,1,0,0,190,19.0,0,4,3,3,6.6,15996,14118,1411.8,-1289,-3588,1
2230,-348,-11,1623.8,16238,18332,7.0,4,4,4,234,23.4,1,1,1,0,0,236,23.6,1,3,4,4,7.0,18343,16586,1658.6,11,348,1
2231,1457,1939,1622.1,16221,18135,7.0,5,5,5,241,24.1,1,1,0,1,0,205,20.5,0,9,4,4,6.6,16196,14764,1476.4,-1939,-1457,0
2232,-850,-256,1656.4,16564,17725,7.0,6,6,7,222,22.2,1,1,0,1,0,201,20.1,1,7,7,7,7.0,17981,17414,1741.4,256,850,1
2233,-4016,-3206,1471.2,14712,15826,6.2,2,2,2,202,20.2,0,0,1,0,1,253,25.3,1,17,13,13,7.0,19032,18728,1872.8,3206,4016,0
2234,1264,2805,1704.2,17042,20182,7.6,7,7,5,189,18.9,0,0,0,1,1,225,22.5,2,4,6,6,6.8,17377,15778,1577.8,-2805,-1264,1
2235,4142,2934,1810.4,18104,19373,7.4,10,10,11,201,20.1,0,0,1,0,0,176,17.6,0,1,2,2,6.6,16439,13962,1396.2,-2934,-4142,1
2236,-279,577,1512.8,15128,18400,6.8,3,3,3,215,21.5,0,0,0,1,1,244,24.4,1,5,4,4,7.0,17823,15407,1540.7,-577,279,0
2237,2521,2240,1777.3,17773,18860,7.0,7,7,5,262,26.2,1,1,1,0,0,197,19.7,0,4,4,4,6.6,16620,15252,1525.2,-2240,-2521,1
2238,715,-69,1726.3,17263,19542,7.4,7,7,5,237,23.7,1,1,1,0,0,231,23.1,0,5,5,5,7.6,19611,16548,1654.8,69,-715,1
2239,744,1657,1732.5,17325,19648,7.0,8,8,5,246,24.6,1,1,1,0,0,216,21.6,1,6,7,7,6.8,17991,16581,1658.1,-1657,-744,1
2240,2818,1675,1919.5,19195,19569,7.2,13,13,9,205,20.5,0,0,1,0,0,200,20.0,0,4,5,5,7.0,17894,16377,1637.7,-1675,-2818,1
2241,2679,3685,1624.6,16246,19387,7.2,3,3,1,253,25.3,1,0,0,1,1,169,16.9,1,2,2,2,6.6,15702,13567,1356.7,-3685,-2679,1
2242,-1262,-769,1657.0,16570,18238,7.0,7,7,10,206,20.6,1,1,0,1,0,231,23.1,0,14,9,9,7.0,19007,17832,1783.2,769,1262,1
2243,1074,1004,1579.0,15790,18873,7.2,5,5,5,216,21.6,1,1,1,0,0,211,21.1,0,1,2,2,7.0,17869,14716,1471.6,-1004,-1074,1
2244,-1814,-946,1659.8,16598,17279,6.8,6,6,6,196,19.6,0,0,0,1,1,231,23.1,1,13,9,9,6.8,18225,18412,1841.2,946,1814,0
2245,6489,4212,2001.8,20018,20654,7.6,12,12,5,226,22.6,1,0,1,0,1,172,17.2,1,0,4,4,6.6,16442,13529,1352.9,-4212,-6489,1
2246,2094,2788,1779.7,17797,19126,7.2,9,9,8,220,22.0,1,1,1,0,0,203,20.3,0,8,6,6,6.8,16338,15703,1570.3,-2788,-2094,1
2247,-106,-62,1616.0,16160,17319,6.8,7,7,7,206,20.6,0,0,1,0,0,229,22.9,0,5,6,6,6.8,17381,16266,1626.6,62,106,1
2248,-7952,-5684,1292.6,12926,14637,6.2,1,1,1,164,16.4,0,0,0,1,1,254,25.4,2,12,11,11,7.4,20321,20878,2087.8,5684,7952,0
2249,-1316,-1111,1492.2,14922,18119,7.2,2,2,2,227,22.7,1,1,1,0,0,247,24.7,0,1,4,4,6.8,19230,16238,1623.8,1111,1316,1
2250,1713,1791,1870.2,18702,18736,7.4,11,11,5,234,23.4,0,0,1,0,0,179,17.9,0,6,9,9,6.6,16945,16989,1698.9,-1791,-1713,1
2251,1318,764,1711.1,17111,17761,7.0,7,7,5,231,23.1,2,1,1,0,0,226,22.6,0,4,4,4,6.8,16997,15793,1579.3,-764,-1318,0
2252,1378,1187,1876.2,18762,18724,7.0,11,11,8,202,20.2,1,0,1,0,0,212,21.2,0,6,10,10,7.0,17537,17384,1738.4,-1187,-1378,1
2253,-610,514,1638.6,16386,18401,7.0,6,6,3,207,20.7,0,0,1,0,1,211,21.1,1,11,8,8,7.0,17887,16996,1699.6,-514,610,0
2254,-560,-1443,1588.7,15887,17319,6.8,7,7,8,171,17.1,0,0,1,0,0,209,20.9,0,3,7,7,7.0,18762,16447,1644.7,1443,560,1
2255,244,-408,1636.3,16363,18270,7.0,5,5,2,225,22.5,0,0,1,0,1,197,19.7,2,7,7,7,7.0,18678,16119,1611.9,408,-244,0
2256,2028,1844,1735.6,17356,18583,7.0,8,8,11,206,20.6,0,0,1,0,1,227,22.7,1,2,4,4,6.8,16739,15328,1532.8,-1844,-2028,1
2257,-44,-2245,1767.7,17677,17477,7.0,10,10,7,184,18.4,0,0,1,0,0,224,22.4,0,9,8,8,7.4,19722,17721,1772.1,2245,44,1
2258,-2069,-242,1610.1,16101,18784,7.2,5,5,2,230,23.0,2,1,0,1,0,239,23.9,0,6,8,8,7.0,19026,18170,1817.0,242,2069,1
2259,4340,1841,1825.7,18257,18323,7.0,8,8,15,209,20.9,0,0,1,0,0,194,19.4,0,2,2,2,6.6,16482,13917,1391.7,-1841,-4340,1
2260,-209,417,1680.1,16801,19121,7.2,8,8,8,198,19.8,1,1,1,0,0,229,22.9,0,6,5,5,7.0,18704,17010,1701.0,-417,209,0
2261,612,678,1735.2,17352,17764,6.6,9,9,10,220,22.0,0,0,0,1,1,223,22.3,1,3,7,7,6.8,17086,16740,1674.0,-678,-612,0
2262,-712,-537,1659.4,16594,16531,6.6,7,7,12,210,21.0,0,0,1,0,1,170,17.0,1,16,9,9,6.8,17068,17306,1730.6,537,712,0
2263,-2815,-2607,1579.6,15796,17324,6.6,6,6,5,195,19.5,0,0,0,1,1,243,24.3,1,11,10,10,7.6,19931,18611,1861.1,2607,2815,0
2264,611,817,1637.2,16372,18609,7.0,5,5,6,234,23.4,0,0,0,1,1,222,22.2,1,5,5,5,6.8,17792,15761,1576.1,-817,-611,0
2265,1358,641,1708.8,17088,19719,7.2,7,7,6,220,22.0,2,1,1,0,0,211,21.1,0,4,6,6,7.2,19078,15730,1573.0,-641,-1358,1
2266,-756,-831,1608.6,16086,17888,7.0,6,6,8,199,19.9,0,0,1,0,1,235,23.5,1,8,7,7,7.2,18719,16842,1684.2,831,756,0
2267,1248,-243,1732.3,17323,18801,7.2,7,7,6,240,24.0,1,0,0,1,1,222,22.2,1,4,5,5,7.2,19044,16075,1607.5,243,-1248,1
2268,457,690,1520.5,15205,17501,6.8,4,4,4,234,23.4,0,0,0,1,1,250,25.0,1,2,2,2,6.6,16811,14748,1474.8,-690,-457,1
2269,-1917,823,1600.9,16009,17560,7.0,4,4,4,214,21.4,0,0,0,1,1,198,19.8,1,11,8,8,6.8,16737,17926,1792.6,-823,1917,1
2270,2351,1317,1753.1,17531,19484,7.4,5,5,5,241,24.1,1,0,0,1,1,223,22.3,1,3,3,3,7.0,18167,15180,1518.0,-1317,-2351,1
2271,-354,-8,1531.0,15310,18085,7.2,3,3,5,228,22.8,1,1,0,1,0,239,23.9,0,2,5,5,7.0,18093,15664,1566.4,8,354,1
2272,-5337,-2474,1488.2,14882,17103,6.6,4,4,2,192,19.2,0,0,0,1,1,249,24.9,2,12,9,9,7.2,19577,20219,2021.9,2474,5337,0
2273,-2316,-2043,1562.8,15628,16659,6.8,4,4,4,233,23.3,1,0,1,0,0,243,24.3,0,10,9,9,7.0,18702,17944,1794.4,2043,2316,0
2274,-4960,-3887,1420.8,14208,14744,6.4,3,3,6,212,21.2,0,0,0,1,1,235,23.5,2,17,10,10,7.2,18631,19168,1916.8,3887,4960,0
2275,3865,4032,1962.9,19629,21016,7.6,9,9,12,232,23.2,2,1,1,0,0,225,22.5,0,7,3,3,6.8,16984,15764,1576.4,-4032,-3865,1
2276,2506,1793,1778.2,17782,19382,7.2,7,7,13,225,22.5,1,1,1,0,0,220,22.0,0,3,3,3,6.8,17589,15276,1527.6,-1793,-2506,1
2277,-1156,466,1479.0,14790,18109,7.2,2,2,1,240,24.0,0,0,0,1,1,240,24.0,1,5,4,4,6.8,17643,15946,1594.6,-466,1156,0
2278,-119,-766,1738.1,17381,18978,7.0,8,8,8,218,21.8,1,0,1,0,1,235,23.5,1,6,6,6,7.2,19744,17500,1750.0,766,119,0
2279,-577,-1953,1645.0,16450,17518,7.0,6,6,9,212,21.2,0,0,1,0,1,239,23.9,2,5,6,6,7.2,19471,17027,1702.7,1953,577,0
2280,355,-798,1645.6,16456,17035,6.6,5,5,6,213,21.3,0,0,0,1,1,223,22.3,2,5,7,7,6.8,17833,16101,1610.1,798,-355,0
2281,-2381,-461,1520.1,15201,16780,7.0,4,4,2,174,17.4,0,0,0,1,1,208,20.8,1,13,9,9,6.6,17241,17582,1758.2,461,2381,0
2282,1928,1805,1752.3,17523,18222,7.0,8,8,8,240,24.0,2,1,1,0,0,209,20.9,0,7,5,5,6.8,16417,15595,1559.5,-1805,-1928,1
2283,166,-650,1707.2,17072,17587,7.0,7,7,8,228,22.8,0,0,1,0,1,223,22.3,2,8,7,7,7.0,18237,16906,1690.6,650,-166,0
2284,1212,-257,1887.8,18878,18276,6.8,11,11,13,222,22.2,0,0,1,0,0,212,21.2,0,8,11,11,7.0,18533,17666,1766.6,257,-1212,0
2285,-1430,-2438,1478.2,14782,16617,6.8,4,4,5,211,21.1,0,0,0,1,1,236,23.6,2,3,4,4,7.2,19055,16212,1621.2,2438,1430,0
2286,-4941,-2777,1401.7,14017,16410,6.6,3,3,4,182,18.2,1,1,0,1,0,227,22.7,0,8,11,11,7.4,19187,18958,1895.8,2777,4941,0
2287,-508,-1385,1667.0,16670,17287,7.0,7,7,8,220,22.0,0,0,0,1,0,217,21.7,0,6,8,8,7.0,18672,17178,1717.8,1385,508,0
2288,-2985,-3019,1468.1,14681,17137,6.8,5,5,2,174,17.4,0,0,1,0,1,213,21.3,1,8,9,9,7.6,20156,17666,1766.6,3019,2985,0
2289,460,-952,1526.8,15268,15740,6.2,3,3,3,202,20.2,0,0,1,0,1,209,20.9,1,9,4,4,6.6,16692,14808,1480.8,952,-460,1
2290,-326,833,1574.8,15748,17980,7.0,5,5,10,203,20.3,0,0,0,1,1,204,20.4,2,5,5,5,6.6,17147,16074,1607.4,-833,326,0
2291,2670,1589,1728.4,17284,18315,7.0,9,9,9,238,23.8,1,1,1,0,0,208,20.8,0,3,4,4,6.6,16726,14614,1461.4,-1589,-2670,1
2292,-210,-130,1680.6,16806,17635,6.8,6,6,5,205,20.5,0,0,1,0,0,230,23.0,1,7,7,7,6.6,17765,17016,1701.6,130,210,0
2293,-2412,-2055,1533.4,15334,17065,6.8,5,5,7,193,19.3,0,0,0,1,0,243,24.3,0,5,6,6,7.2,19120,17746,1774.6,2055,2412,1
2294,-3737,-1022,1533.3,15333,18245,7.2,3,3,4,220,22.0,0,0,0,1,1,260,26.0,2,12,8,8,7.4,19267,19070,1907.0,1022,3737,0
2295,2026,460,1749.1,17491,19044,7.2,7,7,5,251,25.1,0,0,0,1,0,189,18.9,1,3,5,5,7.2,18584,15465,1546.5,-460,-2026,1
2296,-544,671,1569.8,15698,18966,7.4,4,4,3,214,21.4,1,1,1,0,0,238,23.8,0,5,5,5,6.8,18295,16242,1624.2,-671,544,1
2297,3399,2362,1822.3,18223,18996,7.2,7,7,10,230,23.0,2,1,1,0,0,200,20.0,0,1,4,4,6.8,16634,14824,1482.4,-2362,-3399,1
2298,793,475,1836.0,18360,19276,7.2,10,10,14,222,22.2,2,1,1,0,0,215,21.5,0,7,8,8,7.4,18801,17567,1756.7,-475,-793,1
2299,297,1259,1617.8,16178,19249,7.6,4,4,4,223,22.3,1,0,0,1,0,225,22.5,0,5,5,5,7.0,17990,15881,1588.1,-1259,-297,1
2300,-394,-1174,1504.8,15048,17795,6.8,3,3,4,223,22.3,1,1,1,0,0,253,25.3,0,3,3,3,7.2,18969,15442,1544.2,1174,394,1
2301,1897,1014,1686.5,16865,17583,6.8,7,7,14,211,21.1,0,0,0,1,0,182,18.2,0,5,4,4,6.6,16569,14968,1496.8,-1014,-1897,1
2302,222,1327,1807.2,18072,18740,7.2,7,7,8,221,22.1,0,0,0,1,1,202,20.2,1,10,9,9,6.8,17413,17850,1785.0,-1327,-222,0
2303,658,747,1750.0,17500,18895,7.2,11,11,6,193,19.3,0,0,1,0,0,193,19.3,0,10,7,7,6.8,18148,16842,1684.2,-747,-658,0
2304,-214,-334,1668.8,16688,17793,6.8,6,6,5,213,21.3,0,0,1,0,1,201,20.1,1,8,7,7,7.0,18127,16902,1690.2,334,214,0
2305,-898,-939,1738.4,17384,18722,6.8,9,9,6,227,22.7,0,0,1,0,1,225,22.5,2,9,9,9,7.2,19661,18282,1828.2,939,898,0
2306,-3439,-1460,1512.6,15126,18480,7.2,3,3,1,214,21.4,1,0,1,0,1,251,25.1,1,6,8,8,7.2,19940,18565,1856.5,1460,3439,0
2307,1892,1261,1721.4,17214,18791,7.0,7,7,4,241,24.1,0,0,1,0,0,214,21.4,0,5,5,5,6.8,17530,15322,1532.2,-1261,-1892,1
2308,-1428,-656,1738.9,17389,17933,6.8,9,9,6,226,22.6,0,0,0,1,1,237,23.7,1,12,11,11,7.0,18589,18817,1881.7,656,1428,0
2309,-1999,-647,1456.4,14564,17178,6.6,3,3,2,214,21.4,0,0,0,1,1,238,23.8,1,5,4,4,7.0,17825,16563,1656.3,647,1999,0
2310,1191,1276,1767.0,17670,19067,7.0,5,5,3,253,25.3,0,0,0,1,1,166,16.6,1,5,6,6,6.8,17791,16479,1647.9,-1276,-1191,0
2311,301,872,1629.6,16296,18903,7.2,6,6,5,216,21.6,0,0,0,1,1,229,22.9,1,5,6,6,6.8,18031,15995,1599.5,-872,-301,1
2312,-1712,-2334,1573.8,15738,16794,6.8,5,5,6,191,19.1,0,0,1,0,1,222,22.2,1,9,7,7,7.2,19128,17450,1745.0,2334,1712,0
2313,-2079,-538,1411.8,14118,17794,7.0,1,1,0,215,21.5,0,0,1,0,0,244,24.4,0,4,3,3,7.0,18332,16197,1619.7,538,2079,0
2314,-1182,-1113,1634.3,16343,16580,6.8,8,8,11,179,17.9,0,0,0,1,0,204,20.4,1,3,7,7,7.0,17693,17525,1752.5,1113,1182,0
2315,-4225,-2478,1457.9,14579,15758,6.4,2,2,3,196,19.6,0,0,0,1,0,230,23.0,0,16,12,12,7.2,18236,18804,1880.4,2478,4225,0
2316,4318,2821,1848.5,18485,18688,7.2,9,9,15,232,23.2,0,0,0,1,0,197,19.7,1,3,2,2,6.4,15867,14167,1416.7,-2821,-4318,1
2317,2741,2415,1898.2,18982,18664,7.0,12,12,11,234,23.4,0,0,1,0,0,205,20.5,0,5,5,5,6.6,16249,16241,1624.1,-2415,-2741,0
2318,-405,437,1668.8,16688,17678,6.8,6,6,5,223,22.3,1,1,1,0,0,205,20.5,0,11,7,7,6.6,17241,17093,1709.3,-437,405,1
2319,-425,-316,1483.6,14836,18769,7.0,1,1,1,261,26.1,1,1,0,1,0,255,25.5,0,2,2,2,7.2,19085,15261,1526.1,316,425,1
2320,-2928,-1796,1457.3,14573,17827,6.8,2,2,1,212,21.2,0,0,0,1,1,239,23.9,2,8,7,7,7.2,19623,17501,1750.1,1796,2928,0
2321,-3874,-2608,1570.4,15704,16313,6.4,4,4,4,206,20.6,0,0,1,0,1,238,23.8,1,17,11,11,7.4,18921,19578,1957.8,2608,3874,0
2322,-597,275,1657.8,16578,18528,7.0,7,7,10,206,20.6,1,0,0,1,1,242,24.2,1,6,6,6,6.8,18253,17175,1717.5,-275,597,0
2323,-215,-165,1604.5,16045,17324,7.0,5,5,5,208,20.8,0,0,0,1,1,216,21.6,1,6,8,8,7.0,17489,16260,1626.0,165,215,0
2324,-3613,-2636,1407.6,14076,16132,6.4,3,3,4,184,18.4,0,0,0,1,1,234,23.4,2,8,8,8,7.0,18768,17689,1768.9,2636,3613,0
2325,1630,2330,1651.8,16518,19145,7.2,7,7,9,208,20.8,2,1,1,0,0,218,21.8,0,2,3,3,6.8,16815,14888,1488.8,-2330,-1630,1
2326,-2539,-1447,1537.3,15373,16233,6.6,4,4,5,227,22.7,0,0,0,1,1,174,17.4,1,20,11,11,7.0,17680,17912,1791.2,1447,2539,0
2327,-1149,-217,1551.9,15519,18527,7.0,4,4,1,255,25.5,0,0,0,1,0,238,23.8,0,7,6,6,7.2,18744,16668,1666.8,217,1149,0
2328,2011,2996,1679.5,16795,19175,7.4,9,9,10,203,20.3,1,0,0,1,1,202,20.2,1,3,3,3,6.6,16179,14784,1478.4,-2996,-2011,1
2329,-1870,-1732,1594.1,15941,17256,6.8,8,8,15,162,16.2,1,0,0,1,1,245,24.5,1,5,6,6,7.4,18988,17811,1781.1,1732,1870,0
2330,2296,3462,1767.6,17676,20228,7.4,7,7,7,233,23.3,1,1,1,0,0,212,21.2,0,4,4,4,6.8,16766,15380,1538.0,-3462,-2296,1
2331,-278,571,1505.6,15056,18397,6.8,3,3,1,225,22.5,1,1,0,1,0,208,20.8,0,7,4,4,6.8,17826,15334,1533.4,-571,278,1
2332,-1665,-1607,1528.2,15282,17428,6.8,2,2,3,243,24.3,0,0,0,1,1,248,24.8,2,7,5,5,7.2,19035,16947,1694.7,1607,1665,1
2333,-1527,-457,1518.9,15189,18569,6.8,3,3,2,217,21.7,0,0,0,1,1,224,22.4,1,9,7,7,7.2,19026,16716,1671.6,457,1527,0
2334,160,-337,1628.5,16285,17681,7.0,6,6,8,230,23.0,0,0,0,1,0,204,20.4,0,8,5,5,6.8,18018,16125,1612.5,337,-160,1
2335,2498,1487,1838.2,18382,19220,7.0,8,8,11,224,22.4,1,1,1,0,0,217,21.7,0,5,4,4,7.0,17733,15884,1588.4,-1487,-2498,1
2336,-1556,286,1574.6,15746,17836,7.0,4,4,4,195,19.5,1,1,0,1,0,237,23.7,0,6,7,7,6.8,17550,17302,1730.2,-286,1556,1
2337,-3324,-1649,1614.1,16141,19127,7.2,5,5,4,215,21.5,0,0,0,1,1,236,23.6,1,8,12,12,7.6,20776,19465,1946.5,1649,3324,0
2338,-209,800,1555.8,15558,17405,6.6,5,5,2,221,22.1,1,0,0,1,1,185,18.5,1,8,6,6,6.8,16605,15767,1576.7,-800,209,1
2339,1386,1830,1548.6,15486,18701,7.0,2,2,1,251,25.1,0,0,1,0,0,234,23.4,0,0,0,0,6.4,16871,14100,1410.0,-1830,-1386,1
2340,2094,2937,1733.5,17335,17918,6.8,9,9,16,193,19.3,0,0,1,0,0,170,17.0,0,14,6,6,6.2,14981,15241,1524.1,-2937,-2094,1
2341,-7070,-4989,1259.8,12598,14826,6.0,1,1,1,204,20.4,0,0,0,1,0,220,22.0,0,15,14,14,7.4,19815,19668,1966.8,4989,7070,0
2342,1133,1833,1738.5,17385,18349,7.2,9,9,6,216,21.6,2,1,0,1,0,178,17.8,0,7,8,8,6.8,16516,16252,1625.2,-1833,-1133,1
2343,906,1330,1645.2,16452,17946,6.8,6,6,11,208,20.8,1,1,0,1,0,185,18.5,0,7,5,5,6.6,16616,15546,1554.6,-1330,-906,1
2344,-2523,-2980,1599.6,15996,15159,6.2,8,8,10,185,18.5,0,0,1,0,0,231,23.1,1,10,8,8,6.8,18139,18519,1851.9,2980,2523,1
2345,-129,-726,1637.0,16370,16868,6.6,6,6,3,231,23.1,0,0,0,1,0,182,18.2,0,8,7,7,7.0,17594,16499,1649.9,726,129,1
2346,-1450,340,1426.4,14264,18355,7.0,1,1,1,220,22.0,1,0,0,1,1,259,25.9,1,2,2,2,6.8,18015,15714,1571.4,-340,1450,0
2347,1217,2934,1706.1,17061,20292,7.6,5,5,3,249,24.9,1,1,0,1,0,218,21.8,0,6,4,4,6.6,17358,15844,1584.4,-2934,-1217,1
2348,91,-1992,1673.8,16738,16893,6.8,9,9,9,198,19.8,1,1,1,0,0,224,22.4,0,5,6,6,7.2,18885,16647,1664.7,1992,-91,0
2349,1128,1720,1799.9,17999,19369,7.2,9,9,5,227,22.7,0,0,0,1,1,212,21.2,1,12,9,9,7.0,17649,16871,1687.1,-1720,-1128,1
2350,672,-1567,1849.6,18496,17777,7.0,11,11,11,213,21.3,0,0,0,1,1,216,21.6,1,6,11,11,7.2,19344,17824,1782.4,1567,-672,0
2351,-33,-677,1641.4,16414,17333,6.8,7,7,11,205,20.5,0,0,0,1,0,223,22.3,0,6,6,6,7.0,18010,16447,1644.7,677,33,1
2352,1149,-530,1656.3,16563,17565,6.8,5,5,6,226,22.6,0,0,1,0,0,205,20.5,0,6,5,5,6.8,18095,15414,1541.4,530,-1149,0
2353,59,77,1431.4,14314,17525,7.0,1,1,1,244,24.4,1,1,0,1,0,224,22.4,0,1,2,2,6.8,17448,14255,1425.5,-77,-59,1
2354,399,147,1655.6,16556,18696,7.2,6,6,4,231,23.1,0,0,0,1,1,239,23.9,2,4,6,6,7.0,18549,16157,1615.7,-147,-399,1
2355,-4058,-3454,1460.4,14604,16297,6.6,4,4,6,190,19.0,1,1,1,0,0,257,25.7,1,5,7,7,7.4,19751,18662,1866.2,3454,4058,0
2356,-339,-868,1619.5,16195,18670,7.2,4,4,4,241,24.1,0,0,0,1,1,259,25.9,1,4,5,5,7.4,19538,16534,1653.4,868,339,0
2357,-3686,-2333,1466.8,14668,16843,6.6,6,6,2,198,19.8,1,1,1,0,0,232,23.2,1,7,7,7,7.2,19176,18354,1835.4,2333,3686,0
2358,-2564,170,1655.7,16557,17924,6.8,6,6,8,232,23.2,0,0,0,1,1,219,21.9,1,25,11,11,6.8,17754,19121,1912.1,-170,2564,1
2359,106,-462,1686.3,16863,17727,6.6,7,7,10,216,21.6,1,1,1,0,0,184,18.4,0,9,8,8,7.2,18189,16757,1675.7,462,-106,1
2360,1910,1136,1969.4,19694,19555,7.2,13,13,16,215,21.5,2,1,1,0,0,212,21.2,0,13,9,9,7.2,18419,17784,1778.4,-1136,-1910,1
2361,2400,2600,1852.3,18523,19699,7.2,10,10,8,229,22.9,1,1,0,1,0,191,19.1,0,6,8,8,6.8,17099,16123,1612.3,-2600,-2400,1
2362,975,1131,1761.8,17618,18069,7.0,10,10,8,212,21.2,1,1,1,0,0,196,19.6,0,4,8,8,6.8,16938,16643,1664.3,-1131,-975,1
2363,4671,4193,1875.1,18751,20236,7.2,9,9,9,249,24.9,0,0,1,0,1,177,17.7,1,5,4,4,6.6,16043,14080,1408.0,-4193,-4671,0
2364,-5540,-3682,1393.2,13932,15660,6.4,2,2,2,193,19.3,1,1,1,0,0,245,24.5,0,13,11,11,7.2,19342,19472,1947.2,3682,5540,0
2365,-2037,-1895,1639.4,16394,17514,7.2,5,5,9,238,23.8,1,1,1,0,0,229,22.9,1,12,9,9,7.2,19409,18431,1843.1,1895,2037,0
2366,1281,-5,1827.6,18276,17133,6.8,11,11,12,202,20.2,1,1,1,0,0,214,21.4,0,10,7,7,6.6,17138,16995,1699.5,5,-1281,1
2367,1672,1341,1772.2,17722,18023,7.0,9,9,14,215,21.5,1,1,1,0,0,205,20.5,0,8,7,7,6.8,16682,16050,1605.0,-1341,-1672,1
2368,2123,2669,1651.7,16517,19476,7.2,5,5,4,246,24.6,2,1,1,0,0,220,22.0,0,4,2,2,6.6,16807,14394,1439.4,-2669,-2123,0
2369,-646,-148,1533.7,15337,16528,6.6,5,5,6,198,19.8,0,0,0,1,0,197,19.7,0,9,7,7,6.6,16676,15983,1598.3,148,646,0
2370,-72,529,1756.9,17569,18822,7.2,7,7,7,239,23.9,0,0,0,1,1,209,20.9,2,11,9,9,7.0,18293,17641,1764.1,-529,72,1
2371,2268,635,1758.5,17585,18820,7.4,9,9,9,240,24.0,1,1,1,0,0,219,21.9,0,3,4,4,7.2,18185,15317,1531.7,-635,-2268,1
2372,-2365,-2046,1595.0,15950,18040,7.0,5,5,4,231,23.1,0,0,0,1,1,233,23.3,1,6,9,9,7.4,20086,18315,1831.5,2046,2365,0
2373,-136,-290,1653.1,16531,17534,7.0,7,7,9,218,21.8,0,0,1,0,1,243,24.3,2,8,6,6,7.0,17824,16667,1666.7,290,136,1
2374,-2683,-1320,1659.9,16599,16907,6.6,8,8,9,189,18.9,1,1,0,1,0,209,20.9,1,17,11,11,7.2,18227,19282,1928.2,1320,2683,0
2375,441,626,1608.6,16086,18044,7.0,5,5,6,222,22.2,1,1,0,1,0,235,23.5,0,5,4,4,6.8,17418,15645,1564.5,-626,-441,0
2376,-950,-1785,1506.5,15065,17423,6.8,1,1,1,252,25.2,0,0,0,1,0,238,23.8,0,6,5,5,7.2,19208,16015,1601.5,1785,950,0
2377,-2727,-2041,1394.6,13946,16248,6.4,2,2,1,227,22.7,0,0,0,1,1,220,22.0,1,10,7,7,7.0,18289,16673,1667.3,2041,2727,0
2378,-64,239,1652.6,16526,19072,7.2,7,7,10,217,21.7,0,0,0,1,0,214,21.4,0,4,5,5,7.0,18833,16590,1659.0,-239,64,0
2379,222,-72,1649.5,16495,17444,6.8,7,7,8,211,21.1,0,0,1,0,1,205,20.5,1,6,6,6,6.8,17516,16273,1627.3,72,-222,0
2380,862,1098,1700.9,17009,18492,7.2,3,3,1,238,23.8,1,0,0,1,1,252,25.2,1,5,3,3,6.8,17394,16147,1614.7,-1098,-862,1
2381,-2636,-839,1541.9,15419,17517,6.4,4,4,3,191,19.1,0,0,1,0,0,225,22.5,0,9,10,10,6.8,18356,18055,1805.5,839,2636,0
2382,23,-338,1646.0,16460,17849,7.0,7,7,9,220,22.0,1,1,0,1,0,222,22.2,0,8,5,5,7.0,18187,16437,1643.7,338,-23,1
2383,-1565,-1752,1636.4,16364,16467,6.4,7,7,6,223,22.3,0,0,0,1,1,170,17.0,2,14,11,11,7.0,18219,17929,1792.9,1752,1565,0
2384,1545,1824,1643.4,16434,18132,6.8,6,6,7,216,21.6,0,0,1,0,1,233,23.3,1,3,3,3,6.4,16308,14889,1488.9,-1824,-1545,1
2385,2260,248,1768.5,17685,17947,7.0,9,9,11,224,22.4,0,0,1,0,0,226,22.6,0,3,4,4,7.0,17699,15425,1542.5,-248,-2260,0
2386,-2535,-2654,1650.6,16506,16828,6.8,6,6,8,216,21.6,0,0,0,1,1,228,22.8,1,10,10,10,7.4,19482,19041,1904.1,2654,2535,1
2387,1514,1421,1717.4,17174,18060,6.8,9,9,9,212,21.2,0,0,0,1,0,187,18.7,1,6,6,6,6.8,16639,15660,1566.0,-1421,-1514,1
2388,-1426,-26,1477.1,14771,17825,7.0,3,3,6,227,22.7,0,0,0,1,1,218,21.8,2,4,5,5,7.0,17851,16197,1619.7,26,1426,1
2389,-2414,-3087,1635.9,16359,15794,6.4,6,6,10,182,18.2,1,1,1,0,0,225,22.5,0,4,8,8,7.2,18881,18773,1877.3,3087,2414,1
2390,1007,1105,1587.1,15871,18125,7.0,5,5,10,219,21.9,1,1,0,1,0,164,16.4,1,8,5,5,6.8,17020,14864,1486.4,-1105,-1007,1
2391,4749,3580,1821.5,18215,18418,7.2,6,6,6,256,25.6,1,1,1,0,0,207,20.7,0,1,2,2,6.2,14838,13466,1346.6,-3580,-4749,1
2392,-1358,-1063,1574.7,15747,17856,7.0,5,5,3,214,21.4,0,0,1,0,0,219,21.9,0,8,8,8,7.0,18919,17105,1710.5,1063,1358,1
2393,1474,963,1646.4,16464,18030,7.2,7,7,7,209,20.9,0,0,0,1,0,225,22.5,0,3,3,3,6.6,17067,14990,1499.0,-963,-1474,1
2394,2588,1543,1642.4,16424,17611,6.8,8,8,7,196,19.6,0,0,1,0,0,185,18.5,1,0,2,2,6.6,16068,13836,1383.6,-1543,-2588,1
2395,14,202,1749.4,17494,17832,6.8,9,9,14,201,20.1,1,1,0,1,0,243,24.3,0,9,8,8,7.0,17630,17480,1748.0,-202,-14,0
2396,5359,4990,1869.1,18691,20672,7.2,8,8,8,228,22.8,1,0,1,0,1,208,20.8,1,2,1,1,6.4,15682,13332,1333.2,-4990,-5359,1
2397,-3620,-282,1644.6,16446,18130,7.0,7,7,6,218,21.8,1,0,0,1,0,229,22.9,0,16,11,11,6.8,18412,20066,2006.6,282,3620,0
2398,-2295,-2516,1625.9,16259,16527,6.8,7,7,8,184,18.4,0,0,1,0,0,228,22.8,0,13,10,10,7.2,19043,18554,1855.4,2516,2295,0
2399,-2932,-2135,1623.1,16231,18316,7.2,4,4,4,211,21.1,1,1,1,0,0,215,21.5,0,15,11,11,7.4,20451,19163,1916.3,2135,2932,0
2400,2037,-281,1614.6,16146,16204,6.6,7,7,8,196,19.6,1,1,1,0,0,172,17.2,0,3,3,3,6.4,16485,14109,1410.9,281,-2037,0
2401,992,-609,1734.4,17344,17484,6.8,9,9,8,191,19.1,1,1,1,0,0,206,20.6,0,6,6,6,7.0,18093,16352,1635.2,609,-992,1
2402,1568,611,1732.7,17327,18655,7.0,8,8,12,203,20.3,0,0,0,1,0,212,21.2,0,5,5,5,7.0,18044,15759,1575.9,-611,-1568,1
2403,-727,322,1656.8,16568,18066,7.0,6,6,3,215,21.5,1,0,1,0,1,211,21.1,1,10,7,7,7.0,17744,17295,1729.5,-322,727,0
2404,-185,45,1573.2,15732,18040,7.0,3,3,4,241,24.1,0,0,1,0,1,238,23.8,1,4,4,4,7.0,17995,15917,1591.7,-45,185,0
2405,1322,2276,1681.2,16812,19678,7.0,7,7,5,228,22.8,0,0,1,0,1,215,21.5,1,5,5,5,6.6,17402,15490,1549.0,-2276,-1322,1
2406,1068,618,1645.2,16452,19307,7.2,4,4,2,273,27.3,0,0,1,0,0,253,25.3,0,4,2,2,7.2,18689,15384,1538.4,-618,-1068,1
2407,1975,1433,1742.7,17427,19221,7.0,6,6,6,249,24.9,1,1,1,0,0,234,23.4,0,2,3,3,7.0,17788,15452,1545.2,-1433,-1975,1
2408,2391,1726,1689.2,16892,18221,7.0,7,7,10,207,20.7,1,1,0,1,0,190,19.0,0,1,3,3,6.6,16495,14501,1450.1,-1726,-2391,1
2409,570,368,1700.3,17003,18752,7.2,5,5,4,252,25.2,0,0,0,1,0,235,23.5,0,4,5,5,7.2,18384,16433,1643.3,-368,-570,1
2410,1138,1758,1683.6,16836,18457,7.2,7,7,11,205,20.5,1,1,1,0,0,223,22.3,0,3,4,4,6.6,16699,15698,1569.8,-1758,-1138,0
2411,-6972,-3956,1443.4,14434,16488,6.6,3,3,4,181,18.1,1,1,0,1,0,240,24.0,1,10,11,11,7.6,20444,21406,2140.6,3956,6972,0
2412,-422,-43,1669.6,16696,17704,6.8,7,7,9,202,20.2,0,0,0,1,1,189,18.9,2,10,7,7,7.0,17747,17118,1711.8,43,422,1
2413,2906,2360,1697.4,16974,18550,7.2,8,8,12,182,18.2,1,1,1,0,0,201,20.1,0,1,1,1,6.4,16190,14068,1406.8,-2360,-2906,1
2414,-4566,-2032,1365.3,13653,17299,7.0,2,2,3,178,17.8,1,1,0,1,0,260,26.0,1,5,6,6,7.2,19331,18219,1821.9,2032,4566,0
2415,-1571,-693,1393.4,13934,17303,6.8,1,1,1,222,22.2,1,1,0,1,0,191,19.1,0,6,4,4,7.0,17996,15505,1550.5,693,1571,0
2416,-3556,-2950,1340.5,13405,15825,6.6,0,0,0,214,21.4,0,0,0,1,0,237,23.7,0,6,7,7,7.0,18775,16961,1696.1,2950,3556,0
2417,3015,3067,1874.7,18747,19584,7.2,10,10,9,225,22.5,2,1,1,0,0,184,18.4,0,5,6,6,6.8,16517,15732,1573.2,-3067,-3015,1
2418,-324,1651,1515.6,15156,18116,7.0,3,3,2,217,21.7,1,0,0,1,1,220,22.0,1,5,4,4,6.6,16465,15480,1548.0,-1651,324,1
2419,1350,577,1924.1,19241,18942,7.0,11,11,12,198,19.8,1,1,0,1,0,247,24.7,0,11,7,7,7.0,18365,17891,1789.1,-577,-1350,1
2420,394,-55,1586.6,15866,17452,6.8,7,7,6,176,17.6,1,1,0,1,0,216,21.6,0,4,5,5,6.8,17507,15472,1547.2,55,-394,1
2421,-1597,-715,1424.7,14247,16806,6.6,3,3,2,226,22.6,1,1,0,1,0,218,21.8,1,8,5,5,6.8,17521,15844,1584.4,715,1597,1
2422,-5355,-5889,1349.3,13493,14240,6.2,3,3,4,167,16.7,0,0,0,1,1,234,23.4,1,9,8,8,7.4,20129,18848,1884.8,5889,5355,0
2423,145,972,1585.5,15855,18078,7.0,4,4,1,238,23.8,1,1,1,0,0,224,22.4,0,7,5,5,6.6,17106,15710,1571.0,-972,-145,1
2424,1120,477,1518.6,15186,17891,7.0,1,1,1,231,23.1,1,0,1,0,1,196,19.6,1,2,1,1,6.8,17414,14066,1406.6,-477,-1120,1
2425,99,277,1717.6,17176,17299,6.8,10,10,12,188,18.8,1,1,1,0,0,203,20.3,0,8,7,7,6.6,17022,17077,1707.7,-277,-99,1
2426,980,403,1694.7,16947,18756,7.2,5,5,7,226,22.6,2,1,0,1,0,243,24.3,0,3,5,5,6.8,18353,15967,1596.7,-403,-980,1
2427,5351,3549,1952.8,19528,19357,7.2,11,11,10,234,23.4,1,1,1,0,0,211,21.1,0,2,2,2,6.4,15808,14177,1417.7,-3549,-5351,1
2428,-2490,-1110,1377.5,13775,17108,6.8,1,1,1,206,20.6,0,0,0,1,1,237,23.7,1,4,6,6,7.2,18218,16265,1626.5,1110,2490,0
2429,3750,2742,1841.8,18418,18311,7.0,10,10,12,247,24.7,2,1,1,0,0,194,19.4,0,6,5,5,6.4,15569,14668,1466.8,-2742,-3750,1
2430,-755,-1590,1481.5,14815,16774,6.4,3,3,3,189,18.9,0,0,1,0,1,210,21.0,1,6,4,4,7.0,18364,15570,1557.0,1590,755,1
2431,4161,2591,2172.8,21728,20117,7.4,13,13,20,242,24.2,1,0,1,0,0,214,21.4,0,15,8,8,6.8,17526,17567,1756.7,-2591,-4161,1
2432,1476,1149,1634.8,16348,18350,7.0,5,5,8,243,24.3,1,1,1,0,0,233,23.3,0,4,2,2,6.8,17201,14872,1487.2,-1149,-1476,0
2433,336,936,1630.2,16302,18772,7.2,6,6,8,231,23.1,2,1,0,1,0,223,22.3,0,5,5,5,7.0,17836,15966,1596.6,-936,-336,0
2434,-234,-406,1541.0,15410,17797,6.8,3,3,4,216,21.6,1,0,1,0,1,236,23.6,1,2,5,5,7.0,18203,15644,1564.4,406,234,0
2435,-1901,-3111,1511.9,15119,16105,6.4,4,4,3,216,21.6,0,0,1,0,1,216,21.6,1,10,8,8,7.2,19216,17020,1702.0,3111,1901,0
2436,-519,-643,1656.1,16561,17480,7.0,7,7,7,201,20.1,0,0,1,0,1,228,22.8,2,9,8,8,7.0,18123,17080,1708.0,643,519,0
2437,-2301,-2659,1373.6,13736,15897,6.6,1,1,2,180,18.0,0,0,0,1,1,226,22.6,2,3,5,5,7.2,18556,16037,1603.7,2659,2301,0
2438,481,977,1548.1,15481,17390,6.6,4,4,5,222,22.2,1,0,1,0,1,199,19.9,1,8,5,5,6.4,16413,15000,1500.0,-977,-481,0
2439,-1413,-1302,1596.7,15967,18406,7.0,4,4,3,227,22.7,0,0,0,1,1,256,25.6,2,9,6,6,7.2,19708,17380,1738.0,1302,1413,0
2440,-135,-997,1662.7,16627,18363,7.0,5,5,6,223,22.3,0,0,0,1,1,236,23.6,1,7,6,6,7.0,19360,16762,1676.2,997,135,1
2441,442,-145,1708.7,17087,17623,6.8,9,9,8,190,19.0,0,0,0,1,0,186,18.6,1,7,8,8,6.8,17768,16645,1664.5,145,-442,1
2442,2356,2431,1761.2,17612,19905,7.6,6,6,8,246,24.6,1,1,0,1,0,213,21.3,0,2,3,3,7.0,17474,15256,1525.6,-2431,-2356,1
2443,266,-912,1673.1,16731,16329,6.4,8,8,17,205,20.5,0,0,1,0,1,218,21.8,1,6,6,6,6.6,17241,16465,1646.5,912,-266,0
2444,525,476,1836.0,18360,17412,6.8,12,12,17,202,20.2,1,1,0,1,0,218,21.8,0,7,8,8,6.6,16936,17835,1783.5,-476,-525,1
2445,2859,2944,1807.5,18075,19469,7.4,8,8,4,237,23.7,1,0,1,0,0,224,22.4,0,6,4,4,6.6,16525,15216,1521.6,-2944,-2859,1
2446,4253,2731,1963.6,19636,19567,7.2,10,10,11,247,24.7,0,0,1,0,1,209,20.9,2,6,5,5,6.6,16836,15383,1538.3,-2731,-4253,0
2447,1923,1300,1689.7,16897,18652,7.0,6,6,8,234,23.4,1,0,1,0,1,240,24.0,1,2,2,2,6.8,17352,14974,1497.4,-1300,-1923,1
2448,-3278,-1873,1453.8,14538,16373,6.6,4,4,4,211,21.1,0,0,1,0,0,255,25.5,1,5,5,5,7.2,18246,17816,1781.6,1873,3278,0
2449,-1146,-441,1486.8,14868,17584,6.6,2,2,2,224,22.4,0,0,0,1,0,162,16.2,0,4,8,8,6.8,18025,16014,1601.4,441,1146,1
2450,4091,3392,2097.9,20979,20534,7.6,14,14,12,250,25.0,1,1,1,0,0,215,21.5,0,8,5,5,6.8,17142,16888,1688.8,-3392,-4091,1
2451,-379,725,1651.3,16513,18383,6.8,4,4,7,249,24.9,0,0,0,1,1,240,24.0,1,12,6,6,6.8,17658,16892,1689.2,-725,379,1
2452,476,100,1618.0,16180,18032,7.0,4,4,5,210,21.0,1,1,0,1,0,232,23.2,1,2,4,4,6.8,17932,15704,1570.4,-100,-476,1
2453,2041,1289,1605.0,16050,17867,7.0,6,6,8,195,19.5,0,0,1,0,0,202,20.2,0,1,3,3,6.4,16578,14009,1400.9,-1289,-2041,1
2454,-1552,-1506,1442.8,14428,16758,6.6,2,2,2,210,21.0,0,0,0,1,0,223,22.3,0,10,5,5,6.8,18264,15980,1598.0,1506,1552,0
2455,-2243,-2024,1615.0,16150,16419,6.6,6,6,4,194,19.4,0,0,0,1,0,186,18.6,0,13,14,14,7.0,18443,18393,1839.3,2024,2243,0
2456,2237,1848,1757.6,17576,18867,7.2,7,7,7,227,22.7,0,0,1,0,0,209,20.9,0,4,3,3,6.8,17019,15339,1533.9,-1848,-2237,0
2457,-1395,-711,1499.0,14990,17315,6.8,4,4,5,187,18.7,1,1,0,1,0,248,24.8,0,3,4,4,7.0,18026,16385,1638.5,711,1395,1
2458,257,1665,1766.4,17664,19310,7.0,8,8,7,220,22.0,1,1,0,1,0,225,22.5,1,11,8,8,6.8,17645,17407,1740.7,-1665,-257,1
2459,1323,25,1611.4,16114,17563,7.0,4,4,4,235,23.5,1,1,1,0,0,203,20.3,0,5,3,3,6.8,17538,14791,1479.1,-25,-1323,0
2460,-874,-1276,1529.9,15299,17076,6.4,3,3,3,230,23.0,1,1,1,0,0,231,23.1,0,6,6,6,7.0,18352,16173,1617.3,1276,874,0
2461,4565,2079,1891.2,18912,17839,7.0,10,10,12,257,25.7,2,1,1,0,0,197,19.7,0,2,2,2,6.2,15760,14347,1434.7,-2079,-4565,1
2462,5286,3583,1991.5,19915,18674,7.2,7,7,11,246,24.6,1,0,1,0,1,154,15.4,1,8,4,4,6.2,15091,14629,1462.9,-3583,-5286,1
2463,2544,862,1827.3,18273,17500,6.8,7,7,9,207,20.7,1,0,1,0,1,185,18.5,1,11,6,6,6.6,16638,15729,1572.9,-862,-2544,1
2464,-1529,-1177,1515.8,15158,17680,7.0,4,4,3,219,21.9,1,1,0,1,0,213,21.3,0,7,5,5,7.2,18857,16687,1668.7,1177,1529,0
2465,842,-663,1608.6,16086,17616,6.8,4,4,5,222,22.2,1,1,1,0,0,201,20.1,0,5,5,5,7.0,18279,15244,1524.4,663,-842,1
2466,2318,339,1862.6,18626,18656,7.2,9,9,7,226,22.6,0,0,1,0,0,239,23.9,1,4,6,6,7.2,18317,16308,1630.8,-339,-2318,0
2467,-1773,-1963,1704.8,17048,17097,6.8,8,8,13,193,19.3,1,1,0,1,0,215,21.5,0,13,10,10,7.2,19060,18821,1882.1,1963,1773,0
2468,-930,-594,1481.9,14819,17986,7.0,2,2,1,223,22.3,0,0,1,0,1,210,21.0,2,3,5,5,6.8,18580,15749,1574.9,594,930,0
2469,-1851,-2039,1508.2,15082,16399,6.8,5,5,7,199,19.9,0,0,0,1,0,258,25.8,1,4,5,5,7.0,18438,16933,1693.3,2039,1851,0
2470,-280,903,1460.5,14605,17830,7.0,1,1,1,244,24.4,1,0,0,1,1,217,21.7,1,3,3,3,6.6,16927,14885,1488.5,-903,280,0
2471,-1220,-203,1706.3,17063,18195,7.2,9,9,12,200,20.0,1,1,0,1,0,217,21.7,0,13,10,10,7.2,18398,18283,1828.3,203,1220,0
2472,-4851,-3577,1388.1,13881,16482,6.8,1,1,0,225,22.5,0,0,0,1,1,243,24.3,1,12,9,9,7.4,20059,18732,1873.2,3577,4851,0
2473,1748,1496,1718.0,17180,19599,7.0,6,6,5,258,25.8,0,0,1,0,1,236,23.6,1,1,4,4,7.0,18103,15432,1543.2,-1496,-1748,1
2474,-1589,-2907,1697.8,16978,17957,6.8,6,6,4,229,22.9,0,0,1,0,0,193,19.3,1,11,9,9,7.8,20864,18567,1856.7,2907,1589,1
2475,1756,1128,1782.7,17827,18481,6.8,12,12,10,208,20.8,0,0,0,1,1,188,18.8,1,6,5,5,6.8,17353,16071,1607.1,-1128,-1756,1
2476,-1149,-1327,1616.8,16168,17052,6.8,6,6,8,176,17.6,1,1,1,0,0,263,26.3,1,9,5,5,7.0,18379,17317,1731.7,1327,1149,1
2477,-961,-1410,1554.4,15544,18015,7.0,3,3,5,238,23.8,0,0,1,0,1,239,23.9,1,4,5,5,7.2,19425,16505,1650.5,1410,961,0
2478,-528,-296,1756.6,17566,18896,7.2,10,10,9,183,18.3,1,0,0,1,1,228,22.8,1,5,10,10,7.2,19192,18094,1809.4,296,528,1
2479,-1555,-1234,1529.3,15293,16208,6.4,5,5,7,202,20.2,1,1,0,1,0,210,21.0,0,11,7,7,6.8,17442,16848,1684.8,1234,1555,1
2480,2871,2154,1730.3,17303,18705,7.0,9,9,8,219,21.9,2,1,1,0,0,217,21.7,0,3,2,2,6.8,16551,14432,1443.2,-2154,-2871,1
2481,1070,1159,1720.1,17201,18839,7.2,4,4,5,234,23.4,1,1,1,0,0,215,21.5,1,2,4,4,6.8,17680,16131,1613.1,-1159,-1070,1
2482,3725,2903,1874.2,18742,20148,7.4,6,6,3,252,25.2,2,1,1,0,0,208,20.8,0,5,3,3,6.8,17245,15017,1501.7,-2903,-3725,1
2483,-180,2299,1651.9,16519,19018,7.2,5,5,7,210,21.0,0,0,0,1,1,192,19.2,2,7,8,8,6.6,16719,16699,1669.9,-2299,180,1
2484,-5000,-4822,1372.7,13727,16509,6.6,1,1,1,207,20.7,1,1,0,1,0,254,25.4,0,6,9,9,7.6,21331,18727,1872.7,4822,5000,0
2485,685,1449,1761.7,17617,18094,7.0,8,8,10,217,21.7,1,1,0,1,0,180,18.0,0,12,9,9,6.6,16645,16932,1693.2,-1449,-685,0
2486,3857,2660,1943.2,19432,19227,7.2,11,11,15,228,22.8,0,0,1,0,1,210,21.0,1,6,4,4,6.6,16567,15575,1557.5,-2660,-3857,1
2487,-770,-1875,1528.0,15280,16650,6.6,4,4,4,202,20.2,0,0,1,0,1,217,21.7,1,4,7,7,7.2,18525,16050,1605.0,1875,770,0
2488,-1406,-1328,1549.6,15496,17876,7.0,3,3,3,214,21.4,0,0,0,1,1,234,23.4,2,5,4,4,7.2,19204,16902,1690.2,1328,1406,1
2489,-2711,-282,1526.3,15263,15892,6.6,4,4,4,176,17.6,0,0,1,0,1,186,18.6,1,21,12,12,6.6,16174,17974,1797.4,282,2711,0
2490,324,106,1701.2,17012,19091,7.2,6,6,5,225,22.5,0,0,1,0,1,229,22.9,1,5,4,4,7.2,18985,16688,1668.8,-106,-324,1
2491,-3344,-2671,1416.8,14168,16884,6.6,1,1,2,217,21.7,0,0,0,1,1,225,22.5,2,7,6,6,7.6,19555,17512,1751.2,2671,3344,1
2492,143,845,1706.0,17060,17673,6.8,9,9,13,207,20.7,1,1,1,0,0,212,21.2,0,7,8,8,6.6,16828,16917,1691.7,-845,-143,1
2493,1126,71,1705.3,17053,17515,7.0,7,7,10,219,21.9,0,0,1,0,1,217,21.7,2,5,4,4,6.8,17444,15927,1592.7,-71,-1126,1
2494,-2557,-2229,1718.5,17185,16416,6.6,7,7,9,200,20.0,0,0,1,0,1,210,21.0,2,19,12,12,7.2,18645,19742,1974.2,2229,2557,1
2495,-1060,-586,1669.0,16690,17992,6.8,3,3,6,248,24.8,0,0,0,1,1,214,21.4,2,7,5,5,7.0,18578,17750,1775.0,586,1060,0
2496,2914,2052,1824.6,18246,18509,7.0,10,10,12,229,22.9,1,1,1,0,0,209,20.9,0,3,4,4,6.4,16457,15332,1533.2,-2052,-2914,1
2497,464,426,1631.0,16310,17712,6.8,7,7,8,219,21.9,0,0,0,1,1,212,21.2,1,4,7,7,6.8,17286,15846,1584.6,-426,-464,1
2498,1399,554,1676.6,16766,18841,7.2,5,5,5,232,23.2,1,1,1,0,0,240,24.0,0,5,3,3,7.0,18287,15367,1536.7,-554,-1399,1
2499,778,1443,1946.0,19460,19643,7.4,12,12,12,223,22.3,0,0,1,0,0,234,23.4,0,14,11,11,7.0,18200,18682,1868.2,-1443,-778,0
2500,-1618,-1224,1530.7,15307,16772,6.8,5,5,4,205,20.5,1,0,1,0,0,243,24.3,0,9,6,6,7.0,17996,16925,1692.5,1224,1618,1
2501,-1345,169,1590.8,15908,18133,7.0,4,4,5,218,21.8,0,0,0,1,1,220,22.0,1,9,6,6,6.8,17964,17253,1725.3,-169,1345,0
2502,138,1085,1696.6,16966,19311,7.6,6,6,5,231,23.1,1,1,1,0,0,214,21.4,1,6,5,5,7.0,18226,16828,1682.8,-1085,-138,1
2503,-418,185,1699.5,16995,19978,7.6,6,6,2,241,24.1,1,1,0,1,0,237,23.7,0,8,6,6,7.4,19793,17413,1741.3,-185,418,1
2504,789,1319,1829.2,18292,18884,7.0,12,12,17,216,21.6,2,1,1,0,0,220,22.0,0,6,7,7,6.8,17565,17503,1750.3,-1319,-789,0
2505,760,45,1648.1,16481,18642,7.0,6,6,8,229,22.9,1,0,1,0,1,232,23.2,1,3,3,3,7.0,18597,15721,1572.1,-45,-760,1
2506,-2342,-1982,1490.7,14907,17149,6.6,3,3,4,226,22.6,0,0,0,1,0,262,26.2,0,5,6,6,7.2,19131,17249,1724.9,1982,2342,0
2507,-2302,-2232,1510.8,15108,16485,6.4,6,6,7,191,19.1,1,1,1,0,0,246,24.6,0,7,8,8,7.0,18717,17410,1741.0,2232,2302,1
2508,-2932,-2570,1477.9,14779,15595,6.2,6,6,7,137,13.7,1,1,1,0,0,219,21.9,1,5,8,8,7.2,18165,17711,1771.1,2570,2932,0
2509,154,159,1573.9,15739,18231,7.2,6,6,2,193,19.3,0,0,0,1,1,211,21.1,1,5,5,5,7.0,18072,15585,1558.5,-159,-154,0
2510,99,-1609,1666.0,16660,17061,6.8,6,6,9,210,21.0,0,0,1,0,1,214,21.4,1,3,7,7,7.0,18670,16561,1656.1,1609,-99,0
2511,-2876,-2098,1356.1,13561,16632,6.6,0,0,0,222,22.2,0,0,0,1,1,233,23.3,1,8,5,5,7.0,18730,16437,1643.7,2098,2876,0
2512,2501,2298,1776.1,17761,20143,7.4,8,8,5,247,24.7,0,0,1,0,0,251,25.1,0,1,1,1,6.6,17845,15260,1526.0,-2298,-2501,0
2513,-1557,-1039,1491.0,14910,17888,6.8,1,1,1,245,24.5,0,0,0,1,1,225,22.5,1,7,6,6,7.2,18927,16467,1646.7,1039,1557,0
2514,1578,495,1741.0,17410,18627,7.0,9,9,8,190,19.0,1,1,1,0,0,195,19.5,0,6,6,6,7.0,18132,15832,1583.2,-495,-1578,1
2515,-1630,-531,1551.8,15518,18114,6.8,4,4,3,241,24.1,0,0,0,1,1,243,24.3,1,8,6,6,7.2,18645,17148,1714.8,531,1630,0
2516,1753,935,1826.1,18261,18602,7.4,8,8,10,248,24.8,1,1,0,1,0,218,21.8,0,8,7,7,7.0,17667,16508,1650.8,-935,-1753,1
2517,14,-309,1557.4,15574,17216,6.8,4,4,7,236,23.6,0,0,1,0,1,224,22.4,2,6,5,5,6.8,17525,15560,1556.0,309,-14,0
2518,-245,-1208,1656.5,16565,17659,7.0,5,5,5,220,22.0,0,0,0,1,0,244,24.4,0,3,7,7,7.0,18867,16810,1681.0,1208,245,0
2519,1074,542,1616.3,16163,18437,7.0,5,5,8,242,24.2,0,0,1,0,0,224,22.4,1,8,4,4,7.0,17895,15089,1508.9,-542,-1074,0
2520,-3541,-2434,1472.4,14724,16015,6.4,3,3,5,218,21.8,0,0,0,1,1,244,24.4,1,13,9,9,6.8,18449,18265,1826.5,2434,3541,0
2521,2915,2085,1795.3,17953,18275,7.2,10,10,8,213,21.3,1,1,1,0,0,200,20.0,0,6,3,3,6.4,16190,15038,1503.8,-2085,-2915,1
2522,-4413,-3537,1481.9,14819,16721,6.8,5,5,5,164,16.4,1,1,0,1,0,242,24.2,0,8,12,12,7.4,20258,19232,1923.2,3537,4413,0
2523,-1517,-1487,1502.5,15025,16369,6.6,4,4,4,212,21.2,0,0,1,0,0,221,22.1,0,5,7,7,7.0,17856,16542,1654.2,1487,1517,0
2524,2178,31,1830.2,18302,17304,6.8,11,11,14,235,23.5,0,0,1,0,0,192,19.2,0,5,8,8,6.8,17273,16124,1612.4,-31,-2178,1
2525,1470,1240,1819.7,18197,18621,7.0,11,11,7,205,20.5,0,0,1,0,1,206,20.6,1,7,7,7,6.8,17381,16727,1672.7,-1240,-1470,0
2526,4507,4079,1836.3,18363,20337,7.2,8,8,7,233,23.3,1,1,1,0,0,194,19.4,0,2,3,3,6.6,16258,13856,1385.6,-4079,-4507,1
2527,4387,3411,1754.3,17543,19535,7.2,8,8,7,254,25.4,1,1,1,0,0,188,18.8,0,0,2,2,6.6,16124,13156,1315.6,-3411,-4387,1
2528,929,1800,1697.3,16973,18421,7.0,8,8,9,204,20.4,0,0,0,1,0,203,20.3,0,4,7,7,6.8,16621,16044,1604.4,-1800,-929,0
2529,-787,-1921,1658.6,16586,17047,6.8,7,7,8,226,22.6,1,1,0,1,0,207,20.7,0,7,8,8,7.2,18968,17373,1737.3,1921,787,0
2530,2695,1787,1810.6,18106,17783,7.0,11,11,15,191,19.1,0,0,1,0,1,187,18.7,1,6,5,5,6.4,15996,15411,1541.1,-1787,-2695,1
2531,-3173,-4350,1630.0,16300,13423,5.8,9,9,15,141,14.1,0,0,1,0,1,207,20.7,1,18,13,13,7.0,17773,19473,1947.3,4350,3173,0
2532,-1253,933,1639.7,16397,18004,7.0,8,8,7,183,18.3,0,0,0,1,0,199,19.9,0,9,9,9,6.6,17071,17650,1765.0,-933,1253,0
2533,2711,1821,1694.8,16948,18641,6.8,6,6,5,241,24.1,1,1,1,0,0,223,22.3,0,0,2,2,6.4,16820,14237,1423.7,-1821,-2711,1
2534,-471,-1021,1499.2,14992,17756,7.0,4,4,6,213,21.3,1,1,1,0,0,240,24.0,0,1,3,3,7.2,18777,15463,1546.3,1021,471,0
2535,1319,111,1656.0,16560,18049,6.8,5,5,8,220,22.0,1,1,0,1,0,190,19.0,1,5,4,4,7.0,17938,15241,1524.1,-111,-1319,0
2536,338,-1062,1575.9,15759,17563,6.8,5,5,6,219,21.9,1,0,1,0,0,220,22.0,0,4,3,3,7.0,18625,15421,1542.1,1062,-338,0
2537,-2263,-2155,1471.1,14711,15177,6.4,6,6,9,154,15.4,0,0,0,1,1,196,19.6,1,11,10,10,6.8,17332,16974,1697.4,2155,2263,1
2538,2038,357,1694.0,16940,17896,7.0,6,6,7,244,24.4,1,0,1,0,0,198,19.8,0,6,4,4,6.8,17539,14902,1490.2,-357,-2038,1
2539,-1911,-1211,1521.8,15218,19074,7.0,4,4,4,203,20.3,0,0,0,1,1,250,25.0,2,7,5,5,7.4,20285,17129,1712.9,1211,1911,0
2540,488,473,1546.6,15466,17220,6.8,4,4,6,228,22.8,1,1,1,0,0,182,18.2,0,8,5,5,6.8,16747,14978,1497.8,-473,-488,0
2541,734,355,1527.8,15278,18693,7.0,4,4,2,227,22.7,1,1,1,0,0,203,20.3,0,3,3,3,7.2,18338,14544,1454.4,-355,-734,1
2542,5195,2289,1965.1,19651,18318,7.0,16,16,17,200,20.0,1,1,1,0,0,179,17.9,0,3,4,4,6.4,16029,14456,1445.6,-2289,-5195,1
2543,3319,5284,1823.3,18233,21650,7.6,9,9,6,244,24.4,2,1,1,0,0,177,17.7,0,7,4,4,6.6,16366,14914,1491.4,-5284,-3319,0
2544,2335,979,1747.0,17470,18062,7.0,7,7,13,206,20.6,1,1,1,0,0,215,21.5,0,4,4,4,6.8,17083,15135,1513.5,-979,-2335,1
2545,-268,-155,1676.8,16768,19368,7.2,7,7,5,225,22.5,0,0,0,1,1,221,22.1,1,9,8,8,7.2,19523,17036,1703.6,155,268,0
2546,-1110,-1148,1450.9,14509,17194,6.8,3,3,3,201,20.1,0,0,1,0,0,241,24.1,0,4,4,4,6.8,18342,15619,1561.9,1148,1110,0
2547,381,203,1617.8,16178,18656,7.2,7,7,5,216,21.6,1,0,1,0,1,253,25.3,1,3,3,3,7.0,18453,15797,1579.7,-203,-381,1
2548,-1636,-1396,1433.3,14333,16812,6.8,2,2,0,223,22.3,0,0,1,0,1,223,22.3,1,5,6,6,6.8,18208,15969,1596.9,1396,1636,0
2549,-532,298,1773.2,17732,19451,7.2,9,9,12,194,19.4,2,1,0,1,0,208,20.8,0,8,9,9,7.2,19153,18264,1826.4,-298,532,1
2550,-2467,80,1469.5,14695,18090,6.8,4,4,3,207,20.7,0,0,0,1,1,187,18.7,1,10,9,9,7.2,18010,17162,1716.2,-80,2467,0
2551,2460,1934,1780.0,17800,19085,7.0,7,7,13,223,22.3,0,0,0,1,1,205,20.5,1,5,3,3,6.6,17151,15340,1534.0,-1934,-2460,1
2552,1454,1411,1604.8,16048,19032,7.2,4,4,3,255,25.5,0,0,1,0,0,234,23.4,0,3,3,3,7.0,17621,14594,1459.4,-1411,-1454,1
2553,450,924,1416.3,14163,17413,6.8,1,1,0,246,24.6,0,0,1,0,1,211,21.1,1,2,1,1,6.6,16489,13713,1371.3,-924,-450,1
2554,-300,451,1569.5,15695,18493,7.2,4,4,3,238,23.8,2,1,0,1,0,203,20.3,0,5,6,6,7.2,18042,15995,1599.5,-451,300,1
2555,-2343,-2188,1484.4,14844,17179,6.8,3,3,6,218,21.8,1,1,0,1,0,256,25.6,0,3,6,6,7.2,19367,17187,1718.7,2188,2343,0
2556,-1008,-1516,1597.4,15974,16903,6.6,9,9,3,175,17.5,0,0,1,0,1,184,18.4,1,9,10,10,7.0,18419,16982,1698.2,1516,1008,0
2557,-2442,-1250,1499.5,14995,17661,7.0,3,3,5,240,24.0,0,0,1,0,1,264,26.4,1,11,7,7,7.2,18911,17437,1743.7,1250,2442,1
2558,-4740,-3081,1479.9,14799,15917,6.6,4,4,5,218,21.8,0,0,0,1,1,231,23.1,2,8,12,12,7.0,18998,19539,1953.9,3081,4740,0
2559,-1603,-1406,1705.6,17056,17190,6.6,10,10,14,167,16.7,0,0,0,1,1,229,22.9,2,11,11,11,7.0,18596,18659,1865.9,1406,1603,0
2560,-555,-1462,1624.3,16243,17548,6.8,7,7,10,192,19.2,1,1,0,1,0,232,23.2,1,6,6,6,7.2,19010,16798,1679.8,1462,555,0
2561,-1361,-1031,1789.2,17892,16641,6.8,11,11,14,157,15.7,1,1,0,1,0,239,23.9,1,10,10,10,6.8,17672,19253,1925.3,1031,1361,0
2562,2024,1979,1650.8,16508,17714,6.6,6,6,4,243,24.3,1,1,1,0,0,213,21.3,1,4,3,3,6.4,15735,14484,1448.4,-1979,-2024,1
2563,1840,1870,1656.8,16568,18658,6.8,4,4,4,242,24.2,0,0,0,1,0,240,24.0,0,2,2,2,6.6,16788,14728,1472.8,-1870,-1840,1
2564,690,365,1650.3,16503,18765,7.2,5,5,6,231,23.1,0,0,0,1,1,232,23.2,1,3,5,5,7.2,18400,15813,1581.3,-365,-690,1
2565,-98,-1136,1745.9,17459,18018,7.0,9,9,7,185,18.5,1,1,1,0,0,219,21.9,0,6,9,9,7.2,19154,17557,1755.7,1136,98,0
2566,197,1883,1702.4,17024,19375,7.2,7,7,5,222,22.2,0,0,1,0,1,198,19.8,2,7,7,7,7.0,17492,16827,1682.7,-1883,-197,1
2567,1574,1067,1666.0,16660,18272,6.8,5,5,3,252,25.2,0,0,1,0,0,197,19.7,0,6,4,4,6.8,17205,15086,1508.6,-1067,-1574,1
2568,-3553,-1730,1424.4,14244,16850,6.6,2,2,0,207,20.7,0,0,0,1,1,220,22.0,1,9,9,9,7.0,18580,17797,1779.7,1730,3553,0
2569,-5162,-3610,1404.1,14041,15172,6.4,1,1,1,226,22.6,0,0,1,0,0,196,19.6,0,19,10,10,7.2,18782,19203,1920.3,3610,5162,0
2570,2210,2411,1675.2,16752,19777,7.4,4,4,1,232,23.2,1,1,1,0,0,214,21.4,0,0,2,2,6.6,17366,14542,1454.2,-2411,-2210,1
2571,3410,2058,1756.3,17563,18032,7.2,8,8,13,203,20.3,1,0,1,0,1,213,21.3,1,2,2,2,6.4,15974,14153,1415.3,-2058,-3410,1
2572,251,-74,1726.2,17262,19094,7.0,6,6,4,231,23.1,1,1,1,0,0,236,23.6,0,5,6,6,7.2,19168,17011,1701.1,74,-251,1
2573,3018,1995,1743.8,17438,18257,7.0,9,9,9,186,18.6,0,0,1,0,0,222,22.2,0,3,3,3,6.6,16262,14420,1442.0,-1995,-3018,1
2574,-3414,-3747,1427.5,14275,15474,6.4,3,3,3,180,18.0,0,0,0,1,1,228,22.8,2,4,8,8,7.2,19221,17689,1768.9,3747,3414,0
2575,2015,857,1675.3,16753,17461,6.8,7,7,10,220,22.0,1,1,1,0,0,171,17.1,1,2,4,4,6.4,16604,14738,1473.8,-857,-2015,1
2576,1422,775,1716.3,17163,19382,7.2,8,8,9,224,22.4,1,1,1,0,0,218,21.8,0,2,4,4,7.2,18607,15741,1574.1,-775,-1422,1
2577,-1727,-619,1575.0,15750,17334,7.0,5,5,8,214,21.4,0,0,0,1,0,223,22.3,0,8,6,6,6.8,17953,17477,1747.7,619,1727,0
2578,654,823,1595.4,15954,16128,6.8,7,7,6,211,21.1,0,0,1,0,0,190,19.0,1,6,6,6,6.2,15305,15300,1530.0,-823,-654,1
2579,3691,2805,1829.3,18293,19981,7.2,9,9,10,240,24.0,2,1,1,0,0,186,18.6,0,3,3,3,7.0,17176,14602,1460.2,-2805,-3691,1
2580,4627,4784,1933.6,19336,19116,7.2,13,13,16,212,21.2,0,0,1,0,0,175,17.5,0,6,5,5,6.0,14332,14709,1470.9,-4784,-4627,0
2581,-3443,-2284,1401.4,14014,16219,6.6,2,2,1,205,20.5,1,0,1,0,0,230,23.0,0,8,8,8,7.2,18503,17457,1745.7,2284,3443,0
2582,-819,-1829,1620.7,16207,17381,7.0,6,6,8,211,21.1,2,1,0,1,0,223,22.3,0,3,6,6,7.0,19210,17026,1702.6,1829,819,0
2583,1856,1530,1665.4,16654,19392,7.2,4,4,4,255,25.5,0,0,0,1,1,244,24.4,2,1,1,1,6.8,17862,14798,1479.8,-1530,-1856,1
2584,1759,2524,1671.1,16711,19807,7.4,4,4,6,233,23.3,0,0,0,1,1,203,20.3,1,9,4,4,6.8,17283,14952,1495.2,-2524,-1759,1
2585,1159,1510,1657.8,16578,18139,7.0,7,7,10,200,20.0,1,1,1,0,0,250,25.0,0,3,3,3,6.6,16629,15419,1541.9,-1510,-1159,0
2586,-444,-184,1622.0,16220,17447,6.8,4,4,7,227,22.7,1,1,0,1,0,212,21.2,0,12,8,8,7.0,17631,16664,1666.4,184,444,1
2587,-120,-1620,1509.6,15096,15415,6.2,6,6,8,199,19.9,0,0,0,1,1,193,19.3,1,2,4,4,6.4,17035,15216,1521.6,1620,120,0
2588,1493,202,1842.6,18426,18454,7.2,10,10,13,192,19.2,1,0,1,0,0,185,18.5,0,7,8,8,7.0,18252,16933,1693.3,-202,-1493,1
2589,4335,2324,1875.8,18758,18710,7.0,11,11,14,212,21.2,1,1,1,0,0,215,21.5,0,3,3,3,6.6,16386,14423,1442.3,-2324,-4335,1
2590,-935,-4,1592.8,15928,18170,7.2,4,4,3,204,20.4,0,0,1,0,1,233,23.3,1,5,7,7,6.8,18174,16863,1686.3,4,935,0
2591,1081,199,1623.3,16233,18524,7.0,6,6,9,215,21.5,1,1,1,0,0,220,22.0,0,1,3,3,7.2,18325,15152,1515.2,-199,-1081,1
2592,-862,-1734,1649.3,16493,17450,7.0,8,8,7,175,17.5,1,1,1,0,0,223,22.3,1,5,8,8,7.2,19184,17355,1735.5,1734,862,1
2593,-2770,-2347,1563.3,15633,17605,6.8,6,6,8,210,21.0,1,0,0,1,1,218,21.8,1,13,10,10,7.2,19952,18403,1840.3,2347,2770,0
2594,3673,2756,1775.0,17750,20138,7.4,7,7,8,237,23.7,2,1,0,1,0,204,20.4,0,1,2,2,6.8,17382,14077,1407.7,-2756,-3673,1
2595,-4859,-2956,1625.1,16251,16548,6.8,5,5,6,213,21.3,0,0,0,1,0,226,22.6,1,14,14,14,7.2,19504,21110,2111.0,2956,4859,0
2596,428,35,1762.7,17627,18282,7.0,7,7,6,244,24.4,0,0,1,0,1,247,24.7,1,11,7,7,7.0,18247,17199,1719.9,-35,-428,1
2597,-733,-1569,1731.5,17315,19378,7.4,5,5,4,253,25.3,1,1,1,0,0,216,21.6,0,7,10,10,7.6,20947,18048,1804.8,1569,733,0
2598,936,1377,1566.3,15663,18122,7.0,4,4,4,237,23.7,0,0,0,1,1,191,19.1,1,2,5,5,6.6,16745,14727,1472.7,-1377,-936,0
2599,-1179,646,1486.5,14865,18385,7.0,2,2,1,233,23.3,0,0,0,1,1,226,22.6,2,4,4,4,6.8,17739,16044,1604.4,-646,1179,0
2600,932,542,1623.0,16230,18489,7.0,5,5,4,235,23.5,0,0,1,0,0,247,24.7,0,4,2,2,7.2,17947,15298,1529.8,-542,-932,1
2601,544,2063,1606.5,16065,20238,7.4,5,5,1,247,24.7,0,0,0,1,0,222,22.2,0,3,5,5,6.8,18175,15521,1552.1,-2063,-544,1
2602,-105,1881,1704.9,17049,20151,7.4,7,7,8,223,22.3,1,1,0,1,0,231,23.1,0,7,5,5,7.2,18270,17154,1715.4,-1881,105,0
2603,-287,-1045,1541.2,15412,18001,7.0,4,4,5,212,21.2,1,1,0,1,0,243,24.3,0,3,3,3,7.0,19046,15699,1569.9,1045,287,0
2604,1052,340,1794.9,17949,19069,7.0,10,10,10,200,20.0,0,0,1,0,1,223,22.3,1,6,8,8,7.0,18729,16897,1689.7,-340,-1052,1
2605,2145,-316,1693.8,16938,17614,7.0,6,6,5,220,22.0,0,0,1,0,0,197,19.7,0,5,4,4,6.8,17930,14793,1479.3,316,-2145,1
2606,-3960,-4005,1462.7,14627,16086,6.6,4,4,7,193,19.3,0,0,1,0,1,247,24.7,1,9,8,8,7.6,20091,18587,1858.7,4005,3960,0
2607,1097,711,1648.5,16485,18759,7.0,6,6,7,222,22.2,0,0,0,1,1,240,24.0,1,1,3,3,7.0,18048,15388,1538.8,-711,-1097,0
2608,-671,-738,1524.6,15246,17687,7.0,4,4,2,217,21.7,0,0,1,0,1,227,22.7,1,2,5,5,7.0,18425,15917,1591.7,738,671,0
2609,-236,-1078,1758.3,17583,17639,7.0,10,10,19,201,20.1,1,1,0,1,0,225,22.5,0,13,9,9,7.2,18717,17819,1781.9,1078,236,0
2610,3212,3245,1865.5,18655,19797,7.6,10,10,9,254,25.4,1,1,1,0,0,170,17.0,0,8,6,6,6.8,16552,15443,1544.3,-3245,-3212,1
2611,-795,236,1687.5,16875,18112,6.8,7,7,5,219,21.9,1,1,1,0,0,221,22.1,0,9,7,7,6.8,17876,17670,1767.0,-236,795,1
2612,3544,2083,1787.2,17872,19324,7.2,6,6,4,247,24.7,1,0,1,0,1,219,21.9,1,1,1,1,6.8,17241,14328,1432.8,-2083,-3544,1
2613,969,-42,1657.4,16574,17377,6.8,7,7,9,197,19.7,2,1,1,0,0,194,19.4,0,8,6,6,6.6,17419,15605,1560.5,42,-969,1
2614,2348,1133,1765.1,17651,18199,7.0,9,9,7,222,22.2,0,0,1,0,1,195,19.5,1,4,5,5,6.8,17066,15303,1530.3,-1133,-2348,0
2615,-3584,-3248,1503.5,15035,16650,6.4,4,4,7,183,18.3,0,0,1,0,1,238,23.8,1,10,10,10,7.6,19898,18619,1861.9,3248,3584,0
2616,330,-475,1639.9,16399,17698,7.0,5,5,3,236,23.6,2,1,1,0,0,235,23.5,0,6,5,5,6.8,18173,16069,1606.9,475,-330,1
2617,1112,203,1823.6,18236,18690,7.0,8,8,13,221,22.1,1,0,0,1,0,198,19.8,0,12,8,8,7.0,18487,17124,1712.4,-203,-1112,0
2618,279,392,1578.2,15782,18450,7.0,5,5,6,219,21.9,0,0,1,0,1,246,24.6,1,4,3,3,7.0,18058,15503,1550.3,-392,-279,1
2619,1516,426,1693.8,16938,18699,7.0,7,7,9,226,22.6,1,1,1,0,0,210,21.0,0,4,3,3,7.0,18273,15422,1542.2,-426,-1516,0
2620,-4229,-4184,1474.0,14740,15556,6.4,5,5,5,156,15.6,0,0,0,1,1,220,22.0,1,12,10,10,7.4,19740,18969,1896.9,4184,4229,0
2621,-3111,-2286,1529.9,15299,17019,7.0,5,5,6,169,16.9,0,0,0,1,0,178,17.8,0,10,12,12,7.0,19305,18410,1841.0,2286,3111,0
2622,3686,1471,1761.5,17615,18307,7.0,8,8,8,206,20.6,0,0,1,0,0,153,15.3,0,4,5,5,6.6,16836,13929,1392.9,-1471,-3686,1
2623,5136,2785,2095.5,20955,19806,7.2,13,13,14,225,22.5,1,1,1,0,0,213,21.3,0,3,3,3,6.8,17021,15819,1581.9,-2785,-5136,1
2624,1394,1368,1663.6,16636,19834,7.4,6,6,8,245,24.5,0,0,1,0,0,225,22.5,0,3,2,2,7.0,18466,15242,1524.2,-1368,-1394,1
2625,-2009,-2396,1380.5,13805,17253,6.8,0,0,0,221,22.1,1,0,0,1,1,243,24.3,1,5,4,4,7.2,19649,15814,1581.4,2396,2009,0
2626,466,-316,1845.3,18453,18299,7.0,11,11,16,204,20.4,0,0,1,0,0,186,18.6,0,14,10,10,7.4,18615,17987,1798.7,316,-466,0
2627,-4958,-2388,1464.2,14642,15033,6.2,5,5,5,171,17.1,0,0,0,1,1,231,23.1,1,14,13,13,7.0,17421,19600,1960.0,2388,4958,0
2628,-2825,-2497,1450.3,14503,16807,6.8,3,3,4,207,20.7,0,0,0,1,1,221,22.1,2,9,7,7,7.2,19304,17328,1732.8,2497,2825,0
2629,-1716,-1601,1533.5,15335,17368,6.6,3,3,3,234,23.4,1,1,0,1,0,262,26.2,0,5,7,7,7.2,18969,17051,1705.1,1601,1716,0
2630,-1537,-926,1562.9,15629,16806,6.8,6,6,10,176,17.6,0,0,1,0,0,186,18.6,0,9,8,8,7.0,17732,17166,1716.6,926,1537,0
2631,-2707,-2136,1578.2,15782,16172,6.4,5,5,6,195,19.5,0,0,0,1,1,233,23.3,1,10,12,12,7.0,18308,18489,1848.9,2136,2707,0
2632,2857,1406,1868.5,18685,18421,6.8,12,12,17,234,23.4,1,1,1,0,0,214,21.4,0,4,5,5,6.8,17015,15828,1582.8,-1406,-2857,1
2633,-3206,-2169,1490.1,14901,16696,6.8,2,2,3,214,21.4,1,1,0,1,0,238,23.8,0,10,9,9,7.2,18865,18107,1810.7,2169,3206,1
2634,-2670,-1395,1401.2,14012,17304,6.8,1,1,1,230,23.0,0,0,0,1,1,218,21.8,1,6,6,6,7.0,18699,16682,1668.2,1395,2670,0
2635,-960,-2502,1591.3,15913,16454,6.4,4,4,5,193,19.3,0,0,1,0,0,190,19.0,0,9,8,8,7.4,18956,16873,1687.3,2502,960,0
2636,-1579,-1179,1496.9,14969,16860,6.6,5,5,2,200,20.0,1,1,0,1,0,226,22.6,0,1,6,6,7.2,18039,16548,1654.8,1179,1579,0
2637,321,-260,1486.3,14863,18643,7.0,3,3,2,230,23.0,0,0,1,0,0,230,23.0,0,2,2,2,7.0,18903,14542,1454.2,260,-321,0
2638,-12,-1161,1598.5,15985,18011,7.0,5,5,6,214,21.4,0,0,1,0,0,194,19.4,0,4,8,8,7.2,19172,15997,1599.7,1161,12,0
2639,222,1716,1740.7,17407,18451,7.2,9,9,7,214,21.4,0,0,0,1,0,205,20.5,0,13,10,10,6.6,16735,17185,1718.5,-1716,-222,0
2640,968,715,1582.9,15829,17771,6.8,5,5,5,237,23.7,0,0,1,0,1,224,22.4,1,2,3,3,6.8,17056,14861,1486.1,-715,-968,0
2641,-3042,-3641,1495.3,14953,17141,6.6,5,5,3,183,18.3,0,0,1,0,1,224,22.4,1,5,9,9,7.6,20782,17995,1799.5,3641,3042,0
2642,6512,3981,2038.9,20389,20574,7.4,13,13,8,235,23.5,1,1,1,0,0,185,18.5,0,0,3,3,6.8,16593,13877,1387.7,-3981,-6512,1
2643,904,164,1678.9,16789,18276,7.0,6,6,5,233,23.3,0,0,0,1,1,234,23.4,1,4,5,5,6.8,18112,15885,1588.5,-164,-904,1
2644,5365,4901,2040.3,20403,20886,7.4,13,13,14,238,23.8,2,1,1,0,0,178,17.8,0,5,5,5,6.4,15985,15038,1503.8,-4901,-5365,1
2645,-1145,-2100,1531.8,15318,17867,7.0,2,2,2,219,21.9,0,0,1,0,0,261,26.1,1,1,5,5,7.4,19967,16463,1646.3,2100,1145,1
2646,-986,-1508,1518.0,15180,18148,7.0,2,2,3,225,22.5,1,0,1,0,1,235,23.5,1,3,4,4,7.6,19656,16166,1616.6,1508,986,1
2647,3719,1813,1820.0,18200,19337,7.2,8,8,11,218,21.8,1,1,1,0,0,214,21.4,0,1,3,3,6.8,17524,14481,1448.1,-1813,-3719,1
2648,-201,-1702,1564.6,15646,16889,6.6,5,5,5,186,18.6,0,0,1,0,1,247,24.7,2,2,5,5,7.2,18591,15847,1584.7,1702,201,0
2649,-1123,-1230,1574.7,15747,17503,6.8,5,5,6,192,19.2,0,0,1,0,1,227,22.7,1,6,7,7,7.0,18733,16870,1687.0,1230,1123,0
2650,-2440,-2239,1466.8,14668,16196,6.6,3,3,3,197,19.7,0,0,0,1,1,230,23.0,1,6,7,7,7.2,18435,17108,1710.8,2239,2440,0
2651,4787,4701,1931.8,19318,21508,7.8,8,8,7,257,25.7,1,0,1,0,1,230,23.0,1,1,3,3,6.6,16807,14531,1453.1,-4701,-4787,1
2652,851,709,1830.2,18302,19223,7.2,10,10,8,237,23.7,1,1,1,0,0,251,25.1,0,8,7,7,7.0,18514,17451,1745.1,-709,-851,1
2653,-1315,-1049,1516.7,15167,17584,7.0,5,5,6,200,20.0,1,1,0,1,0,222,22.2,0,8,6,6,7.0,18633,16482,1648.2,1049,1315,0
2654,-3277,-1680,1533.0,15330,16378,6.4,3,3,4,205,20.5,0,0,0,1,1,220,22.0,2,12,8,8,6.8,18058,18607,1860.7,1680,3277,0
2655,-1684,-772,1457.9,14579,17772,6.8,2,2,1,218,21.8,1,1,0,1,0,226,22.6,0,3,5,5,7.2,18544,16263,1626.3,772,1684,0
2656,-2330,-1189,1582.8,15828,16976,6.6,5,5,7,195,19.5,0,0,0,1,1,215,21.5,1,12,12,12,7.0,18165,18158,1815.8,1189,2330,0
2657,1510,151,1800.1,18001,18571,7.0,10,10,11,216,21.6,1,1,1,0,0,231,23.1,0,6,6,6,6.8,18420,16491,1649.1,-151,-1510,0
2658,2319,135,1730.5,17305,18581,7.2,5,5,4,246,24.6,0,0,1,0,1,217,21.7,1,2,4,4,7.0,18446,14986,1498.6,-135,-2319,0
2659,3787,2856,1870.6,18706,19465,7.2,11,11,10,243,24.3,1,0,1,0,0,202,20.2,0,4,4,4,6.8,16609,14919,1491.9,-2856,-3787,1
2660,-398,-1977,1693.9,16939,17715,6.8,7,7,6,223,22.3,0,0,0,1,1,202,20.2,1,8,9,9,7.2,19692,17337,1733.7,1977,398,0
2661,2864,1182,1764.5,17645,18081,7.0,5,5,5,224,22.4,2,1,1,0,0,207,20.7,0,3,3,3,6.6,16899,14781,1478.1,-1182,-2864,1
2662,-2993,-2498,1598.5,15985,17976,7.0,6,6,5,176,17.6,0,0,0,1,1,218,21.8,2,7,10,10,7.4,20474,18978,1897.8,2498,2993,0
2663,793,1612,1832.5,18325,19498,7.4,12,12,11,190,19.0,1,0,0,1,1,208,20.8,1,7,9,9,6.8,17886,17532,1753.2,-1612,-793,0
2664,284,681,1805.0,18050,18264,7.2,6,6,7,238,23.8,2,1,0,1,0,207,20.7,0,15,9,9,6.8,17583,17766,1776.6,-681,-284,1
2665,1139,1170,1858.5,18585,19498,7.2,11,11,12,221,22.1,1,1,0,1,0,218,21.8,0,9,9,9,7.0,18328,17446,1744.6,-1170,-1139,1
2666,-2901,-2666,1436.7,14367,16705,6.4,2,2,4,203,20.3,0,0,1,0,0,229,22.9,1,8,7,7,7.2,19371,17268,1726.8,2666,2901,0
2667,1323,457,1674.3,16743,18562,7.2,7,7,7,215,21.5,1,1,0,1,0,209,20.9,0,8,4,4,7.0,18105,15420,1542.0,-457,-1323,0
2668,535,776,1838.8,18388,18350,7.0,13,13,7,185,18.5,0,0,0,1,0,198,19.8,0,10,10,10,7.0,17574,17853,1785.3,-776,-535,1
2669,-682,-323,1571.0,15710,17789,6.8,4,4,3,242,24.2,0,0,1,0,1,227,22.7,1,4,5,5,6.8,18112,16392,1639.2,323,682,0
2670,1702,1352,1727.5,17275,19289,7.2,6,6,10,241,24.1,0,0,1,0,1,234,23.4,1,4,4,4,6.8,17937,15573,1557.3,-1352,-1702,0
2671,-389,329,1662.3,16623,17503,6.8,7,7,9,206,20.6,1,0,0,1,1,225,22.5,1,10,8,8,6.8,17174,17012,1701.2,-329,389,0
2672,3250,3073,1740.2,17402,19869,7.2,6,6,6,262,26.2,1,1,0,1,0,232,23.2,0,1,1,1,6.4,16796,14152,1415.2,-3073,-3250,1
2673,2678,3150,1755.5,17555,20887,7.8,7,7,6,248,24.8,2,1,0,1,0,200,20.0,0,3,3,3,7.0,17737,14877,1487.7,-3150,-2678,1
2674,-2262,-668,1495.2,14952,17963,6.8,2,2,3,264,26.4,0,0,1,0,0,244,24.4,0,4,8,8,7.4,18631,17214,1721.4,668,2262,1
2675,-1796,-2222,1548.7,15487,14798,6.0,6,6,6,187,18.7,0,0,1,0,0,213,21.3,0,7,9,9,6.8,17020,17283,1728.3,2222,1796,0
2676,3827,3161,1835.1,18351,19217,7.4,7,7,6,222,22.2,0,0,1,0,1,201,20.1,1,3,3,3,6.4,16056,14524,1452.4,-3161,-3827,1
2677,-5533,-4951,1379.7,13797,15622,6.2,1,1,1,173,17.3,0,0,0,1,1,256,25.6,2,10,9,9,7.4,20573,19330,1933.0,4951,5533,0
2678,-602,-905,1624.1,16241,18124,7.2,6,6,3,238,23.8,0,0,1,0,0,232,23.2,0,5,7,7,7.2,19029,16843,1684.3,905,602,1
2679,1525,873,1706.5,17065,19124,7.4,6,6,5,257,25.7,0,0,0,1,1,189,18.9,2,5,5,5,7.0,18251,15540,1554.0,-873,-1525,1
2680,5109,3009,1860.9,18609,19904,7.2,8,8,6,244,24.4,0,0,1,0,1,216,21.6,1,0,0,0,6.6,16895,13500,1350.0,-3009,-5109,1
2681,656,-718,1625.9,16259,16785,6.8,8,8,8,171,17.1,1,1,0,1,0,230,23.0,1,3,5,5,6.8,17503,15603,1560.3,718,-656,1
2682,1886,460,1785.8,17858,18694,7.2,8,8,6,267,26.7,1,1,1,0,0,219,21.9,0,4,4,4,7.0,18234,15972,1597.2,-460,-1886,0
2683,982,1653,1905.5,19055,18944,7.0,12,12,12,225,22.5,0,0,1,0,1,188,18.8,2,8,7,7,6.6,17291,18073,1807.3,-1653,-982,1
2684,-414,-47,1721.7,17217,18214,7.2,8,8,10,185,18.5,2,1,0,1,0,198,19.8,0,3,7,7,7.0,18261,17631,1763.1,47,414,1
2685,356,122,1609.1,16091,18518,7.0,6,6,7,238,23.8,0,0,0,1,1,217,21.7,1,4,4,4,7.0,18396,15735,1573.5,-122,-356,0
2686,-516,-4,1717.4,17174,17921,6.8,8,8,13,244,24.4,1,1,0,1,0,183,18.3,0,13,10,10,6.8,17925,17690,1769.0,4,516,0
2687,-2212,-2725,1496.1,14961,16723,6.6,3,3,2,220,22.0,1,1,1,0,0,235,23.5,0,5,7,7,7.4,19448,17173,1717.3,2725,2212,0
2688,-923,-803,1607.6,16076,16620,6.8,7,7,8,187,18.7,0,0,1,0,1,197,19.7,1,11,9,9,6.8,17423,16999,1699.9,803,923,1
2689,-1798,-1804,1590.5,15905,17772,6.8,5,5,3,203,20.3,0,0,0,1,1,218,21.8,1,5,9,9,7.0,19576,17703,1770.3,1804,1798,0
2690,-3996,-3131,1507.5,15075,16260,6.4,6,6,7,179,17.9,1,0,1,0,1,210,21.0,1,11,10,10,7.4,19391,19071,1907.1,3131,3996,0
2691,259,-527,1671.1,16711,17570,6.6,7,7,9,207,20.7,0,0,0,1,0,221,22.1,0,3,6,6,6.8,18097,16452,1645.2,527,-259,1
2692,3058,1096,1737.1,17371,17488,6.6,7,7,11,209,20.9,0,0,1,0,0,230,23.0,0,2,2,2,6.6,16392,14313,1431.3,-1096,-3058,0
2693,-937,-89,1553.7,15537,18851,7.0,3,3,5,231,23.1,0,0,0,1,1,251,25.1,1,5,4,4,7.2,18940,16474,1647.4,89,937,0
2694,-5551,-2712,1375.1,13751,15189,6.2,2,2,2,183,18.3,0,0,1,0,1,201,20.1,1,15,12,12,6.8,17901,19302,1930.2,2712,5551,0
2695,4662,2019,1888.8,18888,18408,7.2,8,8,10,232,23.2,0,0,1,0,0,207,20.7,0,1,1,1,6.6,16389,14226,1422.6,-2019,-4662,1
2696,-5812,-5009,1396.2,13962,15298,6.4,3,3,2,192,19.2,0,0,0,1,1,225,22.5,2,7,11,11,7.4,20307,19774,1977.4,5009,5812,0
2697,-63,-779,1669.7,16697,18216,7.0,5,5,4,214,21.4,0,0,0,1,1,219,21.9,1,4,8,8,7.2,18995,16760,1676.0,779,63,1
2698,-1110,-391,1581.5,15815,18069,7.2,4,4,3,245,24.5,2,1,1,0,0,229,22.9,0,10,8,8,7.0,18460,16925,1692.5,391,1110,0
2699,1604,1599,1704.7,17047,19108,7.2,6,6,5,260,26.0,0,0,0,1,1,209,20.9,1,5,4,4,6.8,17509,15443,1544.3,-1599,-1604,1
2700,-3673,-3603,1511.8,15118,16774,6.6,5,5,2,214,21.4,0,0,0,1,1,206,20.6,2,11,13,13,7.4,20377,18791,1879.1,3603,3673,0
2701,-2257,-2894,1603.5,16035,17041,6.6,6,6,7,196,19.6,0,0,1,0,1,230,23.0,1,5,9,9,7.4,19935,18292,1829.2,2894,2257,0
2702,195,428,1622.5,16225,17748,6.8,8,8,7,179,17.9,1,1,1,0,0,239,23.9,0,4,3,3,6.6,17320,16030,1603.0,-428,-195,1
2703,6,205,1503.3,15033,18279,6.8,3,3,4,211,21.1,1,1,0,1,0,221,22.1,0,2,2,2,7.2,18074,15027,1502.7,-205,-6,0
2704,-574,-1413,1706.4,17064,16813,6.6,8,8,11,185,18.5,1,0,1,0,1,217,21.7,1,14,10,10,6.8,18226,17638,1763.8,1413,574,0
2705,468,302,1804.3,18043,17743,6.8,13,13,12,186,18.6,1,1,0,1,0,219,21.9,0,9,8,8,6.8,17441,17575,1757.5,-302,-468,0
2706,-152,713,1571.0,15710,18847,7.2,5,5,7,239,23.9,1,0,0,1,1,218,21.8,1,5,4,4,7.0,18134,15862,1586.2,-713,152,0
2707,3460,2275,1747.6,17476,19471,7.2,6,6,7,226,22.6,0,0,1,0,1,242,24.2,1,0,0,0,6.8,17196,14016,1401.6,-2275,-3460,0
2708,-2556,-325,1474.5,14745,17469,6.8,1,1,1,236,23.6,0,0,1,0,0,238,23.8,0,9,7,7,7.0,17794,17301,1730.1,325,2556,1
2709,-1558,-500,1605.2,16052,17653,7.0,6,6,8,221,22.1,1,1,1,0,0,212,21.2,0,9,9,9,7.0,18153,17610,1761.0,500,1558,0
2710,4780,2748,1888.8,18888,18447,7.2,10,10,14,242,24.2,1,1,1,0,0,203,20.3,0,2,2,2,6.4,15699,14108,1410.8,-2748,-4780,1
2711,-2523,-732,1542.3,15423,18610,7.2,3,3,5,241,24.1,0,0,0,1,1,248,24.8,1,7,7,7,7.4,19342,17946,1794.6,732,2523,0
2712,-2390,-2971,1592.7,15927,15756,6.6,7,7,6,192,19.2,1,1,1,0,0,219,21.9,0,13,7,7,7.2,18727,18317,1831.7,2971,2390,0
2713,-1578,-598,1596.7,15967,16964,6.4,5,5,3,223,22.3,0,0,0,1,1,206,20.6,2,10,8,8,7.0,17562,17545,1754.5,598,1578,0
2714,2558,2349,1992.9,19929,20672,7.6,13,13,13,224,22.4,1,1,1,0,0,208,20.8,0,14,9,9,7.2,18323,17371,1737.1,-2349,-2558,1
2715,-146,557,1611.0,16110,18673,7.0,5,5,7,222,22.2,0,0,1,0,0,217,21.7,0,7,5,5,7.0,18116,16256,1625.6,-557,146,0
2716,1564,86,1763.1,17631,18106,7.0,9,9,9,214,21.4,0,0,0,1,0,193,19.3,0,7,8,8,7.0,18020,16067,1606.7,-86,-1564,1
2717,1260,1487,1633.7,16337,18992,7.0,4,4,4,251,25.1,2,1,0,1,0,204,20.4,0,2,4,4,6.8,17505,15077,1507.7,-1487,-1260,1
2718,1722,1857,1669.3,16693,18416,7.0,6,6,8,240,24.0,1,1,1,0,0,193,19.3,0,2,5,5,6.6,16559,14971,1497.1,-1857,-1722,1
2719,1111,26,1833.4,18334,19247,7.4,5,5,7,231,23.1,2,1,1,0,0,240,24.0,0,7,7,7,7.4,19221,17223,1722.3,-26,-1111,1
2720,-3174,-1926,1464.1,14641,16376,6.6,4,4,7,171,17.1,1,0,0,1,1,194,19.4,1,14,9,9,7.0,18302,17815,1781.5,1926,3174,1
2721,-1333,-1832,1452.4,14524,17686,6.8,2,2,2,214,21.4,0,0,1,0,0,260,26.0,0,2,4,4,7.0,19518,15857,1585.7,1832,1333,0
2722,1039,-79,1611.1,16111,16723,6.4,6,6,10,219,21.9,0,0,0,1,1,213,21.3,1,3,5,5,6.8,16802,15072,1507.2,79,-1039,0
2723,-3712,-3375,1528.4,15284,17637,7.0,3,3,4,207,20.7,1,0,0,1,1,246,24.6,1,6,9,9,7.6,21012,18996,1899.6,3375,3712,0
2724,-1699,-364,1410.7,14107,17015,6.6,2,2,1,180,18.0,1,1,0,1,0,220,22.0,0,10,6,6,6.8,17379,15806,1580.6,364,1699,1
2725,629,753,1715.2,17152,18219,6.8,7,7,7,223,22.3,0,0,0,1,1,212,21.2,1,9,7,7,6.8,17466,16523,1652.3,-753,-629,1
2726,-2344,-1592,1602.5,16025,16142,6.4,7,7,8,197,19.7,0,0,1,0,0,211,21.1,1,7,9,9,6.8,17734,18369,1836.9,1592,2344,1
2727,-27,281,1513.0,15130,18930,7.2,2,2,2,234,23.4,2,1,1,0,0,250,25.0,0,3,3,3,7.4,18649,15157,1515.7,-281,27,1
2728,-30,-965,1623.0,16230,16813,6.6,7,7,11,181,18.1,0,0,0,1,0,231,23.1,0,5,5,5,6.8,17778,16260,1626.0,965,30,0
2729,-211,320,1611.3,16113,17158,6.8,7,7,4,205,20.5,0,0,0,1,1,191,19.1,1,9,7,7,6.6,16838,16324,1632.4,-320,211,0
2730,-614,-846,1739.4,17394,18046,7.0,10,10,8,195,19.5,1,1,1,0,0,187,18.7,0,8,9,9,7.0,18892,18008,1800.8,846,614,0
2731,-4410,-4163,1380.3,13803,16366,6.6,2,2,0,203,20.3,1,1,1,0,0,236,23.6,1,3,9,9,7.4,20529,18213,1821.3,4163,4410,0
2732,-4054,-3806,1389.3,13893,15277,6.4,3,3,2,171,17.1,0,0,1,0,1,218,21.8,2,11,9,9,7.0,19083,17947,1794.7,3806,4054,0
2733,-77,260,1631.2,16312,18684,7.0,5,5,5,239,23.9,0,0,1,0,1,230,23.0,1,11,6,6,7.0,18424,16389,1638.9,-260,77,0
2734,2002,1791,1820.5,18205,18119,7.0,11,11,15,207,20.7,1,1,1,0,0,208,20.8,0,9,6,6,6.4,16328,16203,1620.3,-1791,-2002,1
2735,-94,-844,1648.4,16484,17799,6.6,5,5,6,242,24.2,1,1,0,1,0,201,20.1,0,7,7,7,7.0,18643,16578,1657.8,844,94,1
2736,171,807,1666.1,16661,18206,7.0,6,6,10,233,23.3,0,0,1,0,0,229,22.9,0,10,8,8,7.0,17399,16490,1649.0,-807,-171,0
2737,-2099,-1505,1538.1,15381,16749,6.4,5,5,7,202,20.2,0,0,0,1,1,206,20.6,1,15,10,10,7.0,18254,17480,1748.0,1505,2099,0
2738,3274,1603,1923.4,19234,17699,6.8,13,13,14,179,17.9,2,1,1,0,0,206,20.6,0,6,6,6,6.4,16096,15960,1596.0,-1603,-3274,0
2739,4553,3000,1935.0,19350,19830,7.4,11,11,14,234,23.4,0,0,0,1,0,208,20.8,0,2,4,4,6.4,16830,14797,1479.7,-3000,-4553,1
2740,760,120,1738.9,17389,19074,7.4,5,5,3,224,22.4,1,0,1,0,1,235,23.5,1,6,6,6,7.2,18954,16629,1662.9,-120,-760,0
2741,611,-139,1613.8,16138,16973,6.6,8,8,9,195,19.5,1,1,1,0,0,215,21.5,0,5,6,6,6.8,17112,15527,1552.7,139,-611,0
2742,356,58,1527.1,15271,18182,7.0,3,3,2,199,19.9,0,0,1,0,0,232,23.2,0,2,2,2,7.0,18124,14915,1491.5,-58,-356,1
2743,316,-1561,1758.4,17584,16118,6.4,10,10,7,159,15.9,0,0,1,0,0,202,20.2,0,8,9,9,6.6,17679,17268,1726.8,1561,-316,1
2744,1961,564,1729.7,17297,18369,7.0,8,8,10,211,21.1,0,0,1,0,1,211,21.1,1,5,4,4,6.8,17805,15336,1533.6,-564,-1961,0
2745,4282,1993,1769.3,17693,17892,6.8,9,9,14,201,20.1,1,1,0,1,0,149,14.9,0,1,3,3,6.6,15899,13411,1341.1,-1993,-4282,1
2746,-1323,-591,1470.3,14703,16749,6.6,4,4,5,232,23.2,0,0,1,0,0,191,19.1,0,15,7,7,6.8,17340,16026,1602.6,591,1323,1
2747,285,-352,1739.4,17394,18668,7.0,6,6,12,233,23.3,0,0,1,0,0,228,22.8,0,9,6,6,7.0,19020,17109,1710.9,352,-285,1
2748,-1292,-1426,1656.3,16563,17202,6.8,9,9,14,182,18.2,0,0,0,1,1,237,23.7,2,3,5,5,7.0,18628,17855,1785.5,1426,1292,0
2749,-375,-1283,1527.0,15270,17913,6.8,4,4,3,225,22.5,0,0,1,0,1,207,20.7,1,1,2,2,7.4,19196,15645,1564.5,1283,375,0
2750,-1198,-599,1490.6,14906,16779,6.6,3,3,3,195,19.5,0,0,0,1,0,250,25.0,0,1,6,6,6.8,17378,16104,1610.4,599,1198,0
2751,4784,3335,1908.5,19085,19432,7.2,14,14,8,226,22.6,1,1,1,0,0,178,17.8,0,2,3,3,6.2,16097,14301,1430.1,-3335,-4784,1
2752,-9,-307,1529.0,15290,17983,7.0,2,2,3,253,25.3,2,1,1,0,0,243,24.3,0,2,2,2,7.0,18290,15299,1529.9,307,9,1
2753,-2101,-2009,1555.7,15557,17145,6.6,4,4,7,212,21.2,0,0,1,0,1,249,24.9,2,11,8,8,7.2,19154,17658,1765.8,2009,2101,0
2754,2789,3223,1731.8,17318,19714,7.4,8,8,7,244,24.4,1,1,0,1,0,203,20.3,0,2,3,3,6.4,16491,14529,1452.9,-3223,-2789,1
2755,117,-113,1635.9,16359,17684,7.0,7,7,5,219,21.9,0,0,1,0,1,229,22.9,1,7,6,6,6.8,17797,16242,1624.2,113,-117,0
2756,-3784,-3051,1472.2,14722,16433,6.4,3,3,4,218,21.8,0,0,0,1,1,239,23.9,1,12,8,8,7.2,19484,18506,1850.6,3051,3784,0
2757,-2930,-2300,1503.5,15035,15909,6.4,3,3,3,202,20.2,0,0,0,1,1,238,23.8,1,9,8,8,7.0,18209,17965,1796.5,2300,2930,0
2758,-3148,-2856,1466.3,14663,15958,6.4,2,2,2,228,22.8,0,0,0,1,1,215,21.5,1,13,9,9,7.2,18814,17811,1781.1,2856,3148,0
2759,-1471,-1204,1550.4,15504,17911,7.0,4,4,3,222,22.2,0,0,0,1,1,214,21.4,1,10,7,7,7.0,19115,16975,1697.5,1204,1471,0
2760,801,1090,1646.3,16463,18904,7.2,4,4,2,247,24.7,0,0,1,0,1,197,19.7,1,7,6,6,6.8,17814,15662,1566.2,-1090,-801,0
2761,45,1199,1700.9,17009,19047,7.2,7,7,6,241,24.1,0,0,0,1,0,211,21.1,0,9,8,8,7.0,17848,16964,1696.4,-1199,-45,1
2762,69,-552,1686.6,16866,17542,6.8,6,6,6,218,21.8,1,0,1,0,1,247,24.7,1,9,6,6,6.8,18094,16797,1679.7,552,-69,1
2763,1277,297,1698.2,16982,18435,7.0,6,6,4,242,24.2,0,0,1,0,1,218,21.8,1,4,3,3,6.8,18138,15705,1570.5,-297,-1277,0
2764,-4401,-3035,1505.1,15051,17568,6.8,3,3,5,211,21.1,0,0,0,1,0,239,23.9,0,12,12,12,7.6,20603,19452,1945.2,3035,4401,0
2765,3523,1757,1871.9,18719,19257,7.4,10,10,11,236,23.6,0,0,1,0,1,220,22.0,1,2,3,3,6.6,17500,15196,1519.6,-1757,-3523,0
2766,-3711,-2987,1554.1,15541,15120,6.2,7,7,11,180,18.0,0,0,0,1,0,207,20.7,0,16,13,13,7.0,18107,19252,1925.2,2987,3711,0
2767,2397,3292,2011.4,20114,19069,7.0,14,14,24,220,22.0,1,1,0,1,0,144,14.4,0,9,10,10,6.4,15777,17717,1771.7,-3292,-2397,1
2768,6281,4551,2017.3,20173,20931,7.4,10,10,8,248,24.8,1,0,1,0,1,204,20.4,1,0,3,3,6.6,16380,13892,1389.2,-4551,-6281,1
2769,-1004,-2008,1705.8,17058,16359,6.4,9,9,14,174,17.4,0,0,1,0,0,213,21.3,0,14,9,9,7.0,18367,18062,1806.2,2008,1004,0
2770,4027,701,1990.0,19900,17323,7.0,11,11,17,200,20.0,1,1,1,0,0,197,19.7,0,9,6,6,6.6,16622,15873,1587.3,-701,-4027,0
2771,-833,-1021,1553.6,15536,17751,6.8,5,5,5,179,17.9,1,1,1,0,0,240,24.0,1,6,6,6,7.2,18772,16369,1636.9,1021,833,1
2772,-2267,-2010,1594.6,15946,16743,6.8,5,5,5,208,20.8,0,0,1,0,1,227,22.7,1,14,11,11,7.0,18753,18213,1821.3,2010,2267,0
2773,4624,2511,2244.9,22449,19137,7.4,17,17,29,209,20.9,0,0,1,0,0,180,18.0,0,17,9,9,6.6,16626,17825,1782.5,-2511,-4624,1
2774,-3782,-3060,1508.7,15087,17017,6.6,6,6,8,177,17.7,0,0,0,1,1,245,24.5,1,10,9,9,7.4,20077,18869,1886.9,3060,3782,0
2775,-1134,-906,1463.2,14632,16037,6.4,3,3,6,198,19.8,0,0,1,0,0,223,22.3,1,5,4,4,6.8,16943,15766,1576.6,906,1134,1
2776,955,642,1688.3,16883,18957,7.2,8,8,4,215,21.5,1,1,1,0,0,206,20.6,0,5,6,6,7.0,18315,15928,1592.8,-642,-955,1
2777,-3882,-2253,1546.3,15463,16063,6.4,7,7,5,208,20.8,0,0,0,1,1,213,21.3,2,15,15,15,7.0,18316,19345,1934.5,2253,3882,0
2778,-811,1024,1615.8,16158,19418,7.4,5,5,6,175,17.5,0,0,1,0,1,232,23.2,2,2,4,4,7.2,18394,16969,1696.9,-1024,811,0
2779,-1755,-1014,1529.5,15295,16951,6.8,4,4,6,225,22.5,0,0,0,1,0,218,21.8,0,13,7,7,7.0,17965,17050,1705.0,1014,1755,1
2780,1499,2433,1754.0,17540,19850,7.4,8,8,5,232,23.2,1,0,1,0,0,187,18.7,0,4,6,6,7.0,17417,16041,1604.1,-2433,-1499,1
2781,3215,2650,1706.6,17066,20061,7.6,6,6,6,239,23.9,0,0,1,0,0,220,22.0,1,0,1,1,6.8,17411,13851,1385.1,-2650,-3215,1
2782,-1519,-1488,1611.0,16110,17732,6.8,5,5,6,245,24.5,0,0,0,1,1,228,22.8,1,10,5,5,7.2,19220,17629,1762.9,1488,1519,0
2783,2488,2913,1770.7,17707,18993,7.2,9,9,6,205,20.5,0,0,0,1,0,190,19.0,0,5,5,5,6.4,16080,15219,1521.9,-2913,-2488,1
2784,-667,1243,1646.1,16461,18295,7.0,6,6,5,173,17.3,1,0,0,1,0,224,22.4,0,9,7,7,6.6,17052,17128,1712.8,-1243,667,1
2785,-172,1254,1642.9,16429,18899,7.0,5,5,4,242,24.2,0,0,0,1,0,219,21.9,0,5,4,4,6.8,17645,16601,1660.1,-1254,172,0
2786,-1972,-1613,1549.5,15495,17827,7.0,3,3,3,226,22.6,1,1,1,0,0,233,23.3,0,9,7,7,7.2,19440,17467,1746.7,1613,1972,0
2787,-396,-1091,1587.5,15875,17873,7.0,4,4,4,235,23.5,1,1,1,0,0,210,21.0,0,6,5,5,7.2,18964,16271,1627.1,1091,396,0
2788,413,-857,1652.1,16521,17150,7.0,7,7,10,223,22.3,0,0,1,0,0,197,19.7,0,5,5,5,7.0,18007,16108,1610.8,857,-413,0
2789,439,751,1678.1,16781,18289,7.0,7,7,10,195,19.5,0,0,1,0,1,203,20.3,2,6,6,6,7.0,17538,16342,1634.2,-751,-439,1
2790,2329,2416,1774.8,17748,19278,7.2,10,10,12,175,17.5,0,0,0,1,0,218,21.8,1,4,4,4,6.6,16862,15419,1541.9,-2416,-2329,0
2791,-2746,-1939,1614.5,16145,17749,7.0,5,5,2,221,22.1,0,0,0,1,1,229,22.9,1,14,13,13,7.2,19688,18891,1889.1,1939,2746,0
2792,-964,-271,1504.9,15049,17845,6.8,3,3,3,200,20.0,0,0,0,1,1,196,19.6,2,4,6,6,7.0,18116,16013,1601.3,271,964,0
2793,2357,1436,1671.2,16712,17797,6.8,8,8,13,194,19.4,1,1,1,0,0,162,16.2,0,3,4,4,6.4,16361,14355,1435.5,-1436,-2357,1
2794,1016,310,1766.2,17662,19112,7.2,8,8,11,219,21.9,1,0,1,0,1,231,23.1,1,8,6,6,7.2,18802,16646,1664.6,-310,-1016,0
2795,-3960,-1446,1519.7,15197,17692,6.8,3,3,2,223,22.3,0,0,0,1,1,216,21.6,2,15,12,12,7.0,19138,19157,1915.7,1446,3960,0
2796,2547,2796,1760.4,17604,20758,7.4,6,6,6,248,24.8,1,1,1,0,0,195,19.5,0,2,3,3,6.6,17962,15057,1505.7,-2796,-2547,1
2797,-1294,-267,1743.1,17431,17722,6.8,10,10,7,202,20.2,0,0,0,1,0,195,19.5,0,20,12,12,6.8,17989,18725,1872.5,267,1294,0
2798,-3886,-3453,1434.6,14346,15676,6.4,2,2,2,200,20.0,0,0,0,1,1,220,22.0,1,10,11,11,7.2,19129,18232,1823.2,3453,3886,0
2799,3100,1006,1762.3,17623,17787,7.0,8,8,8,229,22.9,1,1,1,0,0,209,20.9,0,2,3,3,6.8,16781,14523,1452.3,-1006,-3100,0
2800,1874,1408,1868.3,18683,19031,7.2,8,8,8,218,21.8,1,0,0,1,1,215,21.5,1,8,8,8,6.8,17623,16809,1680.9,-1408,-1874,0
2801,246,-549,1556.1,15561,17448,6.8,4,4,5,226,22.6,1,1,0,1,0,228,22.8,0,1,4,4,7.0,17997,15315,1531.5,549,-246,1
2802,-347,393,1817.2,18172,18893,7.2,10,10,11,218,21.8,1,1,1,0,0,219,21.9,0,10,10,10,7.0,18500,18519,1851.9,-393,347,0
2803,1936,1799,1675.3,16753,17350,6.8,6,6,2,190,19.0,1,0,0,1,1,190,19.0,1,3,6,6,6.0,15551,14817,1481.7,-1799,-1936,1
2804,-966,111,1580.0,15800,17954,6.8,6,6,7,203,20.3,0,0,0,1,0,220,22.0,0,7,6,6,7.0,17843,16766,1676.6,-111,966,0
2805,-5423,-4119,1352.5,13525,15625,6.4,1,1,1,210,21.0,0,0,0,1,1,206,20.6,1,14,12,12,7.4,19744,18948,1894.8,4119,5423,0
2806,1234,962,1641.8,16418,19182,7.2,5,5,5,242,24.2,0,0,0,1,1,215,21.5,2,3,3,3,6.8,18220,15184,1518.4,-962,-1234,1
2807,-822,-592,1486.7,14867,18057,6.8,3,3,2,222,22.2,0,0,0,1,0,209,20.9,0,4,4,4,7.0,18649,15689,1568.9,592,822,0
2808,-3358,-2837,1428.8,14288,15711,6.4,1,1,0,237,23.7,0,0,0,1,1,240,24.0,1,6,8,8,7.2,18548,17646,1764.6,2837,3358,0
2809,-443,396,1610.6,16106,18229,6.8,6,6,7,216,21.6,1,0,0,1,1,240,24.0,1,6,5,5,7.0,17833,16549,1654.9,-396,443,1
2810,-466,608,1606.8,16068,17309,6.8,7,7,4,193,19.3,0,0,1,0,0,224,22.4,0,9,7,7,6.4,16701,16534,1653.4,-608,466,0
2811,-1192,-1896,1655.9,16559,18024,7.0,6,6,6,208,20.8,0,0,0,1,1,242,24.2,1,6,7,7,7.4,19920,17751,1775.1,1896,1192,1
2812,178,882,1638.8,16388,18495,7.0,5,5,5,256,25.6,1,1,0,1,0,216,21.6,1,5,5,5,6.8,17613,16210,1621.0,-882,-178,1
2813,-2035,-1237,1507.7,15077,17523,7.0,4,4,6,208,20.8,1,1,1,0,0,231,23.1,0,7,8,8,7.0,18760,17112,1711.2,1237,2035,1
2814,-4579,-3361,1510.6,15106,17144,6.8,2,2,2,237,23.7,0,0,0,1,1,246,24.6,2,7,7,7,7.4,20505,19685,1968.5,3361,4579,0
2815,77,-875,1656.9,16569,18534,7.0,4,4,6,228,22.8,0,0,0,1,1,246,24.6,1,6,5,5,7.2,19409,16492,1649.2,875,-77,0
2816,296,1370,1686.3,16863,18740,7.0,9,9,11,227,22.7,1,1,0,1,0,222,22.2,0,3,6,6,7.0,17370,16567,1656.7,-1370,-296,1
2817,-2171,-2897,1617.1,16171,16252,6.4,7,7,7,166,16.6,0,0,1,0,1,220,22.0,1,13,11,11,7.0,19149,18342,1834.2,2897,2171,0
2818,3370,2895,1714.9,17149,19250,7.0,7,7,12,216,21.6,1,1,1,0,0,209,20.9,0,0,1,1,6.4,16355,13779,1377.9,-2895,-3370,1
2819,1723,1090,1607.1,16071,17618,6.8,5,5,4,224,22.4,2,1,1,0,0,210,21.0,0,3,2,2,6.6,16528,14348,1434.8,-1090,-1723,1
2820,2759,980,1849.8,18498,18641,7.2,8,8,12,232,23.2,0,0,1,0,1,215,21.5,1,2,4,4,7.0,17661,15739,1573.9,-980,-2759,1
2821,-1703,-2550,1493.6,14936,16574,6.6,3,3,3,225,22.5,0,0,1,0,0,221,22.1,0,7,7,7,7.2,19124,16639,1663.9,2550,1703,0
2822,2699,1015,1890.1,18901,17651,7.0,12,12,17,210,21.0,1,1,1,0,0,203,20.3,0,8,6,6,6.6,16636,16202,1620.2,-1015,-2699,1
2823,2201,374,1637.2,16372,17187,6.8,6,6,6,191,19.1,0,0,1,0,0,187,18.7,0,2,3,3,6.8,16813,14171,1417.1,-374,-2201,1
2824,3136,1557,1795.9,17959,19184,7.2,10,10,11,222,22.2,1,1,1,0,0,221,22.1,0,1,3,3,6.8,17627,14823,1482.3,-1557,-3136,1
2825,-4982,-3368,1355.0,13550,16368,6.8,2,2,1,194,19.4,0,0,0,1,1,258,25.8,2,5,10,10,7.4,19736,18532,1853.2,3368,4982,0
2826,-953,-677,1576.7,15767,17903,7.0,4,4,4,233,23.3,1,0,0,1,0,226,22.6,0,8,8,8,7.0,18580,16720,1672.0,677,953,1
2827,777,977,1715.6,17156,19115,7.4,10,10,6,235,23.5,2,1,1,0,0,254,25.4,0,3,5,5,7.0,18138,16379,1637.9,-977,-777,1
2828,-5571,-2139,1380.2,13802,17008,6.8,2,2,2,202,20.2,0,0,0,1,1,247,24.7,2,16,12,12,7.2,19147,19373,1937.3,2139,5571,0
2829,-2098,-1464,1518.4,15184,15748,6.2,5,5,5,199,19.9,0,0,1,0,1,220,22.0,2,9,9,9,6.8,17212,17282,1728.2,1464,2098,0
2830,1916,1404,1592.3,15923,18062,7.0,3,3,3,248,24.8,1,1,1,0,0,193,19.3,1,3,3,3,6.8,16658,14007,1400.7,-1404,-1916,1
2831,712,1633,1522.2,15222,18238,7.0,4,4,3,228,22.8,1,0,1,0,1,198,19.8,1,5,4,4,6.8,16605,14510,1451.0,-1633,-712,1
2832,-1129,-1348,1485.6,14856,18155,6.8,2,2,1,240,24.0,0,0,0,1,1,225,22.5,1,4,4,4,7.4,19503,15985,1598.5,1348,1129,0
2833,-2735,-2136,1533.6,15336,16676,6.6,6,6,7,187,18.7,1,1,0,1,0,226,22.6,1,9,10,10,7.0,18812,18071,1807.1,2136,2735,0
2834,3096,2404,1848.8,18488,19504,7.4,10,10,15,224,22.4,1,1,0,1,0,210,21.0,0,2,3,3,6.8,17100,15392,1539.2,-2404,-3096,1
2835,-1058,-1404,1568.1,15681,16896,6.6,5,5,4,205,20.5,1,1,0,1,0,224,22.4,0,10,7,7,7.0,18300,16739,1673.9,1404,1058,1
2836,1075,525,1715.9,17159,18318,7.0,3,3,3,250,25.0,1,0,1,0,1,225,22.5,1,7,5,5,7.0,17793,16084,1608.4,-525,-1075,0
2837,-531,28,1522.1,15221,17841,6.8,3,3,2,218,21.8,0,0,0,1,1,240,24.0,1,6,5,5,7.0,17813,15752,1575.2,-28,531,1
2838,409,-292,1674.6,16746,17772,6.8,8,8,10,188,18.8,0,0,1,0,1,216,21.6,1,8,7,7,7.0,18064,16337,1633.7,292,-409,0
2839,517,-151,1823.5,18235,17856,6.8,6,6,8,229,22.9,0,0,1,0,0,213,21.3,1,11,8,8,6.8,18007,17718,1771.8,151,-517,0
2840,-17,-514,1651.4,16514,18012,6.8,5,5,5,244,24.4,0,0,1,0,1,209,20.9,1,10,7,7,7.0,18526,16531,1653.1,514,17,1
2841,1399,1293,1734.6,17346,16570,6.8,8,8,14,191,19.1,0,0,1,0,0,193,19.3,0,14,8,8,6.2,15277,15947,1594.7,-1293,-1399,0
2842,-1278,-1387,1483.8,14838,16485,6.8,3,3,5,208,20.8,1,0,1,0,0,221,22.1,0,9,5,5,7.0,17872,16116,1611.6,1387,1278,0
2843,-3385,-2781,1447.1,14471,17643,7.0,3,3,4,208,20.8,0,0,0,1,1,223,22.3,1,8,9,9,7.4,20424,17856,1785.6,2781,3385,0
2844,136,365,1621.4,16214,18849,7.2,5,5,5,225,22.5,1,1,1,0,0,236,23.6,1,2,2,2,7.0,18484,16078,1607.8,-365,-136,1
2845,1339,1176,1783.9,17839,18405,7.0,8,8,12,217,21.7,2,1,0,1,0,212,21.2,0,5,5,5,6.6,17229,16500,1650.0,-1176,-1339,0
2846,2521,3096,1767.4,17674,19752,7.2,6,6,7,225,22.5,1,0,1,0,0,217,21.7,0,8,5,5,6.6,16656,15153,1515.3,-3096,-2521,1
2847,4255,2387,1900.8,19008,18920,7.4,11,11,13,206,20.6,0,0,1,0,0,202,20.2,0,1,3,3,6.6,16533,14753,1475.3,-2387,-4255,1
2848,-302,764,1580.0,15800,19395,7.4,4,4,6,231,23.1,0,0,0,1,0,236,23.6,0,4,4,4,7.2,18631,16102,1610.2,-764,302,1
2849,-2741,-425,1622.5,16225,17831,7.0,6,6,3,203,20.3,0,0,0,1,1,220,22.0,1,16,11,11,7.0,18256,18966,1896.6,425,2741,0
2850,3675,2389,1823.7,18237,18102,7.0,8,8,8,230,23.0,2,1,1,0,0,170,17.0,0,4,3,3,6.0,15713,14562,1456.2,-2389,-3675,1
2851,46,-1299,1651.2,16512,17751,6.8,6,6,5,225,22.5,1,1,0,1,0,232,23.2,0,8,6,6,7.2,19050,16466,1646.6,1299,-46,0
2852,1071,107,1747.8,17478,18671,7.2,9,9,17,257,25.7,1,1,1,0,0,274,27.4,1,1,3,3,7.0,18564,16407,1640.7,-107,-1071,1
2853,-427,1475,1580.4,15804,18768,7.2,3,3,2,222,22.2,2,1,0,1,0,217,21.7,0,10,6,6,6.6,17293,16231,1623.1,-1475,427,1
2854,1184,1807,1615.8,16158,17789,6.8,7,7,6,224,22.4,2,1,0,1,0,177,17.7,0,3,5,5,6.6,15982,14974,1497.4,-1807,-1184,0
2855,56,-694,1579.9,15799,17703,7.0,5,5,7,225,22.5,0,0,0,1,1,208,20.8,1,4,5,5,7.2,18397,15743,1574.3,694,-56,0
2856,2201,615,1887.6,18876,18843,7.0,9,9,12,235,23.5,0,0,0,1,1,196,19.6,1,7,5,5,7.0,18228,16675,1667.5,-615,-2201,1
2857,-610,-1156,1519.3,15193,17619,7.0,2,2,1,252,25.2,0,0,1,0,1,215,21.5,1,6,4,4,7.4,18775,15803,1580.3,1156,610,0
2858,3974,2785,1952.8,19528,19755,7.4,8,8,8,257,25.7,2,1,1,0,0,220,22.0,0,5,4,4,6.8,16970,15554,1555.4,-2785,-3974,1
2859,118,299,1759.7,17597,18452,7.2,7,7,6,244,24.4,1,1,0,1,0,224,22.4,0,7,7,7,7.0,18153,17479,1747.9,-299,-118,0
2860,955,748,1649.5,16495,18518,7.0,5,5,3,230,23.0,0,0,0,1,0,164,16.4,0,6,6,6,6.8,17770,15540,1554.0,-748,-955,0
2861,-686,-893,1604.2,16042,18424,7.0,5,5,3,238,23.8,0,0,1,0,1,216,21.6,2,4,8,8,7.2,19317,16728,1672.8,893,686,0
2862,-1086,-637,1563.6,15636,17293,6.8,3,3,3,220,22.0,1,1,0,1,0,216,21.6,1,10,5,5,7.0,17930,16722,1672.2,637,1086,1
2863,2411,875,1906.3,19063,19391,7.2,11,11,11,237,23.7,1,0,1,0,1,221,22.1,1,5,7,7,7.2,18516,16652,1665.2,-875,-2411,1
2864,5337,3334,1896.3,18963,19079,7.4,11,11,20,239,23.9,0,0,1,0,1,179,17.9,1,2,2,2,6.6,15745,13626,1362.6,-3334,-5337,1
2865,2040,725,1839.1,18391,17080,6.6,9,9,9,183,18.3,0,0,1,0,0,203,20.3,1,3,5,5,6.6,16355,16351,1635.1,-725,-2040,1
2866,-2139,868,1549.2,15492,17768,7.0,3,3,5,245,24.5,1,0,0,1,1,195,19.5,1,12,9,9,6.6,16900,17631,1763.1,-868,2139,0
2867,-1231,-888,1614.2,16142,16958,6.8,5,5,6,230,23.0,2,1,1,0,0,221,22.1,0,11,9,9,6.8,17846,17373,1737.3,888,1231,0
2868,1947,1677,1692.6,16926,19020,7.2,6,6,4,229,22.9,1,0,0,1,1,230,23.0,1,1,4,4,6.8,17343,14979,1497.9,-1677,-1947,1
2869,653,-556,1551.7,15517,16917,6.6,4,4,7,231,23.1,0,0,1,0,1,226,22.6,1,1,3,3,6.6,17473,14864,1486.4,556,-653,0
2870,-1149,-1888,1692.9,16929,17547,7.0,7,7,7,228,22.8,0,0,1,0,0,232,23.2,0,7,9,9,7.2,19435,18078,1807.8,1888,1149,1
2871,-911,-870,1509.4,15094,16864,6.6,3,3,3,237,23.7,1,1,0,1,0,204,20.4,0,7,6,6,6.8,17734,16005,1600.5,870,911,0
2872,-4752,-2451,1460.4,14604,15280,6.2,5,5,6,146,14.6,1,1,0,1,0,210,21.0,0,11,10,10,6.8,17731,19356,1935.6,2451,4752,0
2873,296,440,1526.8,15268,18685,7.2,1,1,1,269,26.9,1,0,1,0,1,251,25.1,1,0,0,0,7.2,18245,14972,1497.2,-440,-296,1
2874,1163,-539,1631.7,16317,16936,6.8,6,6,9,210,21.0,0,0,0,1,1,241,24.1,1,1,4,4,6.8,17475,15154,1515.4,539,-1163,1
2875,-1672,-470,1542.6,15426,18766,7.2,3,3,4,212,21.2,0,0,0,1,1,259,25.9,1,6,6,6,7.2,19236,17098,1709.8,470,1672,0
2876,-2502,-3183,1405.2,14052,16542,6.6,0,0,0,229,22.9,0,0,0,1,0,249,24.9,0,4,4,4,7.0,19725,16554,1655.4,3183,2502,0
2877,-1833,-917,1536.9,15369,17402,6.8,6,6,4,200,20.0,0,0,0,1,1,245,24.5,1,4,7,7,7.0,18319,17202,1720.2,917,1833,1
2878,531,-881,1696.1,16961,17237,6.6,9,9,8,191,19.1,0,0,1,0,1,198,19.8,1,13,6,6,7.2,18118,16430,1643.0,881,-531,0
2879,3710,2326,1817.7,18177,19922,7.4,8,8,9,256,25.6,1,1,1,0,0,226,22.6,0,2,1,1,7.0,17596,14467,1446.7,-2326,-3710,1
2880,675,691,1732.9,17329,17577,6.8,9,9,10,223,22.3,0,0,0,1,1,227,22.7,2,6,7,7,6.8,16886,16654,1665.4,-691,-675,1
2881,2783,2368,1916.1,19161,18599,7.0,13,13,13,232,23.2,1,1,1,0,0,195,19.5,0,3,7,7,6.8,16231,16378,1637.8,-2368,-2783,1
2882,-1945,-2496,1464.9,14649,15693,6.6,3,3,3,200,20.0,0,0,0,1,1,216,21.6,1,7,6,6,7.0,18189,16594,1659.4,2496,1945,0
2883,183,-231,1536.7,15367,18723,7.0,2,2,2,238,23.8,0,0,0,1,1,233,23.3,2,2,2,2,7.2,18954,15184,1518.4,231,-183,1
2884,960,813,1622.9,16229,18834,7.2,4,4,4,247,24.7,1,1,1,0,0,201,20.1,0,5,5,5,6.8,18021,15269,1526.9,-813,-960,0
2885,1191,-311,1725.8,17258,18225,7.0,6,6,8,239,23.9,2,1,1,0,0,213,21.3,0,5,6,6,6.8,18536,16067,1606.7,311,-1191,0
2886,8450,6098,2217.7,22177,21202,7.8,13,13,15,230,23.0,1,1,1,0,0,201,20.1,1,2,1,1,6.2,15104,13727,1372.7,-6098,-8450,1
2887,-305,685,1800.4,18004,20025,7.4,9,9,12,251,25.1,0,0,0,1,1,249,24.9,1,8,8,8,7.2,19340,18309,1830.9,-685,305,0
2888,6487,4018,2056.7,20567,19536,7.4,15,15,14,221,22.1,2,1,1,0,0,197,19.7,0,1,3,3,6.2,15518,14080,1408.0,-4018,-6487,1
2889,-1213,-1099,1665.0,16650,17869,7.2,7,7,7,212,21.2,0,0,0,1,1,229,22.9,1,6,8,8,7.2,18968,17863,1786.3,1099,1213,0
2890,-3673,-2499,1471.0,14710,17302,6.8,2,2,2,231,23.1,0,0,0,1,1,225,22.5,2,7,6,6,7.4,19801,18383,1838.3,2499,3673,0
2891,-2109,-1475,1544.2,15442,17224,6.6,3,3,5,237,23.7,0,0,0,1,1,233,23.3,1,10,7,7,7.2,18699,17551,1755.1,1475,2109,0
2892,1219,1356,1892.3,18923,20387,7.4,10,10,7,241,24.1,0,0,0,1,1,207,20.7,1,8,7,7,7.0,19031,17704,1770.4,-1356,-1219,0
2893,-1905,-2223,1478.3,14783,15957,6.2,3,3,2,206,20.6,0,0,1,0,1,224,22.4,1,5,8,8,7.0,18180,16688,1668.8,2223,1905,0
2894,2170,1207,1807.4,18074,16950,6.8,12,12,17,211,21.1,0,0,0,1,1,188,18.8,1,11,7,7,6.4,15743,15904,1590.4,-1207,-2170,1
2895,620,146,1768.4,17684,19834,7.4,9,9,8,224,22.4,1,1,0,1,0,197,19.7,1,5,7,7,7.2,19688,17064,1706.4,-146,-620,1
2896,-1972,-1621,1547.6,15476,16908,6.8,5,5,4,184,18.4,0,0,0,1,1,213,21.3,2,10,8,8,7.2,18529,17448,1744.8,1621,1972,0
2897,1530,2220,1762.2,17622,19988,7.2,8,8,6,252,25.2,2,1,1,0,0,239,23.9,0,9,5,5,7.0,17768,16092,1609.2,-2220,-1530,0
2898,1163,-1176,1638.5,16385,16580,6.6,6,6,6,208,20.8,1,1,1,0,0,194,19.4,1,4,4,4,6.8,17756,15222,1522.2,1176,-1163,1
2899,-2619,-1506,1442.5,14425,16191,6.6,3,3,5,198,19.8,0,0,0,1,1,212,21.2,1,9,8,8,6.6,17697,17044,1704.4,1506,2619,0
2900,584,1023,1605.9,16059,18356,7.2,6,6,3,212,21.2,0,0,1,0,0,207,20.7,0,8,5,5,6.8,17333,15475,1547.5,-1023,-584,1
2901,2910,856,1863.3,18633,18698,7.0,9,9,13,246,24.6,0,0,1,0,1,226,22.6,1,4,3,3,6.8,17842,15723,1572.3,-856,-2910,1
2902,-1057,-1798,1573.1,15731,17150,6.6,3,3,2,251,25.1,0,0,0,1,1,220,22.0,1,9,6,6,7.2,18948,16788,1678.8,1798,1057,0
2903,-50,563,1737.1,17371,18243,7.0,7,7,9,227,22.7,0,0,1,0,1,222,22.2,1,9,8,8,6.8,17680,17421,1742.1,-563,50,1
2904,-2084,-2025,1563.1,15631,15075,6.4,5,5,9,199,19.9,0,0,1,0,1,165,16.5,2,11,12,12,7.0,17100,17715,1771.5,2025,2084,0
2905,469,1328,1693.5,16935,18740,7.0,8,8,4,210,21.0,0,0,0,1,0,212,21.2,0,12,7,7,7.0,17412,16466,1646.6,-1328,-469,1
2906,-293,-818,1663.9,16639,18068,6.8,7,7,6,214,21.4,0,0,0,1,1,232,23.2,1,5,7,7,7.2,18886,16932,1693.2,818,293,1
2907,1031,1909,1673.8,16738,19318,7.4,7,7,6,219,21.9,0,0,0,1,1,218,21.8,1,1,3,3,7.0,17409,15707,1570.7,-1909,-1031,1
2908,-726,-1168,1541.9,15419,18138,6.8,3,3,4,251,25.1,0,0,1,0,1,236,23.6,2,4,4,4,7.4,19306,16145,1614.5,1168,726,0
2909,-2511,-2094,1475.2,14752,16831,6.8,4,4,2,209,20.9,2,1,0,1,0,242,24.2,0,10,8,8,7.4,18925,17263,1726.3,2094,2511,1
2910,489,-1163,1650.8,16508,18227,7.0,6,6,7,204,20.4,0,0,1,0,0,235,23.5,1,5,4,4,7.2,19390,16019,1601.9,1163,-489,0
2911,-999,-955,1654.4,16544,16885,6.8,6,6,8,223,22.3,0,0,0,1,1,221,22.1,1,9,10,10,6.8,17840,17543,1754.3,955,999,0
2912,-1366,-242,1559.7,15597,18695,7.0,4,4,3,238,23.8,0,0,0,1,1,266,26.6,1,3,5,5,7.2,18937,16963,1696.3,242,1366,1
2913,2958,983,1802.2,18022,18610,7.0,8,8,14,242,24.2,1,1,1,0,0,226,22.6,0,2,3,3,7.0,17627,15064,1506.4,-983,-2958,0
2914,-3095,-2200,1571.4,15714,17362,6.8,5,5,5,208,20.8,1,1,1,0,0,244,24.4,0,12,10,10,7.2,19562,18809,1880.9,2200,3095,0
2915,709,1449,1621.9,16219,17966,7.2,7,7,9,197,19.7,0,0,0,1,1,199,19.9,1,5,5,5,6.4,16517,15510,1551.0,-1449,-709,0
2916,-540,238,1695.6,16956,17632,6.8,9,9,8,219,21.9,0,0,0,1,0,205,20.5,0,8,8,8,6.8,17394,17496,1749.6,-238,540,0
2917,5041,3996,1928.0,19280,20813,7.6,11,11,9,252,25.2,1,1,1,0,0,215,21.5,0,3,2,2,6.8,16817,14239,1423.9,-3996,-5041,1
2918,1714,1487,1954.0,19540,18969,7.2,10,10,22,247,24.7,0,0,0,1,0,211,21.1,1,8,8,8,7.0,17482,17826,1782.6,-1487,-1714,1
2919,-844,139,1603.8,16038,19227,7.2,5,5,7,228,22.8,0,0,0,1,1,226,22.6,1,5,5,5,7.2,19088,16882,1688.2,-139,844,1
2920,1737,1565,1659.4,16594,20008,7.4,5,5,5,227,22.7,1,1,1,0,0,217,21.7,0,3,2,2,7.0,18443,14857,1485.7,-1565,-1737,1
2921,109,66,1604.0,16040,17545,7.0,4,4,6,214,21.4,0,0,0,1,1,221,22.1,1,6,6,6,6.8,17479,15931,1593.1,-66,-109,1
2922,686,-89,1628.2,16282,16565,6.8,7,7,8,211,21.1,1,1,1,0,0,180,18.0,1,6,7,7,6.6,16654,15596,1559.6,89,-686,1
2923,-1537,93,1552.7,15527,17554,6.8,4,4,7,202,20.2,0,0,0,1,1,216,21.6,2,5,6,6,6.8,17461,17064,1706.4,-93,1537,0
2924,-1790,-1980,1593.3,15933,16916,6.8,7,7,4,221,22.1,0,0,0,1,1,223,22.3,1,10,9,9,7.2,18896,17723,1772.3,1980,1790,0
2925,1044,662,1707.0,17070,17907,7.0,6,6,9,208,20.8,0,0,0,1,0,208,20.8,0,8,6,6,7.0,17245,16026,1602.6,-662,-1044,0
2926,-1302,1008,1508.4,15084,19173,7.2,3,3,0,224,22.4,0,0,0,1,1,226,22.6,1,5,4,4,7.0,18165,16386,1638.6,-1008,1302,0
2927,1627,1723,1660.0,16600,18932,7.2,8,8,10,192,19.2,0,0,0,1,1,194,19.4,1,2,4,4,6.6,17209,14973,1497.3,-1723,-1627,0
2928,-2221,-365,1598.2,15982,18257,6.6,6,6,7,186,18.6,0,0,0,1,0,219,21.9,0,15,8,8,7.2,18622,18203,1820.3,365,2221,1
2929,-1874,-1002,1635.5,16355,17606,6.6,5,5,4,221,22.1,0,0,0,1,0,205,20.5,1,5,5,5,7.2,18608,18229,1822.9,1002,1874,1
2930,-545,-1102,1704.0,17040,17805,7.0,6,6,5,215,21.5,0,0,1,0,1,214,21.4,1,9,10,10,7.0,18907,17585,1758.5,1102,545,1
2931,2423,295,1673.7,16737,17593,6.8,6,6,9,243,24.3,1,1,1,0,0,232,23.2,1,2,2,2,6.8,17298,14314,1431.4,-295,-2423,1
2932,-2001,-1137,1709.0,17090,18662,7.0,7,7,3,222,22.2,1,1,0,1,0,217,21.7,0,20,13,13,7.6,19799,19091,1909.1,1137,2001,0
2933,-7206,-6046,1468.9,14689,14871,6.0,5,5,5,168,16.8,0,0,1,0,1,279,27.9,1,10,15,15,7.4,20917,21895,2189.5,6046,7206,0
2934,494,-1338,1613.5,16135,17313,6.8,7,7,8,196,19.6,0,0,1,0,0,214,21.4,0,2,6,6,7.2,18651,15641,1564.1,1338,-494,1
2935,496,1530,1650.0,16500,18497,6.8,6,6,5,202,20.2,1,0,0,1,1,222,22.2,1,6,5,5,6.8,16967,16004,1600.4,-1530,-496,0
2936,568,-205,1731.8,17318,18742,7.0,6,6,8,237,23.7,0,0,1,0,1,202,20.2,2,8,7,7,7.4,18947,16750,1675.0,205,-568,0
2937,3424,1624,1820.2,18202,18332,7.0,9,9,14,232,23.2,0,0,1,0,1,228,22.8,1,2,2,2,6.4,16708,14778,1477.8,-1624,-3424,1
2938,549,429,1720.8,17208,19055,7.2,5,5,10,260,26.0,1,1,0,1,0,258,25.8,0,6,5,5,6.8,18626,16659,1665.9,-429,-549,0
2939,1506,-169,1649.6,16496,18200,6.8,5,5,8,251,25.1,1,1,0,1,0,224,22.4,1,1,2,2,7.0,18369,14990,1499.0,169,-1506,0
2940,2833,3175,1791.5,17915,19494,7.4,10,10,6,222,22.2,0,0,1,0,0,206,20.6,0,6,5,5,6.6,16319,15082,1508.2,-3175,-2833,1
2941,773,1125,1891.7,18917,18476,7.2,10,10,16,210,21.0,0,0,0,1,1,207,20.7,1,11,8,8,6.6,17351,18144,1814.4,-1125,-773,0
2942,-2146,-3245,1648.4,16484,16372,6.4,8,8,8,176,17.6,1,1,0,1,0,204,20.4,0,7,12,12,7.2,19617,18630,1863.0,3245,2146,0
2943,2399,1719,1940.2,19402,18727,7.0,13,13,10,213,21.3,1,1,1,0,0,212,21.2,0,8,7,7,6.6,17008,17003,1700.3,-1719,-2399,0
2944,453,76,1586.9,15869,18711,7.2,4,4,5,249,24.9,2,1,1,0,0,265,26.5,0,1,1,1,7.0,18635,15416,1541.6,-76,-453,0
2945,2533,1568,1733.8,17338,19907,7.4,6,6,5,256,25.6,1,0,1,0,0,242,24.2,0,3,2,2,7.2,18339,14805,1480.5,-1568,-2533,1
2946,5077,3251,1884.9,18849,19281,7.4,12,12,10,231,23.1,0,0,1,0,0,224,22.4,0,0,1,1,6.6,16030,13772,1377.2,-3251,-5077,1
2947,-4699,-4580,1525.0,15250,15780,6.2,6,6,8,183,18.3,0,0,0,1,1,237,23.7,1,12,11,11,7.4,20360,19949,1994.9,4580,4699,0
2948,-2161,-3222,1521.0,15210,16010,6.6,4,4,6,207,20.7,0,0,0,1,1,214,21.4,2,8,7,7,7.4,19232,17371,1737.1,3222,2161,0
2949,-795,-117,1669.2,16692,17643,7.0,8,8,9,181,18.1,0,0,0,1,0,222,22.2,0,14,8,8,7.0,17760,17487,1748.7,117,795,1
2950,875,-391,1662.1,16621,18305,6.8,4,4,3,255,25.5,0,0,1,0,0,238,23.8,0,7,4,4,7.0,18696,15746,1574.6,391,-875,1
2951,-1556,-887,1569.8,15698,18184,7.0,3,3,4,226,22.6,1,1,0,1,0,237,23.7,0,7,6,6,7.0,19071,17254,1725.4,887,1556,0
2952,-4019,-2008,1459.3,14593,16673,6.6,2,2,3,199,19.9,1,0,0,1,1,232,23.2,1,14,10,10,7.0,18681,18612,1861.2,2008,4019,0
2953,-609,-1114,1671.2,16712,16923,6.8,7,7,8,221,22.1,0,0,1,0,1,229,22.9,1,11,8,8,6.8,18037,17321,1732.1,1114,609,1
2954,-2152,-2041,1683.7,16837,17911,7.2,6,6,8,191,19.1,0,0,0,1,1,237,23.7,2,8,10,10,7.4,19952,18989,1898.9,2041,2152,0
2955,-1509,-358,1551.4,15514,18547,7.0,5,5,5,200,20.0,1,1,0,1,0,259,25.9,0,4,5,5,7.0,18905,17023,1702.3,358,1509,0
2956,-308,1739,1723.6,17236,19937,7.2,8,8,4,235,23.5,0,0,1,0,1,220,22.0,1,10,8,8,6.8,18198,17544,1754.4,-1739,308,1
2957,-4473,-3040,1620.4,16204,17704,7.0,7,7,10,182,18.2,0,0,0,1,1,237,23.7,1,19,14,14,7.4,20744,20677,2067.7,3040,4473,0
2958,2991,1357,1842.2,18422,18184,7.0,9,9,10,219,21.9,0,0,1,0,0,200,20.0,0,6,6,6,6.6,16827,15431,1543.1,-1357,-2991,1
2959,-2416,-3217,1535.6,15356,16700,6.8,5,5,6,207,20.7,0,0,0,1,0,239,23.9,0,8,8,8,7.4,19917,17772,1777.2,3217,2416,0
2960,-132,119,1484.8,14848,17467,6.8,2,2,1,205,20.5,0,0,1,0,1,213,21.3,1,3,4,4,6.8,17348,14980,1498.0,-119,132,0
2961,91,591,1568.8,15688,18341,6.8,4,4,3,237,23.7,0,0,0,1,0,239,23.9,0,6,4,4,6.8,17750,15597,1559.7,-591,-91,1
2962,-842,2032,1492.6,14926,19450,7.0,4,4,2,203,20.3,0,0,1,0,0,243,24.3,1,7,4,4,7.0,17418,15768,1576.8,-2032,842,1
2963,-2302,-997,1619.0,16190,16496,6.6,7,7,5,207,20.7,0,0,0,1,0,173,17.3,0,16,14,14,6.6,17493,18492,1849.2,997,2302,0
2964,2463,1390,1631.8,16318,18426,7.0,6,6,8,226,22.6,1,1,1,0,0,200,20.0,0,1,2,2,6.8,17036,13855,1385.5,-1390,-2463,1
2965,-4264,-3932,1537.6,15376,16758,6.6,6,6,8,196,19.6,0,0,0,1,1,262,26.2,2,6,11,11,7.4,20690,19640,1964.0,3932,4264,0
2966,-3480,-1368,1466.6,14666,16186,6.2,1,1,1,233,23.3,0,0,0,1,1,193,19.3,1,22,10,10,7.0,17554,18146,1814.6,1368,3480,0
2967,-1207,606,1630.1,16301,18968,7.2,6,6,3,235,23.5,1,1,0,1,0,230,23.0,0,10,9,9,7.0,18362,17508,1750.8,-606,1207,1
2968,-4664,-2707,1512.4,15124,17488,6.8,4,4,9,213,21.3,0,0,0,1,1,249,24.9,2,7,11,11,7.4,20195,19788,1978.8,2707,4664,0
2969,4888,3753,1903.1,19031,20293,7.4,10,10,13,212,21.2,2,1,1,0,0,182,18.2,0,3,2,2,6.8,16540,14143,1414.3,-3753,-4888,1
2970,1433,508,1858.1,18581,19012,7.2,11,11,9,239,23.9,0,0,1,0,1,218,21.8,1,7,9,9,7.0,18504,17148,1714.8,-508,-1433,1
2971,1713,1673,1714.4,17144,18638,7.0,7,7,9,230,23.0,2,1,0,1,0,216,21.6,0,1,3,3,6.6,16965,15431,1543.1,-1673,-1713,0
2972,-328,137,1836.8,18368,19062,7.2,9,9,10,204,20.4,2,1,0,1,0,230,23.0,0,13,10,10,7.2,18925,18696,1869.6,-137,328,0
2973,2726,1990,1684.4,16844,18805,7.0,6,6,6,243,24.3,1,1,0,1,0,210,21.0,0,1,2,2,6.8,16815,14118,1411.8,-1990,-2726,1
2974,-648,-1422,1670.7,16707,16612,6.6,8,8,13,204,20.4,0,0,0,1,1,193,19.3,1,12,10,10,6.8,18034,17355,1735.5,1422,648,0
2975,-286,-916,1786.8,17868,17858,7.0,10,10,9,177,17.7,2,1,0,1,0,247,24.7,0,11,9,9,7.0,18774,18154,1815.4,916,286,1
2976,5300,4813,2004.3,20043,21800,7.8,13,13,9,264,26.4,0,0,1,0,0,230,23.0,1,0,2,2,6.6,16987,14743,1474.3,-4813,-5300,1
2977,-4835,-3655,1485.2,14852,16246,6.6,3,3,3,194,19.4,0,0,1,0,1,195,19.5,1,11,11,11,7.2,19901,19687,1968.7,3655,4835,0
2978,-592,-2438,1630.2,16302,15434,6.2,7,7,8,183,18.3,0,0,1,0,0,216,21.6,0,10,8,8,6.8,17872,16894,1689.4,2438,592,0
2979,7776,6703,2335.9,23359,20348,7.4,17,17,25,237,23.7,0,0,1,0,0,134,13.4,0,7,5,5,5.8,13645,15583,1558.3,-6703,-7776,1
2980,1909,1099,1835.2,18352,18953,7.2,8,8,12,242,24.2,1,1,0,1,0,225,22.5,0,5,6,6,7.0,17854,16443,1644.3,-1099,-1909,1
2981,1942,450,1687.3,16873,17662,6.8,3,3,1,240,24.0,1,0,1,0,0,168,16.8,0,4,6,6,6.8,17212,14931,1493.1,-450,-1942,1
2982,16,560,1694.9,16949,18440,7.0,7,7,6,236,23.6,0,0,0,1,1,232,23.2,2,7,6,6,7.2,17880,16933,1693.3,-560,-16,0
2983,-860,949,1634.4,16344,19207,7.4,5,5,3,230,23.0,0,0,0,1,1,202,20.2,1,6,8,8,7.2,18258,17204,1720.4,-949,860,1
2984,-2308,-1946,1526.8,15268,17072,6.6,5,5,6,211,21.1,0,0,0,1,1,263,26.3,1,8,6,6,7.2,19018,17576,1757.6,1946,2308,0
2985,-460,-1189,1646.3,16463,16544,6.4,8,8,8,186,18.6,1,0,0,1,0,238,23.8,0,4,7,7,6.8,17733,16923,1692.3,1189,460,1
2986,799,440,1704.9,17049,17357,6.8,7,7,6,221,22.1,0,0,0,1,0,215,21.5,1,3,4,4,6.6,16917,16250,1625.0,-440,-799,1
2987,886,355,1581.1,15811,18673,7.2,4,4,3,242,24.2,1,1,1,0,0,236,23.6,0,1,2,2,7.2,18318,14925,1492.5,-355,-886,1
2988,-3300,-3318,1410.9,14109,16353,6.4,1,1,1,205,20.5,0,0,0,1,0,231,23.1,0,7,9,9,7.2,19671,17409,1740.9,3318,3300,0
2989,-9341,-6317,1229.2,12292,13648,5.8,2,2,2,152,15.2,0,0,0,1,0,239,23.9,1,11,8,8,7.4,19965,21633,2163.3,6317,9341,0
2990,3851,1574,1848.7,18487,18183,7.2,10,10,16,211,21.1,1,1,1,0,0,211,21.1,0,3,3,3,6.4,16609,14636,1463.6,-1574,-3851,1
2991,-147,21,1686.0,16860,18713,7.2,8,8,7,198,19.8,1,1,0,1,0,257,25.7,0,5,5,5,7.2,18692,17007,1700.7,-21,147,0
2992,1698,1171,1779.8,17798,19047,7.0,7,7,14,222,22.2,1,0,1,0,0,241,24.1,0,7,5,5,6.8,17876,16100,1610.0,-1171,-1698,1
2993,-966,-901,1578.9,15789,17312,6.6,6,6,4,230,23.0,0,0,0,1,1,231,23.1,1,5,6,6,7.0,18213,16755,1675.5,901,966,0
2994,3454,175,1960.9,19609,17551,7.0,13,13,19,207,20.7,1,1,0,1,0,201,20.1,0,6,7,7,6.8,17376,16155,1615.5,-175,-3454,0
2995,-2673,-1867,1485.3,14853,16170,6.4,5,5,6,174,17.4,1,0,0,1,1,246,24.6,1,8,6,6,7.0,18037,17526,1752.6,1867,2673,0
2996,-482,-349,1536.9,15369,17785,7.0,3,3,2,221,22.1,0,0,0,1,1,257,25.7,1,5,4,4,7.0,18134,15851,1585.1,349,482,0
2997,-298,0,1705.3,17053,18362,7.0,6,6,7,219,21.9,0,0,1,0,1,213,21.3,1,7,8,8,7.2,18362,17351,1735.1,0,298,1
2998,-224,-765,1730.7,17307,16527,6.6,11,11,10,161,16.1,1,1,1,0,0,210,21.0,0,9,9,9,6.8,17292,17531,1753.1,765,224,1
2999,-1683,-377,1488.1,14881,15603,6.4,3,3,3,195,19.5,0,0,1,0,1,185,18.5,1,17,9,9,6.4,15980,16564,1656.4,377,1683,0
3000,2514,2924,1792.8,17928,20419,7.4,9,9,7,250,25.0,0,0,0,1,0,180,18.0,0,5,4,4,7.0,17495,15414,1541.4,-2924,-2514,1
3001,81,450,1487.6,14876,17630,7.0,3,3,2,221,22.1,1,1,0,1,0,218,21.8,1,6,3,3,7.0,17180,14795,1479.5,-450,-81,0
3002,420,521,1535.6,15356,18787,7.0,3,3,3,212,21.2,1,1,0,1,0,230,23.0,0,1,2,2,7.0,18266,14936,1493.6,-521,-420,1
3003,-1167,259,1612.2,16122,18226,6.8,7,7,7,168,16.8,1,0,0,1,0,210,21.0,0,3,7,7,7.0,17967,17289,1728.9,-259,1167,1
3004,-99,151,1542.6,15426,17981,7.0,4,4,4,211,21.1,1,0,0,1,1,230,23.0,1,2,4,4,6.8,17830,15525,1552.5,-151,99,1
3005,387,1781,1644.8,16448,19097,7.2,7,7,5,216,21.6,0,0,1,0,0,210,21.0,0,2,7,7,6.8,17316,16061,1606.1,-1781,-387,1
3006,-1700,-1053,1418.2,14182,16753,6.8,2,2,1,220,22.0,0,0,0,1,0,223,22.3,0,3,5,5,6.8,17806,15882,1588.2,1053,1700,0
3007,-820,-298,1589.1,15891,19024,7.2,4,4,4,200,20.0,1,0,0,1,1,214,21.4,1,7,7,7,7.4,19322,16711,1671.1,298,820,1
3008,-3945,-1758,1585.8,15858,16120,6.4,5,5,5,219,21.9,1,0,0,1,1,196,19.6,1,19,13,13,7.2,17878,19803,1980.3,1758,3945,1
3009,-3238,-1130,1494.9,14949,16818,6.4,4,4,5,180,18.0,1,0,0,1,1,259,25.9,1,9,8,8,7.0,17948,18187,1818.7,1130,3238,0
3010,-2511,-2347,1437.7,14377,17055,7.0,2,2,3,210,21.0,1,1,1,0,0,249,24.9,0,8,6,6,7.2,19402,16888,1688.8,2347,2511,0
3011,1433,1278,1594.6,15946,18587,7.0,5,5,6,223,22.3,1,1,1,0,0,183,18.3,0,2,3,3,7.0,17309,14513,1451.3,-1278,-1433,0
3012,-1037,-1057,1558.4,15584,17939,6.8,2,2,3,234,23.4,0,0,1,0,0,222,22.2,0,13,6,6,7.2,18996,16621,1662.1,1057,1037,0
3013,1344,1628,1580.0,15800,18316,7.0,4,4,3,244,24.4,1,1,0,1,0,210,21.0,0,1,3,3,6.6,16688,14456,1445.6,-1628,-1344,1
3014,-245,330,1621.0,16210,18620,7.2,6,6,7,231,23.1,2,1,0,1,0,220,22.0,0,8,6,6,7.2,18290,16455,1645.5,-330,245,0
3015,5920,2703,2058.7,20587,19713,7.4,13,13,7,229,22.9,1,1,1,0,0,168,16.8,0,3,4,4,6.8,17010,14667,1466.7,-2703,-5920,1
3016,539,774,1573.5,15735,18331,7.0,3,3,3,233,23.3,1,1,1,0,0,220,22.0,0,4,5,5,7.0,17557,15196,1519.6,-774,-539,1
3017,708,302,1737.8,17378,18525,7.2,8,8,7,242,24.2,0,0,1,0,0,235,23.5,0,6,7,7,7.0,18223,16670,1667.0,-302,-708,0
3018,2876,2805,1799.3,17993,16834,6.6,10,10,14,222,22.2,0,0,0,1,0,180,18.0,0,8,5,5,6.0,14029,15117,1511.7,-2805,-2876,0
3019,-184,408,1607.2,16072,16945,6.8,5,5,9,236,23.6,0,0,1,0,0,195,19.5,0,7,7,7,6.8,16537,16256,1625.6,-408,184,1
3020,-101,-380,1555.7,15557,18380,7.0,3,3,4,251,25.1,1,1,0,1,0,210,21.0,0,2,5,5,7.2,18760,15658,1565.8,380,101,0
3021,-5563,-4698,1446.7,14467,16331,6.6,3,3,3,209,20.9,0,0,0,1,1,235,23.5,2,8,13,13,7.6,21029,20030,2003.0,4698,5563,0
3022,-447,-2127,1609.6,16096,15907,6.4,8,8,12,197,19.7,1,1,1,0,0,193,19.3,0,7,9,9,7.0,18034,16543,1654.3,2127,447,1
3023,1487,1143,1635.1,16351,17063,6.8,7,7,8,171,17.1,1,1,1,0,0,224,22.4,0,2,4,4,6.4,15920,14864,1486.4,-1143,-1487,1
3024,1126,878,1653.8,16538,18735,7.0,6,6,5,227,22.7,1,1,0,1,0,225,22.5,1,2,4,4,6.8,17857,15412,1541.2,-878,-1126,1
3025,1795,1933,1633.7,16337,19371,7.2,5,5,3,259,25.9,0,0,0,1,0,238,23.8,0,2,2,2,6.8,17438,14542,1454.2,-1933,-1795,1
3026,4216,2141,1751.9,17519,17753,6.8,10,10,13,209,20.9,1,1,1,0,0,197,19.7,0,1,2,2,6.4,15612,13303,1330.3,-2141,-4216,1
3027,-1517,-972,1430.5,14305,17323,6.8,2,2,5,214,21.4,1,1,1,0,0,225,22.5,1,3,3,3,7.0,18295,15822,1582.2,972,1517,0
3028,1236,149,1827.9,18279,18909,7.4,12,12,9,174,17.4,0,0,0,1,1,224,22.4,2,3,5,5,7.0,18760,17043,1704.3,-149,-1236,0
3029,2489,1473,1780.8,17808,18545,7.0,8,8,9,246,24.6,2,1,1,0,0,191,19.1,0,4,6,6,6.6,17072,15319,1531.9,-1473,-2489,1
3030,1259,1281,1736.0,17360,19151,7.4,6,6,5,250,25.0,1,0,1,0,1,201,20.1,1,8,6,6,7.0,17870,16101,1610.1,-1281,-1259,0
3031,3281,1747,1884.9,18849,19086,7.2,11,11,10,220,22.0,1,0,1,0,1,202,20.2,1,3,6,6,6.8,17339,15568,1556.8,-1747,-3281,1
3032,-1136,-1235,1564.1,15641,17857,7.2,4,4,6,244,24.4,0,0,0,1,1,234,23.4,1,3,4,4,7.2,19092,16777,1677.7,1235,1136,0
3033,-5838,-4101,1340.8,13408,15571,6.6,2,2,2,185,18.5,0,0,0,1,1,255,25.5,1,4,6,6,7.2,19672,19246,1924.6,4101,5838,0
3034,1973,1461,1936.6,19366,18628,7.0,13,13,15,229,22.9,0,0,1,0,1,164,16.4,1,13,10,10,6.8,17167,17393,1739.3,-1461,-1973,1
3035,592,-875,1664.6,16646,16213,6.6,7,7,8,204,20.4,1,1,1,0,0,204,20.4,0,8,6,6,6.6,17088,16054,1605.4,875,-592,0
3036,-2492,-1526,1500.9,15009,17067,6.8,3,3,4,207,20.7,1,1,1,0,0,204,20.4,0,13,9,9,7.4,18593,17501,1750.1,1526,2492,0
3037,-1490,-1624,1592.1,15921,17353,6.8,5,5,5,210,21.0,1,1,1,0,0,215,21.5,0,14,9,9,7.2,18977,17411,1741.1,1624,1490,0
3038,2957,2549,1801.2,18012,16748,6.6,8,8,12,210,21.0,1,1,1,0,0,177,17.7,0,5,6,6,6.0,14199,15055,1505.5,-2549,-2957,1
3039,-4927,-5216,1522.4,15224,16423,6.6,5,5,5,203,20.3,1,1,0,1,0,231,23.1,0,11,12,12,7.8,21639,20151,2015.1,5216,4927,0
3040,-4879,-3465,1548.4,15484,16418,6.6,6,6,7,165,16.5,0,0,0,1,1,250,25.0,1,16,15,15,7.4,19883,20363,2036.3,3465,4879,0
3041,-424,-1075,1555.0,15550,18425,7.2,3,3,2,249,24.9,2,1,1,0,0,245,24.5,0,5,3,3,7.2,19500,15974,1597.4,1075,424,1
3042,-1018,-1531,1589.5,15895,17705,6.8,6,6,5,225,22.5,0,0,1,0,1,232,23.2,1,6,4,4,7.4,19236,16913,1691.3,1531,1018,0
3043,907,-86,1677.6,16776,18113,7.0,8,8,7,207,20.7,1,0,1,0,1,228,22.8,1,8,5,5,7.0,18199,15869,1586.9,86,-907,1
3044,-3445,-2015,1344.4,13444,16544,6.4,1,1,2,197,19.7,0,0,0,1,0,246,24.6,0,5,5,5,7.0,18559,16889,1688.9,2015,3445,0
3045,152,-486,1797.1,17971,18271,7.2,11,11,11,162,16.2,0,0,0,1,0,192,19.2,0,9,9,9,7.2,18757,17819,1781.9,486,-152,1
3046,-4456,-2336,1295.9,12959,15381,6.4,1,1,3,172,17.2,0,0,0,1,0,196,19.6,0,17,7,7,6.8,17717,17415,1741.5,2336,4456,0
3047,69,-232,1722.5,17225,17613,7.0,9,9,7,217,21.7,0,0,1,0,0,210,21.0,0,12,9,9,7.0,17845,17156,1715.6,232,-69,1
3048,868,1728,1784.8,17848,19890,7.4,9,9,8,212,21.2,0,0,1,0,1,216,21.6,1,8,6,6,7.2,18162,16980,1698.0,-1728,-868,0
3049,209,1023,1544.8,15448,18033,7.0,2,2,1,215,21.5,1,0,0,1,0,224,22.4,0,4,4,4,6.8,17010,15239,1523.9,-1023,-209,0
3050,-1611,-1931,1542.5,15425,17540,7.0,5,5,7,208,20.8,1,1,1,0,0,246,24.6,0,6,6,6,7.4,19471,17036,1703.6,1931,1611,0
3051,385,-71,1571.7,15717,17819,7.0,5,5,10,211,21.1,1,1,1,0,0,231,23.1,0,3,3,3,7.0,17890,15332,1533.2,71,-385,1
3052,-3750,-4961,1458.9,14589,15373,6.0,5,5,1,195,19.5,0,0,0,1,1,229,22.9,1,14,8,8,7.4,20334,18339,1833.9,4961,3750,0
3053,25,327,1546.3,15463,18378,7.2,4,4,5,215,21.5,0,0,1,0,0,215,21.5,0,5,5,5,7.0,18051,15438,1543.8,-327,-25,1
3054,-388,-619,1601.9,16019,16667,6.6,7,7,7,174,17.4,1,1,0,1,0,207,20.7,0,8,8,8,6.8,17286,16407,1640.7,619,388,0
3055,1930,425,1763.4,17634,17330,6.8,8,8,7,219,21.9,0,0,1,0,0,226,22.6,0,5,4,4,6.4,16905,15704,1570.4,-425,-1930,1
3056,517,-593,1601.7,16017,15395,6.2,8,8,12,157,15.7,0,0,1,0,0,170,17.0,0,7,8,8,6.4,15988,15500,1550.0,593,-517,0
3057,-214,1004,1725.9,17259,19074,7.0,6,6,10,236,23.6,2,1,1,0,0,225,22.5,0,8,7,7,7.0,18070,17473,1747.3,-1004,214,1
3058,2229,2851,1622.6,16226,18917,7.0,5,5,3,250,25.0,1,1,0,1,0,197,19.7,0,2,2,2,6.4,16066,13997,1399.7,-2851,-2229,1
3059,1953,1494,1781.6,17816,18684,6.8,10,10,11,202,20.2,2,1,1,0,0,224,22.4,0,6,4,4,7.0,17190,15863,1586.3,-1494,-1953,0
3060,-781,-1296,1553.2,15532,18026,6.8,4,4,3,210,21.0,0,0,0,1,1,220,22.0,2,4,6,6,7.2,19322,16313,1631.3,1296,781,0
3061,380,1750,1694.6,16946,17971,6.8,7,7,9,217,21.7,0,0,0,1,1,230,23.0,2,10,7,7,6.6,16221,16566,1656.6,-1750,-380,1
3062,-758,733,1601.9,16019,18530,6.8,5,5,4,222,22.2,0,0,0,1,0,215,21.5,0,7,6,6,7.0,17797,16777,1677.7,-733,758,0
3063,3072,1589,1793.8,17938,18237,7.2,8,8,8,232,23.2,0,0,0,1,1,207,20.7,1,4,4,4,6.8,16648,14866,1486.6,-1589,-3072,1
3064,2549,1269,1751.2,17512,18140,7.0,9,9,10,186,18.6,1,0,0,1,1,174,17.4,1,6,6,6,6.6,16871,14963,1496.3,-1269,-2549,1
3065,2427,2303,1671.2,16712,17310,6.8,8,8,7,208,20.8,2,1,1,0,0,172,17.2,0,7,5,5,6.4,15007,14285,1428.5,-2303,-2427,1
3066,-844,-689,1591.3,15913,17592,6.8,5,5,7,202,20.2,1,0,0,1,1,247,24.7,1,3,6,6,7.2,18281,16757,1675.7,689,844,0
3067,-1394,-2258,1710.8,17108,17877,6.8,6,6,6,211,21.1,1,1,1,0,0,210,21.0,0,10,9,9,7.6,20135,18502,1850.2,2258,1394,0
3068,7128,6117,2334.9,23349,21214,7.6,16,16,11,223,22.3,2,1,1,0,0,140,14.0,0,13,9,9,6.2,15097,16221,1622.1,-6117,-7128,1
3069,-826,38,1554.8,15548,18820,7.4,5,5,3,229,22.9,2,1,1,0,0,225,22.5,0,6,5,5,7.2,18782,16374,1637.4,-38,826,0
3070,1233,251,1595.0,15950,18633,7.0,5,5,5,247,24.7,1,1,0,1,0,204,20.4,0,2,2,2,6.8,18382,14717,1471.7,-251,-1233,0
3071,476,467,1601.4,16014,18969,7.0,5,5,3,225,22.5,1,0,1,0,0,257,25.7,0,1,2,2,7.2,18502,15538,1553.8,-467,-476,1
3072,-2587,-1470,1741.9,17419,17316,7.0,9,9,8,178,17.8,1,1,0,1,0,214,21.4,0,23,15,15,7.2,18786,20006,2000.6,1470,2587,0
3073,3763,874,1997.9,19979,18500,7.2,11,11,13,207,20.7,0,0,1,0,0,194,19.4,0,6,5,5,7.0,17626,16216,1621.6,-874,-3763,0
3074,-2968,-2159,1412.2,14122,15708,6.6,3,3,2,188,18.8,1,1,0,1,0,182,18.2,0,7,8,8,7.0,17867,17090,1709.0,2159,2968,0
3075,-384,-1658,1744.7,17447,16191,6.4,10,10,13,173,17.3,0,0,1,0,0,208,20.8,0,9,11,11,7.0,17849,17831,1783.1,1658,384,1
3076,-1673,-327,1612.2,16122,17858,6.8,7,7,9,196,19.6,0,0,0,1,0,231,23.1,0,8,8,8,7.0,18185,17795,1779.5,327,1673,0
3077,-466,-26,1833.6,18336,17626,7.0,12,12,12,179,17.9,0,0,1,0,0,211,21.1,0,19,11,11,6.6,17652,18802,1880.2,26,466,0
3078,-8461,-7340,1200.2,12002,13961,6.0,0,0,0,151,15.1,0,0,0,1,0,238,23.8,0,9,12,12,7.8,21301,20463,2046.3,7340,8461,0
3079,-3682,-3599,1437.8,14378,16230,6.4,3,3,5,209,20.9,0,0,1,0,1,245,24.5,2,2,5,5,7.4,19829,18060,1806.0,3599,3682,0
3080,3544,2399,1769.1,17691,18548,7.0,8,8,18,222,22.2,0,0,1,0,0,184,18.4,0,4,4,4,6.4,16149,14147,1414.7,-2399,-3544,0
3081,2008,2566,1940.2,19402,18717,7.2,15,15,13,195,19.5,0,0,1,0,0,180,18.0,0,12,11,11,6.4,16151,17394,1739.4,-2566,-2008,1
3082,3100,1653,1646.8,16468,18574,6.8,3,3,3,249,24.9,0,0,1,0,0,192,19.2,0,0,1,1,6.6,16921,13368,1336.8,-1653,-3100,1
3083,-3576,-3516,1448.6,14486,15896,6.4,2,2,5,207,20.7,0,0,0,1,0,205,20.5,1,11,11,11,7.2,19412,18062,1806.2,3516,3576,0
3084,775,1702,1765.2,17652,18869,7.4,9,9,9,225,22.5,0,0,0,1,0,210,21.0,1,3,8,8,6.6,17167,16877,1687.7,-1702,-775,1
3085,1515,857,1549.4,15494,15724,6.6,7,7,12,165,16.5,1,1,1,0,0,186,18.6,0,2,3,3,6.4,14867,13979,1397.9,-857,-1515,1
3086,-82,117,1627.0,16270,17661,6.8,6,6,11,200,20.0,0,0,1,0,1,221,22.1,1,4,8,8,6.8,17544,16352,1635.2,-117,82,0
3087,-903,-1584,1589.9,15899,17722,6.8,5,5,3,232,23.2,0,0,1,0,1,249,24.9,1,7,6,6,7.2,19306,16802,1680.2,1584,903,0
3088,-5802,-3559,1427.7,14277,17550,7.0,3,3,3,201,20.1,0,0,0,1,1,240,24.0,1,9,12,12,7.6,21109,20079,2007.9,3559,5802,0
3089,1492,1607,1735.0,17350,18857,7.2,5,5,4,202,20.2,0,0,0,1,1,191,19.1,1,9,6,6,7.0,17250,15858,1585.8,-1607,-1492,1
3090,246,1266,1831.5,18315,18534,7.0,8,8,15,209,20.9,0,0,1,0,1,208,20.8,1,8,9,9,6.8,17268,18069,1806.9,-1266,-246,1
3091,4826,4472,1957.0,19570,21203,7.8,9,9,13,259,25.9,0,0,1,0,1,229,22.9,1,4,2,2,6.6,16731,14744,1474.4,-4472,-4826,1
3092,1085,775,1652.9,16529,16649,6.8,6,6,5,198,19.8,0,0,1,0,1,179,17.9,1,8,5,5,6.4,15874,15444,1544.4,-775,-1085,1
3093,2158,640,1832.4,18324,18016,7.0,11,11,18,205,20.5,1,1,1,0,0,219,21.9,0,8,5,5,7.0,17376,16166,1616.6,-640,-2158,1
3094,3181,3298,1726.3,17263,19913,7.2,8,8,6,234,23.4,0,0,1,0,1,159,15.9,2,3,3,3,6.8,16615,14082,1408.2,-3298,-3181,1
3095,1629,677,1528.2,15282,17848,6.8,4,4,3,211,21.1,1,1,1,0,0,246,24.6,0,0,0,0,6.8,17171,13653,1365.3,-677,-1629,1
3096,782,1903,1596.0,15960,18478,7.2,5,5,4,232,23.2,0,0,0,1,1,211,21.1,1,5,4,4,6.4,16575,15178,1517.8,-1903,-782,0
3097,-1328,-317,1510.3,15103,17162,6.6,5,5,5,198,19.8,1,1,1,0,0,227,22.7,1,7,5,5,7.0,17479,16431,1643.1,317,1328,0
3098,794,577,1606.0,16060,18431,7.0,7,7,6,228,22.8,0,0,0,1,0,213,21.3,0,4,3,3,7.0,17854,15266,1526.6,-577,-794,1
3099,-2809,-1673,1546.3,15463,17772,6.8,7,7,6,162,16.2,0,0,0,1,1,219,21.9,1,7,9,9,7.2,19445,18272,1827.2,1673,2809,0
3100,-833,-1786,1722.5,17225,16572,6.6,6,6,7,210,21.0,0,0,0,1,0,220,22.0,1,10,10,10,7.0,18358,18058,1805.8,1786,833,0
3101,-3337,-1701,1486.1,14861,16993,6.8,3,3,2,225,22.5,0,0,0,1,0,223,22.3,0,10,9,9,7.2,18694,18198,1819.8,1701,3337,0
3102,1532,1453,1596.6,15966,18955,7.2,4,4,10,229,22.9,1,1,0,1,0,229,22.9,0,1,1,1,7.2,17502,14434,1443.4,-1453,-1532,1
3103,-1066,10,1517.2,15172,18276,7.0,4,4,2,205,20.5,0,0,1,0,1,241,24.1,1,7,6,6,6.8,18266,16238,1623.8,-10,1066,0
3104,-477,-513,1595.3,15953,17960,6.8,4,4,4,260,26.0,0,0,0,1,0,234,23.4,0,9,7,7,7.0,18473,16430,1643.0,513,477,1
3105,1696,2266,1795.9,17959,20494,7.6,9,9,7,239,23.9,0,0,0,1,1,225,22.5,1,3,5,5,6.8,18228,16263,1626.3,-2266,-1696,1
3106,2889,1215,1717.6,17176,18575,7.0,7,7,11,200,20.0,2,1,1,0,0,217,21.7,0,2,2,2,6.8,17360,14287,1428.7,-1215,-2889,1
3107,2156,3157,1732.8,17328,18867,7.0,8,8,7,234,23.4,1,0,1,0,0,225,22.5,0,8,4,4,6.2,15710,15172,1517.2,-3157,-2156,1
3108,-1281,-602,1514.4,15144,17995,7.2,2,2,3,236,23.6,0,0,0,1,0,219,21.9,0,10,6,6,7.2,18597,16425,1642.5,602,1281,0
3109,85,765,1653.3,16533,18187,7.0,6,6,4,217,21.7,1,0,0,1,0,214,21.4,0,9,6,6,6.8,17422,16448,1644.8,-765,-85,0
3110,1761,1895,1847.5,18475,19732,7.4,11,11,9,196,19.6,0,0,1,0,1,196,19.6,1,9,8,8,6.8,17837,16714,1671.4,-1895,-1761,0
3111,-1293,-380,1525.2,15252,18024,7.0,3,3,2,224,22.4,1,1,0,1,0,219,21.9,0,8,7,7,7.0,18404,16545,1654.5,380,1293,0
3112,-3644,-1277,1462.1,14621,17862,7.0,4,4,1,179,17.9,0,0,0,1,1,243,24.3,1,12,9,9,7.0,19139,18265,1826.5,1277,3644,1
3113,-1095,-249,1595.3,15953,17372,6.6,6,6,7,221,22.1,0,0,0,1,1,218,21.8,1,8,8,8,6.8,17621,17048,1704.8,249,1095,0
3114,2359,1681,1662.7,16627,18676,6.8,5,5,5,223,22.3,2,1,1,0,0,221,22.1,0,3,2,2,6.6,16995,14268,1426.8,-1681,-2359,1
3115,699,944,1724.0,17240,18845,7.0,8,8,4,248,24.8,0,0,1,0,1,179,17.9,1,6,8,8,6.8,17901,16541,1654.1,-944,-699,1
3116,453,1426,1579.6,15796,18152,7.0,5,5,4,221,22.1,0,0,0,1,1,256,25.6,1,4,2,2,6.4,16726,15343,1534.3,-1426,-453,0
3117,1769,319,1833.0,18330,19257,7.4,8,8,10,232,23.2,0,0,1,0,1,251,25.1,2,1,2,2,7.2,18938,16561,1656.1,-319,-1769,1
3118,-3240,-2396,1568.4,15684,17219,6.6,6,6,8,202,20.2,1,1,1,0,0,257,25.7,1,8,7,7,7.0,19615,18924,1892.4,2396,3240,0
3119,1936,1098,1712.0,17120,18300,6.8,7,7,3,233,23.3,1,1,1,0,0,206,20.6,0,4,4,4,6.8,17202,15184,1518.4,-1098,-1936,1
3120,-393,-1504,1526.1,15261,17058,6.6,4,4,2,233,23.3,1,1,1,0,0,208,20.8,0,5,5,5,7.2,18562,15654,1565.4,1504,393,1
3121,620,339,1805.3,18053,17357,6.6,11,11,17,189,18.9,1,0,0,1,0,196,19.6,0,10,8,8,6.4,17018,17433,1743.3,-339,-620,0
3122,-691,-666,1541.7,15417,16990,6.8,3,3,3,224,22.4,1,0,1,0,1,213,21.3,1,11,6,6,6.8,17656,16108,1610.8,666,691,0
3123,1357,614,1652.3,16523,18718,7.2,8,8,5,193,19.3,1,1,1,0,0,208,20.8,0,2,5,5,6.8,18104,15166,1516.6,-614,-1357,1
3124,-12,-151,1680.9,16809,18470,7.0,8,8,6,210,21.0,1,1,1,0,0,221,22.1,0,6,8,8,7.2,18621,16821,1682.1,151,12,0
3125,-2690,-3245,1562.7,15627,17457,6.8,5,5,6,199,19.9,0,0,1,0,1,230,23.0,2,9,8,8,7.6,20702,18317,1831.7,3245,2690,0
3126,-2240,-1623,1379.3,13793,17022,6.8,0,0,0,223,22.3,1,0,0,1,1,247,24.7,1,1,3,3,7.0,18645,16033,1603.3,1623,2240,0
3127,-2765,-2274,1448.1,14481,15768,6.4,3,3,4,214,21.4,0,0,1,0,1,226,22.6,2,16,8,8,7.2,18042,17246,1724.6,2274,2765,1
3128,-82,280,1635.7,16357,17543,6.6,8,8,11,196,19.6,1,1,1,0,0,241,24.1,0,4,4,4,6.8,17263,16439,1643.9,-280,82,0
3129,2230,2112,1858.2,18582,19549,7.4,10,10,11,222,22.2,0,0,0,1,0,196,19.6,1,8,6,6,6.8,17437,16352,1635.2,-2112,-2230,1
3130,-1661,-1064,1394.3,13943,17418,6.8,1,1,1,235,23.5,0,0,0,1,0,241,24.1,0,2,3,3,7.0,18482,15604,1560.4,1064,1661,0
3131,1720,1364,1841.0,18410,19835,7.2,10,10,8,241,24.1,0,0,1,0,0,212,21.2,0,6,7,7,7.4,18471,16690,1669.0,-1364,-1720,0
3132,211,880,1668.9,16689,18369,7.0,6,6,6,240,24.0,0,0,0,1,0,214,21.4,0,7,7,7,7.0,17489,16478,1647.8,-880,-211,0
3133,-27,-1847,1606.0,16060,16764,6.4,6,6,4,200,20.0,0,0,1,0,1,194,19.4,1,7,7,7,7.0,18611,16087,1608.7,1847,27,0
3134,-5142,-3023,1403.5,14035,14801,6.2,3,3,4,185,18.5,0,0,0,1,1,210,21.0,1,14,12,12,7.0,17824,19177,1917.7,3023,5142,0
3135,1818,1761,1775.7,17757,18305,7.0,9,9,10,218,21.8,2,1,1,0,0,204,20.4,0,7,6,6,6.8,16544,15939,1593.9,-1761,-1818,1
3136,-5571,-3921,1426.7,14267,16538,6.6,2,2,3,204,20.4,0,0,0,1,1,268,26.8,2,10,9,9,7.6,20459,19838,1983.8,3921,5571,0
3137,-1734,-3696,1595.1,15951,16512,6.6,6,6,6,223,22.3,0,0,0,1,1,221,22.1,2,5,12,12,7.6,20208,17685,1768.5,3696,1734,0
3138,704,-123,1668.8,16688,17926,6.8,8,8,4,216,21.6,0,0,1,0,1,190,19.0,1,4,8,8,7.2,18049,15984,1598.4,123,-704,0
3139,-2657,-2095,1430.3,14303,15787,6.2,3,3,2,187,18.7,2,1,0,1,0,237,23.7,0,6,5,5,7.0,17882,16960,1696.0,2095,2657,0
3140,-377,842,1739.6,17396,17804,7.0,9,9,12,205,20.5,1,1,1,0,0,223,22.3,1,10,8,8,6.6,16962,17773,1777.3,-842,377,1
3141,3037,2677,1815.9,18159,19769,7.4,9,9,9,245,24.5,1,0,1,0,1,213,21.3,1,4,3,3,6.6,17092,15122,1512.2,-2677,-3037,1
3142,459,1388,1626.9,16269,18306,7.2,7,7,8,202,20.2,1,0,0,1,1,212,21.2,1,8,5,5,6.6,16918,15810,1581.0,-1388,-459,0
3143,-2986,-3369,1531.6,15316,17118,6.6,4,4,5,198,19.8,1,1,1,0,0,247,24.7,0,3,9,9,7.4,20487,18302,1830.2,3369,2986,1
3144,1699,638,1649.8,16498,17738,6.8,5,5,4,237,23.7,1,1,1,0,0,202,20.2,0,3,4,4,6.8,17100,14799,1479.9,-638,-1699,1
3145,7873,5225,2060.3,20603,20443,7.4,16,16,17,245,24.5,1,1,1,0,0,188,18.8,0,0,0,0,6.6,15218,12730,1273.0,-5225,-7873,1
3146,3534,2345,1960.6,19606,18619,7.2,10,10,7,220,22.0,1,0,0,1,1,170,17.0,1,8,7,7,6.6,16274,16072,1607.2,-2345,-3534,1
3147,400,-213,1694.0,16940,17305,6.8,7,7,6,234,23.4,1,0,1,0,1,222,22.2,1,10,8,8,6.8,17518,16540,1654.0,213,-400,1
3148,2247,1262,1681.4,16814,18612,7.0,6,6,11,238,23.8,0,0,0,1,1,220,22.0,1,0,4,4,6.8,17350,14567,1456.7,-1262,-2247,1
3149,383,-1655,1814.6,18146,17263,6.6,9,9,13,199,19.9,1,0,1,0,0,201,20.1,0,10,8,8,7.4,18918,17763,1776.3,1655,-383,1
3150,-774,334,1524.2,15242,17856,7.2,3,3,3,216,21.6,0,0,0,1,0,243,24.3,0,4,5,5,6.8,17522,16016,1601.6,-334,774,0
3151,617,128,1745.4,17454,18029,6.8,10,10,5,204,20.4,1,1,1,0,0,178,17.8,0,5,7,7,6.8,17901,16837,1683.7,-128,-617,0
3152,1614,1179,1605.3,16053,17817,7.0,5,5,6,227,22.7,1,1,1,0,0,206,20.6,0,4,3,3,6.6,16638,14439,1443.9,-1179,-1614,0
3153,-2206,-2548,1497.5,14975,16649,6.4,2,2,1,222,22.2,0,0,1,0,1,216,21.6,1,12,9,9,7.4,19197,17181,1718.1,2548,2206,1
3154,-262,-375,1609.5,16095,18669,7.0,4,4,4,241,24.1,1,1,1,0,0,257,25.7,0,2,4,4,7.2,19044,16357,1635.7,375,262,1
3155,1012,-620,1712.3,17123,17944,6.8,8,8,11,223,22.3,0,0,0,1,0,220,22.0,0,3,5,5,7.4,18564,16111,1611.1,620,-1012,1
3156,313,-1776,1698.6,16986,17323,7.0,6,6,14,231,23.1,1,1,1,0,0,236,23.6,1,3,5,5,7.2,19099,16673,1667.3,1776,-313,0
3157,-1148,708,1473.1,14731,17886,7.0,3,3,3,204,20.4,0,0,0,1,1,237,23.7,1,4,3,3,6.8,17178,15879,1587.9,-708,1148,0
3158,3172,2797,1731.6,17316,18689,7.2,8,8,9,227,22.7,1,1,1,0,0,200,20.0,0,4,3,3,6.2,15892,14144,1414.4,-2797,-3172,1
3159,-819,-1709,1488.9,14889,17345,6.8,1,1,2,256,25.6,0,0,0,1,0,246,24.6,0,4,3,3,7.0,19054,15708,1570.8,1709,819,1
3160,-205,-41,1641.6,16416,18647,6.8,5,5,4,253,25.3,1,0,0,1,1,239,23.9,1,7,6,6,7.0,18688,16621,1662.1,41,205,0
3161,-1228,-1785,1694.3,16943,17177,6.8,7,7,10,215,21.5,0,0,0,1,1,217,21.7,1,11,11,11,7.4,18962,18171,1817.1,1785,1228,1
3162,5521,4435,1994.0,19940,20030,7.4,13,13,13,192,19.2,1,0,1,0,0,212,21.2,0,2,3,3,6.6,15595,14419,1441.9,-4435,-5521,1
3163,-1016,-1306,1620.4,16204,17473,6.6,8,8,5,184,18.4,0,0,1,0,1,210,21.0,1,7,7,7,7.0,18779,17220,1722.0,1306,1016,0
3164,-1246,150,1706.2,17062,18221,7.2,7,7,7,220,22.0,1,1,1,0,0,203,20.3,0,12,10,10,6.8,18071,18308,1830.8,-150,1246,1
3165,456,-69,1569.1,15691,17592,7.0,6,6,6,212,21.2,0,0,0,1,1,192,19.2,2,3,5,5,6.8,17661,15235,1523.5,69,-456,0
3166,-5087,-2795,1351.1,13511,16013,6.6,1,1,0,200,20.0,0,0,0,1,0,226,22.6,0,18,11,11,7.2,18808,18598,1859.8,2795,5087,0
3167,4006,3678,1892.7,18927,19861,7.4,12,12,11,231,23.1,0,0,1,0,0,176,17.6,0,2,2,2,6.4,16183,14921,1492.1,-3678,-4006,1
3168,-876,-1141,1616.4,16164,17989,7.0,7,7,10,196,19.6,1,1,0,1,0,239,23.9,0,4,6,6,7.0,19130,17040,1704.0,1141,876,1
3169,-1216,-1810,1557.2,15572,17404,6.8,4,4,8,221,22.1,0,0,1,0,0,256,25.6,0,3,4,4,7.4,19214,16788,1678.8,1810,1216,1
3170,1432,-889,1746.9,17469,17964,6.6,5,5,2,229,22.9,1,0,1,0,1,203,20.3,1,6,7,7,7.2,18853,16037,1603.7,889,-1432,0
3171,-3593,-3240,1468.6,14686,17582,7.0,3,3,4,206,20.6,1,1,0,1,0,226,22.6,0,5,10,10,7.6,20822,18279,1827.9,3240,3593,1
3172,2,-345,1632.5,16325,17831,6.8,8,8,10,193,19.3,0,0,0,1,1,227,22.7,1,4,6,6,7.0,18176,16323,1632.3,345,-2,0
3173,2034,884,1723.3,17233,17651,6.8,9,9,12,202,20.2,1,1,0,1,0,200,20.0,0,4,4,4,6.6,16767,15199,1519.9,-884,-2034,1
3174,-966,-455,1600.4,16004,18128,7.2,3,3,4,241,24.1,0,0,0,1,0,213,21.3,0,9,8,8,7.2,18583,16970,1697.0,455,966,0
3175,1167,-461,1665.1,16651,16985,6.6,6,6,9,218,21.8,0,0,1,0,1,207,20.7,1,4,6,6,6.8,17446,15484,1548.4,461,-1167,1
3176,-2128,-1289,1495.9,14959,17503,7.0,2,2,2,229,22.9,0,0,1,0,1,219,21.9,1,7,6,6,7.2,18792,17087,1708.7,1289,2128,1
3177,-1971,-2626,1591.7,15917,17246,6.8,5,5,4,200,20.0,0,0,1,0,1,200,20.0,2,13,10,10,7.2,19872,17888,1788.8,2626,1971,0
3178,-708,-1311,1575.4,15754,16844,6.6,6,6,9,198,19.8,0,0,0,1,0,207,20.7,0,5,6,6,7.0,18155,16462,1646.2,1311,708,1
3179,-1296,4,1689.1,16891,17845,7.0,8,8,9,201,20.1,1,1,1,0,0,217,21.7,0,9,8,8,7.0,17841,18187,1818.7,-4,1296,0
3180,-5924,-3368,1487.8,14878,16826,6.6,3,3,3,197,19.7,0,0,0,1,1,226,22.6,2,20,15,15,7.2,20194,20802,2080.2,3368,5924,0
3181,1443,2143,1715.0,17150,19389,7.2,7,7,7,225,22.5,0,0,1,0,0,229,22.9,0,5,3,3,6.8,17246,15707,1570.7,-2143,-1443,1
3182,-2,-1484,1594.1,15941,17661,7.0,5,5,6,236,23.6,1,1,1,0,0,237,23.7,0,2,4,4,7.2,19145,15943,1594.3,1484,2,0
3183,1070,1731,1780.2,17802,19422,7.4,7,7,11,239,23.9,0,0,1,0,0,211,21.1,1,3,3,3,7.0,17691,16732,1673.2,-1731,-1070,1
3184,-1238,-1708,1554.8,15548,18653,7.0,5,5,4,181,18.1,1,1,1,0,0,219,21.9,0,5,6,6,7.4,20361,16786,1678.6,1708,1238,1
3185,1300,1228,1555.6,15556,17886,7.0,5,5,6,219,21.9,0,0,0,1,0,218,21.8,0,3,2,2,6.6,16658,14256,1425.6,-1228,-1300,1
3186,-282,-192,1609.8,16098,18103,6.8,6,6,6,209,20.9,1,1,1,0,0,224,22.4,1,5,5,5,7.0,18295,16380,1638.0,192,282,1
3187,-456,-1135,1610.7,16107,17538,7.0,6,6,6,213,21.3,1,0,0,1,1,203,20.3,1,5,5,5,7.0,18673,16563,1656.3,1135,456,1
3188,1167,510,1631.5,16315,18067,7.0,7,7,6,201,20.1,0,0,1,0,0,240,24.0,0,2,2,2,6.8,17557,15148,1514.8,-510,-1167,0
3189,457,-383,1658.7,16587,16824,6.6,6,6,13,199,19.9,1,0,1,0,1,194,19.4,1,13,7,7,6.8,17207,16130,1613.0,383,-457,0
3190,276,377,1611.2,16112,16844,6.6,8,8,9,201,20.1,0,0,0,1,1,167,16.7,1,7,6,6,6.6,16467,15836,1583.6,-377,-276,0
3191,4429,3004,1821.2,18212,18905,7.2,10,10,12,196,19.6,2,1,1,0,0,180,18.0,0,1,2,2,6.6,15901,13783,1378.3,-3004,-4429,1
3192,-907,414,1476.1,14761,17479,7.0,3,3,2,204,20.4,0,0,0,1,1,225,22.5,1,6,5,5,6.6,17065,15668,1566.8,-414,907,0
3193,914,1227,1761.3,17613,19706,7.2,5,5,5,251,25.1,1,1,1,0,0,224,22.4,0,7,5,5,7.0,18479,16699,1669.9,-1227,-914,0
3194,-232,-1633,1638.4,16384,16954,6.8,8,8,13,218,21.8,0,0,1,0,0,242,24.2,0,3,5,5,7.2,18587,16616,1661.6,1633,232,0
3195,344,1270,1700.1,17001,19154,7.2,6,6,3,230,23.0,0,0,0,1,0,255,25.5,0,5,6,6,7.0,17884,16657,1665.7,-1270,-344,1
3196,-2904,-2819,1508.4,15084,16366,6.6,4,4,3,211,21.1,0,0,1,0,0,237,23.7,1,8,9,9,7.2,19185,17988,1798.8,2819,2904,0
3197,355,-336,1691.8,16918,18396,6.8,8,8,5,216,21.6,0,0,0,1,1,214,21.4,1,6,8,8,6.8,18732,16563,1656.3,336,-355,1
3198,1911,1969,1856.2,18562,18633,7.0,9,9,13,203,20.3,0,0,0,1,1,206,20.6,1,12,8,8,6.6,16664,16651,1665.1,-1969,-1911,1
3199,-1572,-2164,1582.2,15822,17481,7.0,5,5,9,219,21.9,1,1,1,0,0,248,24.8,1,3,6,6,7.2,19645,17394,1739.4,2164,1572,1
3200,1996,860,1740.5,17405,18506,6.8,9,9,10,187,18.7,1,1,1,0,0,236,23.6,0,3,4,4,7.0,17646,15409,1540.9,-860,-1996,0
3201,3802,1762,1969.6,19696,18881,7.2,11,11,12,222,22.2,2,1,1,0,0,209,20.9,0,6,5,5,6.8,17119,15894,1589.4,-1762,-3802,1
3202,-956,-1451,1732.2,17322,16229,6.4,9,9,11,182,18.2,0,0,1,0,1,207,20.7,1,12,11,11,6.8,17680,18278,1827.8,1451,956,1
3203,240,131,1553.2,15532,17669,6.8,4,4,4,227,22.7,0,0,1,0,0,240,24.0,0,2,2,2,6.8,17538,15292,1529.2,-131,-240,1
3204,828,-79,1782.3,17823,17275,6.6,10,10,7,237,23.7,0,0,1,0,1,200,20.0,1,5,8,8,6.8,17354,16995,1699.5,79,-828,0
3205,-5102,-3977,1329.1,13291,15898,6.4,1,1,0,201,20.1,0,0,0,1,1,227,22.7,2,18,12,12,7.4,19875,18393,1839.3,3977,5102,0
3206,-778,-752,1685.1,16851,16674,6.8,7,7,7,216,21.6,0,0,1,0,1,200,20.0,1,14,11,11,6.8,17426,17629,1762.9,752,778,1
3207,2431,1886,1683.0,16830,18443,7.2,7,7,8,232,23.2,0,0,1,0,0,209,20.9,0,2,2,2,6.6,16557,14399,1439.9,-1886,-2431,1
3208,530,1280,1606.1,16061,18238,7.0,5,5,7,210,21.0,0,0,1,0,0,204,20.4,0,5,5,5,6.8,16958,15531,1553.1,-1280,-530,1
3209,766,331,1560.8,15608,17516,6.8,2,2,2,260,26.0,0,0,0,1,0,229,22.9,0,2,2,2,7.0,17185,14842,1484.2,-331,-766,0
3210,-4172,-2185,1514.4,15144,16696,6.6,5,5,3,205,20.5,0,0,1,0,0,221,22.1,0,9,9,9,7.2,18881,19316,1931.6,2185,4172,0
3211,-1578,-2563,1577.8,15778,15796,6.2,7,7,7,213,21.3,0,0,0,1,1,201,20.1,2,3,6,6,7.2,18359,17356,1735.6,2563,1578,0
3212,-964,72,1472.1,14721,18073,7.0,2,2,1,234,23.4,0,0,0,1,1,238,23.8,1,4,4,4,7.0,18001,15685,1568.5,-72,964,1
3213,1764,1515,1615.4,16154,18075,7.0,8,8,6,192,19.2,0,0,0,1,1,210,21.0,2,2,3,3,6.4,16560,14390,1439.0,-1515,-1764,1
3214,-3212,-786,1513.6,15136,18082,7.0,6,6,4,170,17.0,0,0,0,1,1,227,22.7,1,9,9,9,7.0,18868,18348,1834.8,786,3212,0
3215,-2259,-2256,1423.1,14231,16339,6.6,2,2,3,201,20.1,0,0,1,0,1,234,23.4,1,5,4,4,7.0,18595,16490,1649.0,2256,2259,0
3216,1718,2947,1647.0,16470,19232,7.2,4,4,4,232,23.2,1,0,1,0,1,218,21.8,1,3,2,2,6.6,16285,14752,1475.2,-2947,-1718,1
3217,-1159,-157,1367.4,13674,17384,6.8,0,0,0,229,22.9,0,0,0,1,1,230,23.0,1,3,3,3,6.8,17541,14833,1483.3,157,1159,1
3218,-3232,-2573,1525.1,15251,16852,6.4,5,5,5,210,21.0,0,0,0,1,1,215,21.5,2,13,10,10,7.4,19425,18483,1848.3,2573,3232,0
3219,3248,2152,1885.6,18856,19227,7.2,11,11,14,231,23.1,1,0,1,0,1,189,18.9,1,7,5,5,6.6,17075,15608,1560.8,-2152,-3248,1
3220,-1248,-843,1627.4,16274,17652,6.8,7,7,8,204,20.4,0,0,1,0,0,211,21.1,0,13,9,9,7.2,18495,17522,1752.2,843,1248,1
3221,-136,-583,1724.1,17241,18072,7.0,7,7,5,242,24.2,1,0,0,1,1,234,23.4,1,7,8,8,7.4,18655,17377,1737.7,583,136,0
3222,-468,-1886,1620.1,16201,15667,6.4,4,4,4,204,20.4,1,0,1,0,1,210,21.0,1,10,8,8,6.8,17553,16669,1666.9,1886,468,1
3223,-3909,-2136,1562.2,15622,16556,6.6,5,5,6,200,20.0,0,0,0,1,1,222,22.2,2,8,10,10,7.2,18692,19531,1953.1,2136,3909,0
3224,961,-973,1757.5,17575,17019,6.4,7,7,8,209,20.9,1,1,1,0,0,208,20.8,0,8,6,6,7.0,17992,16614,1661.4,973,-961,0
3225,-2936,-1305,1640.8,16408,18014,7.0,5,5,8,228,22.8,1,1,0,1,0,232,23.2,0,17,10,10,7.0,19319,19344,1934.4,1305,2936,1
3226,1766,1606,1807.3,18073,19907,7.4,9,9,13,221,22.1,1,1,1,0,0,198,19.8,1,11,7,7,6.8,18301,16307,1630.7,-1606,-1766,1
3227,-2929,-1515,1537.0,15370,17168,6.6,4,4,4,200,20.0,0,0,0,1,1,217,21.7,1,13,9,9,7.0,18683,18299,1829.9,1515,2929,1
3228,-1944,-1062,1465.9,14659,17566,6.8,2,2,1,235,23.5,0,0,1,0,0,240,24.0,1,4,4,4,7.0,18628,16603,1660.3,1062,1944,0
3229,3164,287,1885.5,18855,18139,7.0,11,11,10,180,18.0,0,0,0,1,1,206,20.6,1,1,5,5,7.0,17852,15691,1569.1,-287,-3164,0
3230,-1947,-2097,1469.5,14695,16864,6.8,2,2,2,230,23.0,0,0,0,1,1,255,25.5,1,6,5,5,7.2,18961,16642,1664.2,2097,1947,0
3231,396,-1813,1792.7,17927,18100,6.8,6,6,7,213,21.3,1,0,0,1,1,229,22.9,1,8,7,7,7.4,19913,17531,1753.1,1813,-396,0
3232,1697,293,1632.6,16326,18135,7.0,5,5,5,217,21.7,1,1,1,0,0,246,24.6,1,2,2,2,6.6,17842,14629,1462.9,-293,-1697,1
3233,4845,2789,1855.2,18552,17072,6.6,12,12,13,207,20.7,1,1,1,0,0,183,18.3,0,4,4,4,6.0,14283,13707,1370.7,-2789,-4845,1
3234,3370,4484,1666.9,16669,18607,7.0,7,7,3,226,22.6,1,1,0,1,0,194,19.4,0,2,2,2,6.0,14123,13299,1329.9,-4484,-3370,1
3235,-5191,-3819,1530.4,15304,15933,6.4,6,6,8,175,17.5,0,0,0,1,0,229,22.9,0,15,13,13,7.2,19752,20495,2049.5,3819,5191,0
3236,-3024,-1285,1524.2,15242,16792,6.6,5,5,6,198,19.8,0,0,0,1,0,236,23.6,0,3,6,6,7.0,18077,18266,1826.6,1285,3024,0
3237,-2114,-1121,1423.7,14237,17344,6.6,2,2,5,178,17.8,1,0,0,1,1,248,24.8,1,5,3,3,7.0,18465,16351,1635.1,1121,2114,0
3238,-3555,-3207,1428.0,14280,15054,6.2,3,3,4,190,19.0,0,0,1,0,1,220,22.0,1,10,9,9,7.0,18261,17835,1783.5,3207,3555,0
3239,2309,1211,1880.9,18809,18415,7.0,9,9,15,225,22.5,0,0,1,0,1,185,18.5,1,8,8,8,7.0,17204,16500,1650.0,-1211,-2309,1
3240,-2554,-2576,1423.8,14238,16667,6.8,0,0,0,234,23.4,1,0,0,1,0,225,22.5,0,11,6,6,7.0,19243,16792,1679.2,2576,2554,0
3241,-654,-97,1510.1,15101,17275,6.8,4,4,5,205,20.5,1,1,1,0,0,212,21.2,0,10,5,5,7.0,17372,15755,1575.5,97,654,0
3242,4824,2940,1823.7,18237,19105,7.4,8,8,11,221,22.1,1,0,1,0,0,179,17.9,0,2,1,1,6.4,16165,13413,1341.3,-2940,-4824,1
3243,6883,5337,1982.0,19820,19369,7.2,8,8,5,247,24.7,1,1,1,0,0,179,17.9,1,1,1,1,6.0,14032,12937,1293.7,-5337,-6883,1
3244,-968,-3,1688.4,16884,17197,6.4,9,9,9,193,19.3,1,1,0,1,0,210,21.0,1,6,8,8,6.8,17200,17852,1785.2,3,968,0
3245,-4526,-2062,1588.0,15880,16941,6.6,6,6,7,204,20.4,1,1,0,1,0,201,20.1,0,23,14,14,7.0,19003,20406,2040.6,2062,4526,0
3246,-2850,-832,1543.0,15430,18275,6.8,4,4,3,240,24.0,0,0,0,1,1,235,23.5,1,7,9,9,7.4,19107,18280,1828.0,832,2850,0
3247,-2760,-1872,1425.8,14258,17644,7.0,2,2,2,216,21.6,0,0,0,1,1,248,24.8,2,6,5,5,7.2,19516,17018,1701.8,1872,2760,0
3248,-2145,-1335,1484.9,14849,17923,7.0,0,0,0,249,24.9,0,0,0,1,1,245,24.5,1,7,5,5,7.4,19258,16994,1699.4,1335,2145,1
3249,1202,-535,1702.3,17023,17502,6.8,7,7,6,198,19.8,0,0,1,0,0,180,18.0,1,5,7,7,7.0,18037,15821,1582.1,535,-1202,1
3250,3469,3684,1914.3,19143,20064,7.4,12,12,9,243,24.3,0,0,1,0,1,199,19.9,1,8,5,5,6.6,16380,15674,1567.4,-3684,-3469,1
3251,-1083,-127,1562.0,15620,17968,7.0,5,5,4,214,21.4,0,0,0,1,1,218,21.8,1,10,6,6,7.0,18095,16703,1670.3,127,1083,0
3252,914,34,1862.3,18623,17867,7.2,8,8,11,229,22.9,1,1,1,0,0,237,23.7,0,9,8,8,7.0,17833,17709,1770.9,-34,-914,1
3253,1436,1597,1656.4,16564,18605,7.0,5,5,5,222,22.2,0,0,0,1,1,221,22.1,1,5,3,3,6.8,17008,15128,1512.8,-1597,-1436,1
3254,2256,725,1842.1,18421,18519,7.2,11,11,16,232,23.2,1,1,0,1,0,222,22.2,0,7,7,7,6.8,17794,16165,1616.5,-725,-2256,1
3255,1206,1055,1736.4,17364,18990,7.0,7,7,8,215,21.5,1,0,1,0,1,248,24.8,1,4,5,5,7.0,17935,16158,1615.8,-1055,-1206,0
3256,243,-276,1674.9,16749,17759,7.0,8,8,14,174,17.4,1,1,0,1,0,227,22.7,0,1,7,7,6.8,18035,16506,1650.6,276,-243,1
3257,-368,-612,1798.7,17987,17683,6.8,9,9,9,209,20.9,0,0,0,1,0,236,23.6,0,11,10,10,7.2,18295,18355,1835.5,612,368,0
3258,-90,-739,1610.3,16103,18017,6.8,6,6,4,220,22.0,1,1,1,0,0,205,20.5,0,5,7,7,7.2,18756,16193,1619.3,739,90,0
3259,1717,1335,1838.4,18384,18718,7.2,10,10,12,226,22.6,0,0,1,0,0,229,22.9,0,10,6,6,6.8,17383,16667,1666.7,-1335,-1717,1
3260,875,276,1746.5,17465,17463,6.6,9,9,14,211,21.1,1,0,1,0,0,183,18.3,0,7,7,7,6.6,17187,16590,1659.0,-276,-875,1
3261,-2322,-2808,1559.1,15591,16788,6.6,6,6,8,204,20.4,0,0,0,1,1,216,21.6,1,7,9,9,7.2,19596,17913,1791.3,2808,2322,0
3262,1343,1089,1539.1,15391,17387,6.6,3,3,2,232,23.2,0,0,1,0,1,218,21.8,1,1,2,2,6.4,16298,14048,1404.8,-1089,-1343,1
3263,-3084,-1719,1495.3,14953,17850,6.8,2,2,2,228,22.8,0,0,0,1,1,258,25.8,1,9,9,9,7.4,19569,18037,1803.7,1719,3084,0
3264,1964,1416,1664.0,16640,18989,7.0,5,5,11,247,24.7,1,1,0,1,0,215,21.5,0,1,2,2,7.0,17573,14676,1467.6,-1416,-1964,1
3265,-257,-180,1550.1,15501,17414,7.0,3,3,4,245,24.5,1,1,0,1,0,199,19.9,0,7,5,5,6.8,17594,15758,1575.8,180,257,1
3266,3024,1980,1889.1,18891,19302,7.2,11,11,12,235,23.5,1,1,1,0,0,185,18.5,0,5,6,6,7.0,17322,15867,1586.7,-1980,-3024,0
3267,-647,543,1699.9,16999,18661,7.2,6,6,4,232,23.2,1,1,1,0,0,226,22.6,0,11,8,8,6.8,18118,17646,1764.6,-543,647,1
3268,939,1327,1829.1,18291,18744,7.0,11,11,11,195,19.5,0,0,0,1,0,209,20.9,0,9,8,8,7.0,17417,17352,1735.2,-1327,-939,1
3269,-1159,-73,1458.8,14588,18059,7.0,1,1,1,234,23.4,0,0,0,1,1,243,24.3,2,4,4,4,7.2,18132,15747,1574.7,73,1159,0
3270,2390,1778,1643.2,16432,18849,7.4,6,6,4,208,20.8,1,1,1,0,0,219,21.9,0,1,2,2,6.6,17071,14042,1404.2,-1778,-2390,1
3271,-2482,-2515,1619.9,16199,17974,6.8,5,5,3,216,21.6,1,0,1,0,1,219,21.9,1,13,10,10,7.4,20489,18681,1868.1,2515,2482,0
3272,-447,-955,1734.2,17342,17885,7.0,10,10,12,179,17.9,1,1,0,1,0,206,20.6,0,5,8,8,7.2,18840,17789,1778.9,955,447,1
3273,1351,940,1624.7,16247,19000,7.0,3,3,4,257,25.7,1,0,1,0,1,269,26.9,1,0,1,1,7.0,18060,14896,1489.6,-940,-1351,0
3274,1530,334,1703.8,17038,18971,7.2,8,8,4,233,23.3,1,1,1,0,0,233,23.3,1,2,4,4,6.8,18637,15508,1550.8,-334,-1530,1
3275,-2968,-2262,1460.7,14607,17527,6.8,3,3,2,204,20.4,0,0,1,0,1,243,24.3,2,8,6,6,7.6,19789,17575,1757.5,2262,2968,0
3276,-2574,-1057,1483.9,14839,16702,6.8,5,5,8,208,20.8,0,0,1,0,1,227,22.7,1,17,10,10,7.0,17759,17413,1741.3,1057,2574,0
3277,-1851,-1813,1514.2,15142,17554,7.0,3,3,5,235,23.5,0,0,1,0,1,242,24.2,2,9,7,7,7.2,19367,16993,1699.3,1813,1851,1
3278,840,145,1783.6,17836,19239,7.4,8,8,10,235,23.5,1,1,1,0,0,263,26.3,0,3,4,4,7.0,19094,16996,1699.6,-145,-840,0
3279,-626,239,1653.8,16538,18750,7.4,6,6,6,231,23.1,1,1,0,1,0,230,23.0,1,10,6,6,6.8,18511,17164,1716.4,-239,626,1
3280,4230,1545,2055.8,20558,18104,7.0,15,15,22,230,23.0,1,1,1,0,0,167,16.7,0,5,9,9,6.8,16559,16328,1632.8,-1545,-4230,1
3281,4173,1912,1981.3,19813,18543,7.0,13,13,18,236,23.6,1,1,1,0,0,167,16.7,0,7,5,5,6.6,16631,15640,1564.0,-1912,-4173,1
3282,1809,1633,1853.7,18537,19024,7.2,14,14,11,200,20.0,1,1,1,0,0,193,19.3,0,5,6,6,6.8,17391,16728,1672.8,-1633,-1809,1
3283,6304,5904,1780.6,17806,18750,7.0,5,5,5,244,24.4,2,1,1,0,0,155,15.5,0,0,0,0,5.4,12846,11502,1150.2,-5904,-6304,1
3284,5501,3548,2085.3,20853,20248,7.6,13,13,11,270,27.0,0,0,1,0,0,188,18.8,0,7,5,5,6.8,16700,15352,1535.2,-3548,-5501,1
3285,1218,1167,1644.1,16441,19798,7.2,5,5,5,243,24.3,0,0,0,1,0,252,25.2,1,2,2,2,7.0,18631,15223,1522.3,-1167,-1218,0
3286,-187,-361,1580.1,15801,18475,7.2,4,4,5,206,20.6,0,0,1,0,1,251,25.1,1,3,4,4,7.2,18836,15988,1598.8,361,187,0
3287,51,-1075,1587.1,15871,17211,6.8,4,4,6,229,22.9,1,1,0,1,0,216,21.6,0,2,5,5,7.0,18286,15820,1582.0,1075,-51,0
3288,-811,-798,1619.9,16199,16645,6.6,7,7,6,206,20.6,0,0,1,0,1,192,19.2,1,8,8,8,6.8,17443,17010,1701.0,798,811,0
3289,-2241,-1888,1583.1,15831,17389,6.6,5,5,7,208,20.8,0,0,0,1,1,218,21.8,2,13,9,9,7.2,19277,18072,1807.2,1888,2241,0
3290,-3794,-1962,1446.7,14467,16928,6.6,2,2,1,215,21.5,0,0,0,1,1,234,23.4,1,11,8,8,7.2,18890,18261,1826.1,1962,3794,0
3291,426,917,1779.5,17795,18362,7.0,6,6,12,228,22.8,1,1,1,0,0,194,19.4,1,15,10,10,6.8,17445,17369,1736.9,-917,-426,0
3292,-1741,-1348,1583.2,15832,18359,7.0,5,5,4,236,23.6,1,1,0,1,0,234,23.4,1,5,7,7,7.4,19707,17573,1757.3,1348,1741,1
3293,3058,3283,1817.0,18170,19022,7.0,13,13,9,191,19.1,2,1,1,0,0,189,18.9,0,6,5,5,6.4,15739,15112,1511.2,-3283,-3058,1
3294,1106,1014,1619.6,16196,18411,7.0,5,5,6,238,23.8,1,1,0,1,0,216,21.6,0,3,2,2,6.8,17397,15090,1509.0,-1014,-1106,0
3295,-1602,-1412,1468.0,14680,17465,7.0,2,2,4,207,20.7,0,0,0,1,1,243,24.3,2,2,3,3,7.2,18877,16282,1628.2,1412,1602,0
3296,569,-1349,1702.9,17029,17944,6.8,9,9,8,201,20.1,1,1,1,0,0,204,20.4,0,3,6,6,7.0,19293,16460,1646.0,1349,-569,1
3297,-873,-736,1429.8,14298,17567,6.4,3,3,4,228,22.8,0,0,0,1,0,238,23.8,0,2,3,3,7.0,18303,15171,1517.1,736,873,0
3298,-5327,-4636,1405.8,14058,16535,6.6,1,1,0,214,21.4,0,0,0,1,1,234,23.4,2,10,10,10,7.6,21171,19385,1938.5,4636,5327,0
3299,2745,1478,1738.5,17385,18040,6.8,8,8,11,221,22.1,2,1,1,0,0,203,20.3,0,6,4,4,6.6,16562,14640,1464.0,-1478,-2745,1
3300,2763,2019,1900.8,19008,19915,7.6,11,11,10,235,23.5,0,0,1,0,1,216,21.6,1,6,7,7,7.0,17896,16245,1624.5,-2019,-2763,1
3301,-22,86,1803.8,18038,18690,7.0,8,8,13,236,23.6,0,0,1,0,1,214,21.4,1,8,9,9,7.0,18604,18060,1806.0,-86,22,0
3302,1510,1545,1645.4,16454,18902,7.0,6,6,3,228,22.8,0,0,1,0,1,222,22.2,1,2,3,3,7.0,17357,14944,1494.4,-1545,-1510,1
3303,1099,-673,1831.3,18313,17999,7.0,11,11,9,214,21.4,1,1,1,0,0,178,17.8,0,6,9,9,6.8,18672,17214,1721.4,673,-1099,1
3304,2019,138,1705.7,17057,17917,6.8,6,6,7,243,24.3,0,0,1,0,0,209,20.9,0,6,3,3,6.8,17779,15038,1503.8,-138,-2019,1
3305,-4939,-3731,1504.6,15046,17088,6.8,4,4,5,214,21.4,0,0,1,0,0,251,25.1,1,16,11,11,7.6,20819,19985,1998.5,3731,4939,0
3306,-2471,-2179,1445.5,14455,16461,6.6,3,3,5,199,19.9,0,0,0,1,1,249,24.9,1,4,6,6,6.8,18640,16926,1692.6,2179,2471,0
3307,2532,1229,1848.0,18480,17912,6.8,11,11,12,201,20.1,0,0,1,0,0,203,20.3,0,10,5,5,6.6,16683,15948,1594.8,-1229,-2532,1
3308,1249,1879,1915.3,19153,18170,7.0,12,12,11,217,21.7,0,0,0,1,0,177,17.7,0,12,9,9,6.4,16291,17904,1790.4,-1879,-1249,1
3309,859,128,1668.8,16688,18714,7.2,5,5,5,226,22.6,1,1,1,0,0,242,24.2,0,5,4,4,7.0,18586,15829,1582.9,-128,-859,1
3310,-1737,-776,1556.7,15567,16972,6.6,6,6,6,167,16.7,0,0,0,1,1,245,24.5,1,6,8,8,7.0,17748,17304,1730.4,776,1737,0
3311,1453,1251,1542.9,15429,18375,6.8,3,3,3,218,21.8,1,1,1,0,0,231,23.1,0,0,0,0,6.6,17124,13976,1397.6,-1251,-1453,1
3312,616,43,1749.1,17491,18181,7.0,9,9,10,194,19.4,1,0,0,1,1,253,25.3,1,5,6,6,6.8,18138,16875,1687.5,-43,-616,1
3313,363,-1888,1767.9,17679,17322,6.8,9,9,15,222,22.2,1,1,1,0,0,230,23.0,1,7,6,6,7.2,19210,17316,1731.6,1888,-363,0
3314,2598,4512,1739.7,17397,19011,7.2,8,8,9,244,24.4,1,1,0,1,0,186,18.6,0,7,4,4,5.8,14499,14799,1479.9,-4512,-2598,1
3315,-5253,-5281,1441.6,14416,11286,5.2,7,7,11,90,9.0,0,0,0,1,0,203,20.3,0,19,14,14,6.6,16567,19669,1966.9,5281,5253,0
3316,-2234,-3264,1682.0,16820,16714,6.8,7,7,10,202,20.2,0,0,0,1,1,209,20.9,1,15,11,11,7.2,19978,19054,1905.4,3264,2234,0
3317,-127,-445,1565.9,15659,17407,6.8,6,6,5,211,21.1,0,0,1,0,1,209,20.9,2,6,4,4,6.8,17852,15786,1578.6,445,127,1
3318,3458,3204,1935.3,19353,18423,6.8,10,10,6,223,22.3,0,0,1,0,0,163,16.3,0,13,8,8,6.2,15219,15895,1589.5,-3204,-3458,1
3319,337,-260,1779.4,17794,18646,7.2,11,11,13,211,21.1,0,0,1,0,1,218,21.8,1,7,9,9,7.0,18906,17457,1745.7,260,-337,0
3320,-1041,-661,1644.3,16443,17912,6.8,7,7,2,228,22.8,1,1,1,0,0,216,21.6,0,9,8,8,7.0,18573,17484,1748.4,661,1041,1
3321,2421,3009,1777.3,17773,20821,7.6,7,7,9,242,24.2,0,0,1,0,0,221,22.1,0,2,2,2,7.0,17812,15352,1535.2,-3009,-2421,1
3322,-4822,-2537,1499.6,14996,17677,6.8,6,6,5,181,18.1,1,1,0,1,0,249,24.9,0,15,13,13,7.4,20214,19818,1981.8,2537,4822,1
3323,-2994,-1007,1580.3,15803,18061,7.0,5,5,3,217,21.7,1,1,0,1,0,248,24.8,1,12,9,9,7.2,19068,18797,1879.7,1007,2994,0
3324,-1539,-601,1624.1,16241,18864,7.0,6,6,8,211,21.1,0,0,0,1,1,249,24.9,1,9,9,9,7.2,19465,17780,1778.0,601,1539,1
3325,-76,1386,1777.4,17774,18440,7.0,11,11,11,180,18.0,1,1,0,1,0,190,19.0,0,9,9,9,6.8,17054,17850,1785.0,-1386,76,1
3326,-1482,256,1582.3,15823,18209,7.0,6,6,4,214,21.4,0,0,0,1,1,247,24.7,1,8,6,6,6.8,17953,17305,1730.5,-256,1482,0
3327,3847,2027,1768.4,17684,19113,7.4,10,10,7,224,22.4,0,0,1,0,0,217,21.7,0,0,0,0,6.8,17086,13837,1383.7,-2027,-3847,1
3328,3044,1775,1789.8,17898,18482,7.2,8,8,5,247,24.7,0,0,1,0,0,213,21.3,0,2,4,4,6.8,16707,14854,1485.4,-1775,-3044,0
3329,-1176,-1838,1556.2,15562,16991,6.8,3,3,3,222,22.2,2,1,1,0,0,201,20.1,0,9,5,5,7.0,18829,16738,1673.8,1838,1176,1
3330,-1659,-1134,1488.1,14881,17401,6.6,3,3,4,196,19.6,0,0,0,1,1,248,24.8,1,5,4,4,7.2,18535,16540,1654.0,1134,1659,0
3331,2547,1517,1663.6,16636,19367,7.0,5,5,9,246,24.6,2,1,0,1,0,215,21.5,0,0,2,2,6.8,17850,14089,1408.9,-1517,-2547,1
3332,-389,-29,1639.6,16396,18362,7.2,7,7,5,209,20.9,0,0,1,0,1,213,21.3,1,10,8,8,7.0,18391,16785,1678.5,29,389,1
3333,-1193,-843,1539.6,15396,16586,6.6,3,3,4,218,21.8,0,0,0,1,0,238,23.8,1,7,7,7,6.8,17429,16589,1658.9,843,1193,0
3334,-640,403,1816.4,18164,18492,7.0,11,11,7,198,19.8,1,0,1,0,1,204,20.4,1,14,11,11,7.0,18089,18804,1880.4,-403,640,1
3335,74,-513,1777.4,17774,17519,6.6,11,11,17,193,19.3,0,0,0,1,0,221,22.1,0,10,9,9,6.8,18032,17700,1770.0,513,-74,1
3336,1954,1045,1699.0,16990,18051,7.0,6,6,8,244,24.4,0,0,0,1,1,225,22.5,1,3,4,4,6.8,17006,15036,1503.6,-1045,-1954,0
3337,646,407,1650.8,16508,18539,7.0,6,6,6,228,22.8,1,1,1,0,0,238,23.8,0,2,2,2,6.8,18132,15862,1586.2,-407,-646,1
3338,-1585,-280,1553.3,15533,18287,6.8,3,3,1,244,24.4,0,0,0,1,1,256,25.6,1,10,6,6,7.0,18567,17118,1711.8,280,1585,0
3339,46,970,1539.1,15391,17937,7.0,4,4,5,191,19.1,1,1,1,0,0,236,23.6,0,2,3,3,6.8,16967,15345,1534.5,-970,-46,1
3340,-426,-2349,1507.6,15076,16299,6.4,2,2,3,196,19.6,0,0,1,0,0,218,21.8,1,3,3,3,6.8,18648,15502,1550.2,2349,426,1
3341,-524,-1029,1611.9,16119,16658,6.6,7,7,6,217,21.7,0,0,1,0,1,190,19.0,2,8,7,7,6.8,17687,16643,1664.3,1029,524,1
3342,-3773,-3783,1437.7,14377,17408,7.0,2,2,2,194,19.4,0,0,1,0,1,258,25.8,1,8,7,7,7.8,21191,18150,1815.0,3783,3773,0
3343,-4738,-2857,1395.8,13958,17193,6.6,3,3,0,176,17.6,0,0,0,1,1,264,26.4,2,4,7,7,7.4,20050,18696,1869.6,2857,4738,1
3344,1059,1185,1883.4,18834,17602,6.8,13,13,8,203,20.3,1,1,1,0,0,182,18.2,0,12,11,11,6.4,16417,17775,1777.5,-1185,-1059,1
3345,2330,1713,1789.5,17895,18393,7.0,10,10,6,208,20.8,1,1,1,0,0,204,20.4,0,7,7,7,6.6,16680,15565,1556.5,-1713,-2330,1
3346,434,740,1652.6,16526,18436,7.0,6,6,4,215,21.5,0,0,0,1,0,226,22.6,0,3,7,7,7.0,17696,16092,1609.2,-740,-434,1
3347,-1778,-1128,1607.5,16075,17316,6.8,8,8,9,200,20.0,0,0,0,1,1,208,20.8,1,10,9,9,7.0,18444,17853,1785.3,1128,1778,0
3348,412,-655,1894.7,18947,17963,6.8,9,9,10,215,21.5,1,0,0,1,1,241,24.1,1,13,10,10,7.2,18618,18535,1853.5,655,-412,0
3349,-2645,-1869,1513.7,15137,16725,6.6,3,3,2,214,21.4,0,0,0,1,1,225,22.5,1,7,10,10,7.2,18594,17782,1778.2,1869,2645,0
3350,804,365,1615.7,16157,17603,6.8,5,5,5,240,24.0,0,0,1,0,0,206,20.6,0,4,4,4,7.0,17238,15353,1535.3,-365,-804,0
3351,-619,190,1515.2,15152,17748,6.8,4,4,2,229,22.9,0,0,0,1,1,188,18.8,1,13,6,6,6.6,17558,15771,1577.1,-190,619,0
3352,2263,1326,1704.1,17041,17082,6.8,8,8,8,227,22.7,0,0,1,0,1,179,17.9,1,5,4,4,6.4,15756,14778,1477.8,-1326,-2263,1
3353,2805,2599,1674.2,16742,19873,7.4,6,6,7,236,23.6,1,1,1,0,0,254,25.4,0,0,0,0,6.6,17274,13937,1393.7,-2599,-2805,1
3354,-2392,-2503,1566.0,15660,17755,7.0,4,4,3,246,24.6,1,1,1,0,0,266,26.6,0,7,6,6,7.4,20258,18052,1805.2,2503,2392,0
3355,823,1225,1629.8,16298,19052,7.0,6,6,5,229,22.9,0,0,1,0,1,235,23.5,1,3,3,3,6.8,17827,15475,1547.5,-1225,-823,1
3356,-1160,-12,1586.0,15860,18449,7.2,4,4,5,228,22.8,1,1,1,0,0,203,20.3,1,9,7,7,7.0,18461,17020,1702.0,12,1160,1
3357,-1065,502,1580.9,15809,18321,7.2,6,6,3,239,23.9,1,1,1,0,0,235,23.5,1,8,8,8,7.0,17819,16874,1687.4,-502,1065,1
3358,6297,5777,1947.0,19470,20453,7.4,13,13,18,243,24.3,0,0,0,1,1,189,18.9,1,1,2,2,6.0,14676,13173,1317.3,-5777,-6297,1
3359,5255,2255,1966.0,19660,17870,7.0,15,15,22,186,18.6,2,1,1,0,0,183,18.3,0,4,4,4,6.2,15615,14405,1440.5,-2255,-5255,0
3360,-5167,-3200,1363.1,13631,15864,6.6,2,2,4,175,17.5,0,0,0,1,0,234,23.4,0,7,9,9,7.4,19064,18798,1879.8,3200,5167,0
3361,873,215,1674.8,16748,17343,6.8,8,8,11,209,20.9,0,0,0,1,0,235,23.5,0,5,5,5,7.0,17128,15875,1587.5,-215,-873,1
3362,-920,-451,1443.4,14434,17904,6.8,1,1,0,221,22.1,0,0,0,1,1,230,23.0,1,3,3,3,6.8,18355,15354,1535.4,451,920,0
3363,1099,-622,1628.7,16287,16978,7.0,5,5,5,235,23.5,0,0,1,0,0,183,18.3,0,4,5,5,6.8,17600,15188,1518.8,622,-1099,1
3364,-3465,-897,1510.2,15102,16371,6.6,4,4,3,201,20.1,1,1,0,1,0,253,25.3,1,11,8,8,6.6,17268,18567,1856.7,897,3465,0
3365,1412,737,1549.2,15492,18241,7.0,4,4,4,212,21.2,2,1,1,0,0,236,23.6,0,0,1,1,6.8,17504,14080,1408.0,-737,-1412,1
3366,-2814,-2772,1455.4,14554,16715,6.8,4,4,3,198,19.8,1,1,0,1,0,228,22.8,0,5,6,6,7.4,19487,17368,1736.8,2772,2814,1
3367,-1636,-2200,1540.3,15403,17661,6.8,4,4,5,216,21.6,0,0,0,1,1,245,24.5,1,5,6,6,7.2,19861,17039,1703.9,2200,1636,1
3368,-4912,-4457,1302.4,13024,15869,6.6,0,0,0,192,19.2,0,0,0,1,1,251,25.1,2,5,9,9,7.4,20326,17936,1793.6,4457,4912,0
3369,-1827,-1102,1579.9,15799,17838,6.8,5,5,7,242,24.2,1,1,0,1,0,243,24.3,1,10,7,7,7.0,18940,17626,1762.6,1102,1827,1
3370,-373,-212,1712.7,17127,17974,7.0,7,7,8,243,24.3,1,0,0,1,1,229,22.9,1,10,8,8,7.0,18186,17500,1750.0,212,373,0
3371,423,1071,1720.8,17208,18913,7.2,9,9,10,201,20.1,2,1,1,0,0,222,22.2,0,7,7,7,7.0,17842,16785,1678.5,-1071,-423,1
3372,-91,-2362,1686.0,16860,15585,6.2,8,8,17,183,18.3,0,0,0,1,0,204,20.4,0,7,7,7,6.8,17947,16951,1695.1,2362,91,1
3373,-1097,-674,1808.2,18082,17805,6.8,9,9,12,215,21.5,0,0,0,1,1,204,20.4,1,18,13,13,7.0,18479,19179,1917.9,674,1097,0
3374,-5062,-5699,1481.3,14813,14354,6.0,4,4,5,198,19.8,0,0,1,0,1,250,25.0,2,22,16,16,7.4,20053,19875,1987.5,5699,5062,0
3375,267,427,1798.9,17989,18476,7.0,8,8,14,254,25.4,0,0,0,1,0,219,21.9,0,11,7,7,7.0,18049,17722,1772.2,-427,-267,1
3376,-1053,-2759,1581.5,15815,16506,6.6,6,6,9,206,20.6,0,0,1,0,1,247,24.7,1,7,7,7,7.4,19265,16868,1686.8,2759,1053,1
3377,2664,3273,1799.1,17991,19538,7.4,8,8,12,219,21.9,1,1,0,1,0,187,18.7,0,7,5,5,6.6,16265,15327,1532.7,-3273,-2664,1
3378,-1611,-1380,1656.0,16560,17640,6.8,8,8,5,200,20.0,0,0,1,0,1,209,20.9,1,9,9,9,7.2,19020,18171,1817.1,1380,1611,0
3379,323,701,1526.0,15260,17619,7.0,4,4,5,191,19.1,0,0,0,1,1,212,21.2,2,0,3,3,6.6,16918,14937,1493.7,-701,-323,0
3380,-5820,-4066,1354.4,13544,15367,6.2,2,2,1,206,20.6,0,0,1,0,0,255,25.5,0,8,10,10,7.2,19433,19364,1936.4,4066,5820,0
3381,-1870,-71,1546.2,15462,18980,7.2,4,4,4,239,23.9,0,0,0,1,1,238,23.8,1,6,6,6,7.2,19051,17332,1733.2,71,1870,1
3382,-3761,-2552,1500.0,15000,16731,6.6,3,3,2,221,22.1,1,1,1,0,0,225,22.5,0,7,9,9,7.2,19283,18761,1876.1,2552,3761,0
3383,2036,2773,1639.9,16399,18784,7.4,6,6,6,235,23.5,1,0,1,0,1,221,22.1,1,2,2,2,6.6,16011,14363,1436.3,-2773,-2036,1
3384,-1087,-108,1459.4,14594,17746,6.8,5,5,1,184,18.4,0,0,0,1,0,220,22.0,0,3,5,5,7.0,17854,15681,1568.1,108,1087,0
3385,7995,4733,2104.6,21046,19706,7.4,13,13,10,250,25.0,1,0,1,0,0,179,17.9,0,0,2,2,6.4,14973,13051,1305.1,-4733,-7995,1
3386,-1182,-944,1538.2,15382,17876,7.0,4,4,5,218,21.8,1,1,0,1,0,207,20.7,1,4,6,6,7.0,18820,16564,1656.4,944,1182,0
3387,-1905,-2185,1609.5,16095,17192,6.8,5,5,8,222,22.2,0,0,0,1,0,217,21.7,0,12,9,9,7.2,19377,18000,1800.0,2185,1905,1
3388,-3630,668,1486.3,14863,17880,6.8,3,3,1,222,22.2,0,0,0,1,1,216,21.6,2,15,10,10,6.8,17212,18493,1849.3,-668,3630,0
3389,-788,-203,1766.8,17668,18625,7.2,10,10,9,194,19.4,0,0,0,1,1,185,18.5,1,18,9,9,7.0,18828,18456,1845.6,203,788,0
3390,-3593,-3086,1642.0,16420,16281,6.6,6,6,6,223,22.3,0,0,0,1,1,229,22.9,2,12,13,13,7.4,19367,20013,2001.3,3086,3593,0
3391,633,-944,1719.4,17194,18161,7.0,7,7,8,233,23.3,0,0,0,1,0,202,20.2,0,5,7,7,7.2,19105,16561,1656.1,944,-633,1
3392,3476,2025,1952.9,19529,19763,7.2,13,13,9,204,20.4,0,0,1,0,1,182,18.2,1,5,7,7,7.0,17738,16053,1605.3,-2025,-3476,1
3393,849,794,1776.2,17762,18599,7.0,9,9,11,233,23.3,1,1,0,1,0,200,20.0,0,8,7,7,6.8,17805,16913,1691.3,-794,-849,1
3394,1153,-5,1698.7,16987,18495,7.2,5,5,4,255,25.5,0,0,1,0,1,241,24.1,1,6,4,4,7.2,18500,15834,1583.4,5,-1153,1
3395,992,393,1698.5,16985,18420,7.2,7,7,7,248,24.8,0,0,1,0,1,229,22.9,1,5,4,4,6.6,18027,15993,1599.3,-393,-992,1
3396,-3193,-2101,1484.5,14845,16713,6.4,2,2,4,236,23.6,0,0,0,1,1,207,20.7,1,14,8,8,7.2,18814,18038,1803.8,2101,3193,0
3397,-787,-926,1817.4,18174,17137,6.8,11,11,10,222,22.2,0,0,0,1,1,225,22.5,1,16,11,11,6.6,18063,18961,1896.1,926,787,0
3398,860,284,1712.0,17120,18447,7.0,7,7,7,205,20.5,1,1,1,0,0,200,20.0,0,8,6,6,7.2,18163,16260,1626.0,-284,-860,1
3399,-400,-1311,1577.6,15776,16824,6.8,5,5,6,199,19.9,1,1,1,0,0,217,21.7,0,6,7,7,6.8,18135,16176,1617.6,1311,400,0
3400,-680,567,1717.5,17175,18994,7.0,5,5,6,264,26.4,0,0,0,1,1,239,23.9,1,11,8,8,7.0,18427,17855,1785.5,-567,680,1
3401,-1458,-618,1565.6,15656,16714,6.6,5,5,4,206,20.6,0,0,1,0,1,193,19.3,2,11,10,10,6.6,17332,17114,1711.4,618,1458,0
3402,-2153,-2348,1486.7,14867,17173,7.0,4,4,4,216,21.6,1,1,1,0,0,220,22.0,0,4,7,7,7.2,19521,17020,1702.0,2348,2153,0
3403,1895,635,1738.1,17381,18938,7.0,7,7,5,232,23.2,1,1,1,0,0,211,21.1,0,5,6,6,7.2,18303,15486,1548.6,-635,-1895,1
3404,5301,5872,1882.1,18821,20341,7.4,12,12,8,225,22.5,2,1,1,0,0,167,16.7,0,3,3,3,6.4,14469,13520,1352.0,-5872,-5301,1
3405,-2859,143,1445.9,14459,17799,6.8,4,4,5,173,17.3,0,0,0,1,0,242,24.2,0,8,5,5,7.0,17656,17318,1731.8,-143,2859,0
3406,-959,-1002,1665.4,16654,18387,7.0,6,6,6,239,23.9,1,1,0,1,0,211,21.1,0,12,9,9,7.0,19389,17613,1761.3,1002,959,0
3407,2152,1936,1743.8,17438,18793,7.2,6,6,11,249,24.9,0,0,0,1,1,227,22.7,2,7,4,4,6.8,16857,15286,1528.6,-1936,-2152,1
3408,300,427,1743.1,17431,18675,7.2,5,5,4,272,27.2,0,0,1,0,1,236,23.6,2,3,4,4,7.0,18248,17131,1713.1,-427,-300,1
3409,2060,1621,1732.7,17327,19938,7.4,6,6,5,240,24.0,1,1,1,0,0,226,22.6,0,2,4,4,7.0,18317,15267,1526.7,-1621,-2060,1
3410,-430,-1028,1763.7,17637,17342,6.8,7,7,5,196,19.6,2,1,1,0,0,210,21.0,0,16,10,10,7.2,18370,18067,1806.7,1028,430,1
3411,-620,-384,1602.1,16021,18021,6.8,6,6,4,199,19.9,1,1,1,0,0,217,21.7,0,9,8,8,7.2,18405,16641,1664.1,384,620,1
3412,2107,1105,1699.7,16997,17603,6.8,7,7,13,227,22.7,1,1,1,0,0,220,22.0,0,5,3,3,6.6,16498,14890,1489.0,-1105,-2107,1
3413,-2141,-52,1553.0,15530,17375,6.8,5,5,7,220,22.0,1,1,1,0,0,236,23.6,1,12,9,9,6.8,17427,17671,1767.1,52,2141,0
3414,-575,-1495,1456.9,14569,16380,6.6,2,2,2,234,23.4,0,0,0,1,1,200,20.0,1,3,6,6,7.0,17875,15144,1514.4,1495,575,1
3415,559,-140,1721.2,17212,18257,7.0,7,7,7,225,22.5,0,0,0,1,1,225,22.5,1,7,5,5,7.0,18397,16653,1665.3,140,-559,1
3416,-790,-834,1849.4,18494,19080,7.0,10,10,8,223,22.3,0,0,1,0,1,237,23.7,1,9,12,12,7.2,19914,19284,1928.4,834,790,0
3417,-2293,-1323,1563.2,15632,17715,6.8,4,4,3,230,23.0,1,0,0,1,1,234,23.4,1,13,8,8,7.2,19038,17925,1792.5,1323,2293,0
3418,2409,2186,1745.5,17455,19749,7.4,5,5,4,254,25.4,0,0,0,1,0,239,23.9,1,4,3,3,6.8,17563,15046,1504.6,-2186,-2409,1
3419,12,161,1571.6,15716,18832,7.0,5,5,4,221,22.1,1,1,0,1,0,244,24.4,0,3,3,3,6.8,18671,15704,1570.4,-161,-12,1
3420,2812,2747,1757.7,17577,20010,7.4,9,9,8,210,21.0,2,1,1,0,0,205,20.5,0,4,3,3,6.8,17263,14765,1476.5,-2747,-2812,1
3421,2435,1428,1782.2,17822,19861,7.2,7,7,10,237,23.7,1,1,1,0,0,215,21.5,0,4,3,3,6.8,18433,15387,1538.7,-1428,-2435,1
3422,759,657,1538.1,15381,17703,7.0,5,5,6,211,21.1,1,1,1,0,0,245,24.5,0,0,1,1,6.8,17046,14622,1462.2,-657,-759,0
3423,-215,-546,1548.5,15485,16891,6.6,5,5,7,201,20.1,0,0,1,0,1,170,17.0,2,8,7,7,6.8,17437,15700,1570.0,546,215,1
3424,1491,533,1695.3,16953,18804,7.2,6,6,5,238,23.8,1,0,1,0,1,213,21.3,1,4,5,5,7.0,18271,15462,1546.2,-533,-1491,1
3425,-6460,-5383,1322.9,13229,15040,6.4,2,2,0,177,17.7,0,0,0,1,0,233,23.3,0,11,14,14,7.4,20423,19689,1968.9,5383,6460,0
3426,-27,-649,1657.9,16579,19488,7.2,4,4,5,249,24.9,1,1,1,0,0,246,24.6,0,5,5,5,7.4,20137,16606,1660.6,649,27,1
3427,-1151,-753,1556.2,15562,17777,7.2,5,5,5,219,21.9,0,0,0,1,1,227,22.7,2,5,7,7,7.2,18530,16713,1671.3,753,1151,0
3428,662,44,1719.2,17192,18065,7.0,6,6,8,221,22.1,1,0,0,1,1,196,19.6,1,6,7,7,6.8,18021,16530,1653.0,-44,-662,1
3429,5121,2946,1876.4,18764,18764,7.0,7,7,9,268,26.8,1,0,1,0,0,201,20.1,0,2,1,1,6.4,15818,13643,1364.3,-2946,-5121,1
3430,-1876,-2154,1579.0,15790,16879,6.6,4,4,2,215,21.5,0,0,1,0,1,208,20.8,1,10,9,9,7.4,19033,17666,1766.6,2154,1876,0
3431,3844,2740,1938.0,19380,19467,7.2,10,10,11,244,24.4,1,1,1,0,0,189,18.9,0,6,6,6,6.4,16727,15536,1553.6,-2740,-3844,1
3432,-154,-193,1655.4,16554,17192,6.6,6,6,8,215,21.5,0,0,1,0,0,218,21.8,1,9,7,7,6.8,17385,16708,1670.8,193,154,0
3433,-5089,-1828,1401.7,14017,16680,6.6,3,3,4,185,18.5,0,0,0,1,0,245,24.5,0,10,9,9,7.0,18508,19106,1910.6,1828,5089,0
3434,4322,3830,2013.6,20136,19337,7.4,14,14,14,225,22.5,1,1,1,0,0,186,18.6,0,8,6,6,6.4,15507,15814,1581.4,-3830,-4322,0
3435,-450,-992,1671.7,16717,18457,7.2,7,7,6,223,22.3,1,1,1,0,0,247,24.7,0,5,6,6,7.2,19449,17167,1716.7,992,450,1
3436,-412,-609,1592.7,15927,17498,6.6,5,5,8,220,22.0,1,0,1,0,1,234,23.4,1,8,6,6,6.6,18107,16339,1633.9,609,412,1
3437,-5830,-3608,1572.9,15729,16459,6.6,6,6,8,186,18.6,0,0,0,1,0,225,22.5,1,14,14,14,7.4,20067,21559,2155.9,3608,5830,0
3438,-3402,-1459,1481.4,14814,17587,7.0,2,2,0,222,22.2,1,1,0,1,0,229,22.9,0,11,9,9,7.4,19046,18216,1821.6,1459,3402,0
3439,2044,378,1661.0,16610,18058,7.0,6,6,5,227,22.7,1,1,1,0,0,220,22.0,0,2,2,2,7.0,17680,14566,1456.6,-378,-2044,0
3440,1219,292,1758.8,17588,18328,7.0,7,7,7,233,23.3,2,1,1,0,0,216,21.6,0,10,6,6,6.8,18036,16369,1636.9,-292,-1219,1
3441,1598,2478,1601.7,16017,17471,7.2,6,6,4,208,20.8,1,1,0,1,0,194,19.4,0,6,4,4,6.2,14993,14419,1441.9,-2478,-1598,0
3442,-1068,-17,1485.1,14851,17101,6.6,2,2,5,245,24.5,0,0,0,1,1,212,21.2,2,7,5,5,6.8,17118,15919,1591.9,17,1068,0
3443,-2264,-1389,1542.0,15420,17930,6.8,4,4,3,235,23.5,2,1,1,0,0,237,23.7,0,7,7,7,7.4,19319,17684,1768.4,1389,2264,0
3444,-963,-546,1547.6,15476,16323,6.6,6,6,9,192,19.2,0,0,0,1,1,164,16.4,1,7,8,8,6.6,16869,16439,1643.9,546,963,1
3445,-2820,-1048,1446.3,14463,18394,6.8,1,1,3,224,22.4,0,0,0,1,1,258,25.8,1,8,5,5,7.4,19442,17283,1728.3,1048,2820,0
3446,1931,92,1765.3,17653,18042,7.2,9,9,15,218,21.8,1,1,1,0,0,205,20.5,0,6,6,6,7.0,17950,15722,1572.2,-92,-1931,1
3447,-429,55,1509.7,15097,18396,7.2,3,3,1,218,21.8,0,0,1,0,1,244,24.4,2,1,2,2,7.2,18341,15526,1552.6,-55,429,0
3448,-323,345,1647.6,16476,18421,7.0,6,6,2,238,23.8,1,1,1,0,0,231,23.1,0,10,4,4,7.0,18076,16799,1679.9,-345,323,1
3449,6290,4719,2013.6,20136,20899,7.8,12,12,12,235,23.5,1,1,1,0,0,201,20.1,0,0,1,1,6.4,16180,13846,1384.6,-4719,-6290,1
3450,-959,-1331,1438.5,14385,17383,6.6,2,2,3,216,21.6,0,0,1,0,1,223,22.3,1,2,2,2,7.0,18714,15344,1534.4,1331,959,0
3451,-1112,311,1667.2,16672,18758,7.0,6,6,4,231,23.1,0,0,1,0,0,211,21.1,0,8,9,9,6.8,18447,17784,1778.4,-311,1112,0
3452,431,625,1728.6,17286,18839,7.2,6,6,7,222,22.2,0,0,0,1,1,193,19.3,1,7,9,9,7.0,18214,16855,1685.5,-625,-431,1
3453,3001,1223,1638.5,16385,18374,7.0,4,4,4,249,24.9,0,0,1,0,1,213,21.3,1,0,1,1,6.8,17151,13384,1338.4,-1223,-3001,0
3454,1451,1154,1690.2,16902,17878,6.8,9,9,7,207,20.7,0,0,1,0,0,199,19.9,0,7,6,6,6.8,16724,15451,1545.1,-1154,-1451,1
3455,2735,2319,1712.7,17127,19195,7.2,8,8,11,221,22.1,2,1,1,0,0,208,20.8,0,2,2,2,6.6,16876,14392,1439.2,-2319,-2735,1
3456,4152,1466,1838.3,18383,18694,7.0,9,9,13,233,23.3,0,0,1,0,0,213,21.3,1,2,2,2,7.0,17228,14231,1423.1,-1466,-4152,1
3457,-2395,-3117,1547.5,15475,15944,6.4,6,6,4,205,20.5,0,0,0,1,1,210,21.0,1,13,10,10,7.2,19061,17870,1787.0,3117,2395,0
3458,227,939,1895.0,18950,18183,7.4,12,12,13,216,21.6,0,0,0,1,0,217,21.7,0,13,11,11,6.8,17244,18723,1872.3,-939,-227,1
3459,3843,2831,1694.2,16942,17249,6.6,7,7,11,214,21.4,1,1,1,0,0,191,19.1,0,0,0,0,6.2,14418,13099,1309.9,-2831,-3843,1
3460,-2055,-860,1542.3,15423,18648,7.2,3,3,3,232,23.2,0,0,0,1,1,258,25.8,1,10,7,7,7.2,19508,17478,1747.8,860,2055,0
3461,1011,17,1829.6,18296,18788,7.0,10,10,10,208,20.8,0,0,1,0,0,237,23.7,0,8,7,7,7.0,18771,17285,1728.5,-17,-1011,0
3462,-3865,-2920,1516.6,15166,15761,6.6,6,6,6,162,16.2,0,0,0,1,1,204,20.4,1,17,13,13,7.0,18681,19031,1903.1,2920,3865,0
3463,-1222,-125,1623.0,16230,18114,6.8,5,5,6,230,23.0,0,0,0,1,0,221,22.1,1,9,8,8,6.8,18239,17452,1745.2,125,1222,0
3464,5201,4398,2000.5,20005,20561,7.4,14,14,17,222,22.2,1,1,1,0,0,211,21.1,0,3,3,3,6.6,16163,14804,1480.4,-4398,-5201,1
3465,-953,-862,1448.5,14485,17358,6.6,2,2,3,211,21.1,0,0,1,0,0,246,24.6,0,2,1,1,7.0,18220,15438,1543.8,862,953,0
3466,496,1365,1531.3,15313,18483,7.0,2,2,3,221,22.1,1,1,0,1,0,237,23.7,0,2,2,2,6.8,17118,14817,1481.7,-1365,-496,0
3467,1412,1897,1714.7,17147,19004,7.2,9,9,7,197,19.7,0,0,1,0,1,210,21.0,1,4,6,6,6.8,17107,15735,1573.5,-1897,-1412,1
3468,-1408,-1192,1607.8,16078,18042,6.8,5,5,4,217,21.7,0,0,0,1,1,245,24.5,1,12,7,7,7.0,19234,17486,1748.6,1192,1408,0
3469,-2246,-961,1451.1,14511,17013,6.2,4,4,5,193,19.3,0,0,0,1,1,233,23.3,1,7,5,5,7.0,17974,16757,1675.7,961,2246,0
3470,1168,481,1522.4,15224,17138,6.6,4,4,4,218,21.8,1,1,1,0,0,231,23.1,0,0,1,1,6.4,16657,14056,1405.6,-481,-1168,0
3471,-2662,-2170,1598.9,15989,16090,6.4,7,7,7,179,17.9,0,0,1,0,1,204,20.4,1,16,10,10,7.0,18260,18651,1865.1,2170,2662,0
3472,2704,1740,1755.8,17558,19554,7.2,7,7,10,251,25.1,0,0,1,0,1,224,22.4,1,1,1,1,6.6,17814,14854,1485.4,-1740,-2704,1
3473,0,-368,1521.5,15215,16664,6.6,5,5,2,212,21.2,0,0,1,0,1,197,19.7,1,5,4,4,6.8,17032,15215,1521.5,368,0,1
3474,-3088,-2028,1488.7,14887,15841,6.4,4,4,2,209,20.9,0,0,1,0,0,203,20.3,0,12,9,9,6.8,17869,17975,1797.5,2028,3088,1
3475,-5508,-3521,1410.0,14100,16725,6.6,2,2,1,204,20.4,0,0,0,1,1,239,23.9,1,15,12,12,7.6,20246,19608,1960.8,3521,5508,0
3476,1800,546,1709.7,17097,17368,7.0,7,7,7,199,19.9,1,1,0,1,0,182,18.2,0,9,5,5,6.6,16822,15297,1529.7,-546,-1800,1
3477,-3196,-1322,1408.2,14082,16368,6.6,2,2,0,238,23.8,0,0,0,1,1,216,21.6,1,14,10,10,6.8,17690,17278,1727.8,1322,3196,0
3478,2077,266,1750.0,17500,18692,7.2,6,6,7,226,22.6,0,0,1,0,1,212,21.2,1,4,6,6,6.8,18426,15423,1542.3,-266,-2077,1
3479,2003,2155,1797.0,17970,19866,7.2,11,11,12,208,20.8,2,1,1,0,0,230,23.0,0,4,4,4,7.0,17711,15967,1596.7,-2155,-2003,1
3480,-266,15,1519.8,15198,18486,7.0,4,4,5,205,20.5,0,0,0,1,1,224,22.4,1,2,4,4,7.0,18471,15464,1546.4,-15,266,1
3481,2588,1628,1719.4,17194,19447,7.4,5,5,3,263,26.3,0,0,1,0,0,215,21.5,0,3,3,3,7.0,17819,14606,1460.6,-1628,-2588,1
3482,-2002,-565,1495.1,14951,17632,6.8,3,3,3,206,20.6,0,0,1,0,1,214,21.4,1,6,7,7,7.0,18197,16953,1695.3,565,2002,0
3483,1996,2078,1696.6,16966,19062,7.2,7,7,9,222,22.2,1,1,1,0,0,222,22.2,0,2,2,2,6.8,16984,14970,1497.0,-2078,-1996,0
3484,-1494,-368,1451.3,14513,16872,6.8,3,3,4,202,20.2,1,1,0,1,0,232,23.2,0,5,6,6,6.8,17240,16007,1600.7,368,1494,1
3485,1918,1638,1844.6,18446,19075,7.2,10,10,13,195,19.5,0,0,1,0,1,191,19.1,2,8,7,7,7.0,17437,16528,1652.8,-1638,-1918,0
3486,825,318,1710.0,17100,18774,7.2,8,8,9,213,21.3,0,0,0,1,1,196,19.6,1,10,6,6,7.2,18456,16275,1627.5,-318,-825,0
3487,4096,3516,2061.1,20611,19378,7.0,13,13,16,210,21.0,2,1,1,0,0,166,16.6,0,8,7,7,6.4,15862,16515,1651.5,-3516,-4096,1
3488,2427,742,1867.2,18672,19296,7.2,8,8,11,250,25.0,0,0,0,1,1,184,18.4,1,5,7,7,7.0,18554,16245,1624.5,-742,-2427,1
3489,428,-36,1498.8,14988,18065,7.2,1,1,1,256,25.6,0,0,0,1,1,220,22.0,1,1,3,3,7.0,18101,14560,1456.0,36,-428,0
3490,-862,-1596,1725.0,17250,18266,7.0,6,6,5,222,22.2,0,0,1,0,0,216,21.6,0,11,10,10,7.4,19862,18112,1811.2,1596,862,0
3491,5634,2094,2014.5,20145,19898,7.4,11,11,14,242,24.2,1,0,1,0,1,196,19.6,1,1,3,3,6.8,17804,14511,1451.1,-2094,-5634,1
3492,1243,1506,1732.5,17325,18954,7.0,7,7,8,207,20.7,1,1,0,1,0,218,21.8,0,4,4,4,6.8,17448,16082,1608.2,-1506,-1243,1
3493,6221,6143,1933.6,19336,21123,7.8,10,10,7,267,26.7,1,0,1,0,1,205,20.5,1,1,1,1,6.2,14980,13115,1311.5,-6143,-6221,1
3494,-4873,-2666,1370.1,13701,15626,6.6,1,1,0,200,20.0,0,0,0,1,1,222,22.2,1,12,11,11,7.2,18292,18574,1857.4,2666,4873,0
3495,-164,-313,1576.5,15765,17647,7.0,6,6,6,214,21.4,1,1,1,0,0,218,21.8,0,6,5,5,6.8,17960,15929,1592.9,313,164,0
3496,-224,635,1484.1,14841,17969,7.0,4,4,2,183,18.3,0,0,0,1,1,234,23.4,2,2,2,2,6.8,17334,15065,1506.5,-635,224,0
3497,717,215,1559.7,15597,17541,6.8,4,4,4,232,23.2,0,0,1,0,1,197,19.7,1,3,4,4,6.8,17326,14880,1488.0,-215,-717,0
3498,-3588,-2501,1382.8,13828,16964,6.6,1,1,0,228,22.8,0,0,0,1,0,258,25.8,0,6,7,7,7.2,19465,17416,1741.6,2501,3588,0
3499,-184,57,1627.5,16275,18687,7.2,6,6,9,209,20.9,0,0,0,1,1,250,25.0,1,3,5,5,7.2,18630,16459,1645.9,-57,184,0
3500,-729,-620,1676.3,16763,19010,7.2,5,5,5,252,25.2,0,0,0,1,1,241,24.1,2,6,7,7,7.2,19630,17492,1749.2,620,729,0
3501,5859,3289,2108.9,21089,18924,7.0,16,16,28,218,21.8,0,0,1,0,0,205,20.5,0,7,5,5,6.4,15635,15230,1523.0,-3289,-5859,1
3502,-2548,-826,1515.5,15155,16875,6.6,4,4,2,201,20.1,0,0,0,1,1,212,21.2,1,10,8,8,7.2,17701,17703,1770.3,826,2548,0
3503,2061,1693,1722.6,17226,18458,7.2,8,8,9,193,19.3,2,1,1,0,0,220,22.0,0,5,3,3,6.4,16765,15165,1516.5,-1693,-2061,1
3504,825,-1367,1763.4,17634,18416,7.2,7,7,6,237,23.7,1,0,1,0,1,215,21.5,1,4,7,7,7.0,19783,16809,1680.9,1367,-825,0
3505,1948,764,1756.2,17562,18512,7.0,9,9,8,224,22.4,1,1,0,1,0,202,20.2,0,6,3,3,7.0,17748,15614,1561.4,-764,-1948,1
3506,-167,855,1616.1,16161,18920,7.0,5,5,7,214,21.4,0,0,0,1,0,213,21.3,0,7,6,6,7.2,18065,16328,1632.8,-855,167,1
3507,5477,3692,2085.3,20853,20447,7.4,13,13,18,251,25.1,1,1,1,0,0,206,20.6,0,4,5,5,6.6,16755,15376,1537.6,-3692,-5477,1
3508,-251,557,1574.3,15743,18383,6.8,1,1,1,264,26.4,1,0,0,1,1,210,21.0,1,11,5,5,7.0,17826,15994,1599.4,-557,251,1
3509,153,917,1520.4,15204,17963,6.8,3,3,6,209,20.9,1,0,1,0,1,232,23.2,1,3,3,3,6.8,17046,15051,1505.1,-917,-153,1
3510,-741,-637,1501.3,15013,16860,6.6,3,3,4,212,21.2,0,0,0,1,1,225,22.5,1,7,4,4,6.8,17497,15754,1575.4,637,741,0
3511,5830,1979,2017.6,20176,19773,7.6,11,11,8,260,26.0,1,0,1,0,0,194,19.4,0,0,4,4,6.8,17794,14346,1434.6,-1979,-5830,1
3512,-460,60,1585.6,15856,17723,7.0,6,6,5,224,22.4,0,0,0,1,1,238,23.8,1,7,6,6,6.8,17663,16316,1631.6,-60,460,0
3513,1186,907,1709.7,17097,18583,7.2,9,9,10,220,22.0,2,1,1,0,0,213,21.3,0,3,4,4,7.0,17676,15911,1591.1,-907,-1186,1
3514,-829,289,1659.5,16595,18766,7.2,6,6,7,217,21.7,0,0,1,0,1,220,22.0,2,10,8,8,7.2,18477,17424,1742.4,-289,829,0
3515,-3559,-2812,1395.2,13952,15665,6.2,3,3,4,172,17.2,0,0,0,1,1,230,23.0,2,3,5,5,7.0,18477,17511,1751.1,2812,3559,0
3516,2377,2335,1841.3,18413,19681,7.2,11,11,6,228,22.8,2,1,1,0,0,172,17.2,0,7,7,7,7.0,17346,16036,1603.6,-2335,-2377,1
3517,1277,1357,1611.3,16113,18642,7.0,5,5,9,236,23.6,0,0,1,0,1,221,22.1,1,4,2,2,6.8,17285,14836,1483.6,-1357,-1277,0
3518,-919,-923,1550.8,15508,17985,7.0,2,2,1,258,25.8,0,0,0,1,0,226,22.6,0,8,5,5,7.2,18908,16427,1642.7,923,919,1
3519,941,-561,1834.5,18345,17559,6.8,12,12,16,222,22.2,1,1,1,0,0,207,20.7,1,8,9,9,7.0,18120,17404,1740.4,561,-941,0
3520,291,839,1888.2,18882,19357,7.2,12,12,10,224,22.4,0,0,1,0,0,222,22.2,0,13,11,11,6.8,18518,18591,1859.1,-839,-291,1
3521,-1871,-605,1473.4,14734,17665,6.8,3,3,1,226,22.6,0,0,1,0,0,231,23.1,0,6,6,6,7.0,18270,16605,1660.5,605,1871,0
3522,-1167,-1265,1533.7,15337,17456,6.8,4,4,4,211,21.1,0,0,0,1,0,173,17.3,0,8,9,9,7.0,18721,16504,1650.4,1265,1167,0
3523,447,609,1528.0,15280,18773,7.2,2,2,2,257,25.7,0,0,0,1,1,240,24.0,1,2,2,2,6.8,18164,14833,1483.3,-609,-447,0
3524,2211,1501,1686.1,16861,18561,7.2,7,7,8,196,19.6,0,0,1,0,1,208,20.8,1,1,2,2,7.0,17060,14650,1465.0,-1501,-2211,1
3525,-2593,-1668,1632.1,16321,17802,7.0,5,5,3,185,18.5,0,0,0,1,1,245,24.5,1,18,11,11,7.2,19470,18914,1891.4,1668,2593,1
3526,-1566,-2539,1588.5,15885,16848,6.6,5,5,8,220,22.0,0,0,1,0,1,221,22.1,1,7,7,7,7.2,19387,17451,1745.1,2539,1566,0
3527,-3397,-2492,1600.7,16007,17004,6.6,5,5,3,206,20.6,0,0,0,1,1,229,22.9,1,8,11,11,7.2,19496,19404,1940.4,2492,3397,0
3528,-857,-1356,1617.1,16171,17226,6.8,6,6,8,191,19.1,0,0,0,1,1,234,23.4,1,5,6,6,7.0,18582,17028,1702.8,1356,857,1
3529,-3796,-326,1572.6,15726,16968,6.4,8,8,8,176,17.6,0,0,0,1,0,219,21.9,0,7,9,9,6.8,17294,19522,1952.2,326,3796,0
3530,-2174,-117,1685.1,16851,17624,6.8,7,7,6,215,21.5,0,0,0,1,0,211,21.1,0,17,13,13,7.0,17741,19025,1902.5,117,2174,0
3531,-2969,-1135,1444.8,14448,17263,6.8,5,5,4,156,15.6,0,0,0,1,1,225,22.5,1,8,6,6,7.0,18398,17417,1741.7,1135,2969,0
3532,220,-284,1504.5,15045,16887,6.6,3,3,3,221,22.1,0,0,1,0,0,199,19.9,0,5,3,3,6.8,17171,14825,1482.5,284,-220,1
3533,-356,-408,1726.7,17267,17580,7.0,8,8,8,203,20.3,2,1,1,0,0,180,18.0,0,16,9,9,6.8,17988,17623,1762.3,408,356,1
3534,1893,763,1770.6,17706,18003,6.8,8,8,4,194,19.4,0,0,1,0,1,193,19.3,1,7,6,6,6.6,17240,15813,1581.3,-763,-1893,1
3535,-887,-1878,1557.6,15576,16352,6.6,5,5,5,221,22.1,0,0,1,0,0,197,19.7,1,7,7,7,7.0,18230,16463,1646.3,1878,887,0
3536,2439,2070,1708.4,17084,18215,7.2,6,6,7,227,22.7,1,1,1,0,0,208,20.8,0,9,4,4,6.6,16145,14645,1464.5,-2070,-2439,1
3537,-2683,-3323,1561.4,15614,16000,6.4,6,6,8,196,19.6,1,1,1,0,0,223,22.3,1,7,10,10,7.4,19323,18297,1829.7,3323,2683,0
3538,5238,2654,1960.2,19602,20259,7.4,10,10,13,236,23.6,1,1,1,0,0,209,20.9,0,2,1,1,6.8,17605,14364,1436.4,-2654,-5238,1
3539,-2550,-792,1540.9,15409,18219,7.0,2,2,1,247,24.7,0,0,1,0,1,256,25.6,1,10,7,7,7.0,19011,17959,1795.9,792,2550,0
3540,852,-26,1429.8,14298,15101,6.4,4,4,8,171,17.1,0,0,1,0,0,213,21.3,0,1,1,1,6.4,15127,13446,1344.6,26,-852,1
3541,3756,1754,1850.7,18507,19423,7.2,7,7,10,245,24.5,2,1,1,0,0,247,24.7,0,3,2,2,6.6,17669,14751,1475.1,-1754,-3756,1
3542,-97,1114,1617.9,16179,18305,7.0,5,5,5,263,26.3,0,0,0,1,1,221,22.1,2,7,6,6,6.8,17191,16276,1627.6,-1114,97,0
3543,1463,1571,1701.8,17018,19495,7.2,7,7,6,238,23.8,1,1,1,0,0,219,21.9,0,4,4,4,7.0,17924,15555,1555.5,-1571,-1463,1
3544,-961,-1427,1530.6,15306,16874,6.8,3,3,4,220,22.0,1,1,0,1,0,256,25.6,0,1,4,4,7.2,18301,16267,1626.7,1427,961,0
3545,-1226,-1378,1507.9,15079,18092,7.0,4,4,4,196,19.6,0,0,1,0,0,261,26.1,0,3,5,5,7.2,19470,16305,1630.5,1378,1226,0
3546,173,41,1762.2,17622,17879,7.2,9,9,11,192,19.2,1,1,1,0,0,227,22.7,0,7,7,7,6.8,17838,17449,1744.9,-41,-173,1
3547,1266,1770,1734.1,17341,19621,7.2,9,9,5,203,20.3,0,0,1,0,0,193,19.3,0,6,6,6,7.0,17851,16075,1607.5,-1770,-1266,0
3548,-585,-795,1586.8,15868,16452,6.6,6,6,5,201,20.1,0,0,1,0,0,242,24.2,0,7,6,6,6.8,17247,16453,1645.3,795,585,0
3549,-522,226,1717.0,17170,18583,7.0,9,9,8,204,20.4,1,1,0,1,0,192,19.2,0,10,10,10,7.0,18357,17692,1769.2,-226,522,1
3550,-3393,-1177,1571.6,15716,17135,6.8,6,6,5,189,18.9,1,1,0,1,0,206,20.6,0,19,12,12,6.8,18312,19109,1910.9,1177,3393,0
3551,-2855,-2453,1503.6,15036,17957,7.2,3,3,3,198,19.8,0,0,0,1,1,269,26.9,1,7,8,8,7.4,20410,17891,1789.1,2453,2855,0
3552,-114,1359,1660.8,16608,18490,7.2,8,8,5,201,20.1,0,0,0,1,1,200,20.0,1,10,9,9,6.8,17131,16722,1672.2,-1359,114,1
3553,-77,416,1611.6,16116,17070,6.8,6,6,9,196,19.6,0,0,0,1,1,204,20.4,1,11,8,8,6.6,16654,16193,1619.3,-416,77,0
3554,7420,5869,2138.6,21386,20807,7.4,13,13,11,264,26.4,1,1,1,0,0,190,19.0,0,3,3,3,6.0,14938,13966,1396.6,-5869,-7420,1
3555,132,-2613,1644.1,16441,16272,6.4,7,7,8,218,21.8,0,0,0,1,1,203,20.3,1,6,6,6,7.0,18885,16309,1630.9,2613,-132,0
3556,-1995,-1392,1544.6,15446,16131,6.4,6,6,4,198,19.8,0,0,0,1,1,216,21.6,1,7,8,8,7.0,17523,17441,1744.1,1392,1995,0
3557,-1069,-1901,1579.9,15799,16589,6.4,5,5,7,224,22.4,0,0,1,0,0,215,21.5,0,5,7,7,7.0,18490,16868,1686.8,1901,1069,0
3558,-292,-506,1790.9,17909,18562,7.0,9,9,11,214,21.4,1,1,0,1,0,205,20.5,0,13,11,11,7.2,19068,18201,1820.1,506,292,1
3559,-4962,-2312,1530.9,15309,16938,6.6,4,4,5,175,17.5,0,0,0,1,0,242,24.2,1,14,13,13,7.2,19250,20271,2027.1,2312,4962,0
3560,3669,3030,1907.7,19077,18861,7.2,13,13,11,215,21.5,1,1,1,0,0,207,20.7,0,5,4,4,6.4,15831,15408,1540.8,-3030,-3669,1
3561,-2338,-2724,1532.1,15321,17311,6.6,7,7,5,171,17.1,0,0,1,0,0,225,22.5,0,10,7,7,7.4,20035,17659,1765.9,2724,2338,0
3562,-3596,-2738,1452.2,14522,15305,6.4,3,3,2,211,21.1,0,0,0,1,0,236,23.6,1,6,8,8,7.0,18043,18118,1811.8,2738,3596,0
3563,1295,435,1799.6,17996,18896,7.0,8,8,7,208,20.8,2,1,0,1,0,227,22.7,0,5,7,7,7.0,18461,16701,1670.1,-435,-1295,0
3564,-168,376,1644.7,16447,18423,7.0,6,6,10,201,20.1,1,1,1,0,0,224,22.4,0,10,7,7,7.0,18047,16615,1661.5,-376,168,0
3565,-5375,-4425,1306.8,13068,15506,6.4,0,0,0,198,19.8,0,0,0,1,1,235,23.5,2,5,7,7,7.2,19931,18443,1844.3,4425,5375,0
3566,2341,2225,1775.7,17757,18821,7.0,9,9,8,217,21.7,0,0,1,0,1,185,18.5,1,5,5,5,6.8,16596,15416,1541.6,-2225,-2341,0
3567,-531,-1077,1745.9,17459,17338,6.8,9,9,11,226,22.6,0,0,1,0,0,200,20.0,0,11,9,9,7.2,18415,17990,1799.0,1077,531,0
3568,-3083,-2239,1406.8,14068,17057,6.8,3,3,1,206,20.6,0,0,0,1,0,252,25.2,0,6,7,7,7.0,19296,17151,1715.1,2239,3083,1
3569,-4808,-4098,1396.0,13960,15667,6.2,3,3,1,202,20.2,0,0,0,1,1,241,24.1,1,9,8,8,7.4,19765,18768,1876.8,4098,4808,0
3570,-1237,-874,1825.5,18255,17685,6.8,10,10,8,206,20.6,1,0,0,1,0,203,20.3,0,22,13,13,7.0,18559,19492,1949.2,874,1237,1
3571,408,742,1713.4,17134,19465,7.0,7,7,8,207,20.7,0,0,1,0,1,236,23.6,1,4,5,5,7.2,18723,16726,1672.6,-742,-408,1
3572,274,-459,1748.7,17487,17660,6.8,10,10,12,211,21.1,0,0,1,0,1,198,19.8,1,13,9,9,7.0,18119,17213,1721.3,459,-274,0
3573,-956,16,1633.5,16335,17339,6.6,6,6,4,192,19.2,0,0,1,0,0,202,20.2,1,11,10,10,6.8,17323,17291,1729.1,-16,956,0
3574,861,1078,1640.5,16405,18502,7.0,5,5,6,239,23.9,1,0,1,0,1,233,23.3,1,9,5,5,6.6,17424,15544,1554.4,-1078,-861,1
3575,-5471,-4481,1414.5,14145,15252,6.0,3,3,5,186,18.6,0,0,1,0,1,228,22.8,2,10,11,11,7.6,19733,19616,1961.6,4481,5471,0
3576,159,363,1641.9,16419,17295,6.8,5,5,6,233,23.3,0,0,0,1,1,194,19.4,2,5,5,5,6.6,16932,16260,1626.0,-363,-159,1
3577,-3335,-2502,1448.2,14482,17114,6.8,3,3,3,198,19.8,0,0,1,0,1,248,24.8,2,4,4,4,7.2,19616,17817,1781.7,2502,3335,1
3578,803,798,1596.7,15967,17855,6.8,5,5,5,203,20.3,1,1,1,0,0,226,22.6,0,6,4,4,6.8,17057,15164,1516.4,-798,-803,1
3579,-700,-1781,1609.3,16093,17056,6.8,5,5,5,209,20.9,0,0,0,1,0,192,19.2,0,6,9,9,7.0,18837,16793,1679.3,1781,700,0
3580,5491,4640,2082.7,20827,19657,7.4,16,16,13,215,21.5,0,0,1,0,0,183,18.3,0,4,4,4,6.4,15017,15336,1533.6,-4640,-5491,1
3581,-1620,-1655,1469.7,14697,17818,7.0,4,4,2,222,22.2,1,1,0,1,0,255,25.5,0,4,4,4,7.4,19473,16317,1631.7,1655,1620,0
3582,-1478,-1657,1770.2,17702,16589,6.4,10,10,10,198,19.8,0,0,0,1,0,202,20.2,0,14,11,11,6.8,18246,19180,1918.0,1657,1478,0
3583,-4406,-2663,1473.0,14730,17103,6.6,2,2,2,246,24.6,1,1,0,1,0,233,23.3,1,6,9,9,7.6,19766,19136,1913.6,2663,4406,0
3584,-1015,-1031,1687.6,16876,16812,6.6,6,6,10,238,23.8,0,0,0,1,0,212,21.2,0,9,10,10,6.8,17843,17891,1789.1,1031,1015,0
3585,-5057,-3732,1620.3,16203,17059,6.6,5,5,7,187,18.7,0,0,0,1,1,255,25.5,1,16,15,15,7.4,20791,21260,2126.0,3732,5057,1
3586,1465,1232,1721.4,17214,18232,7.2,7,7,7,219,21.9,1,0,1,0,1,193,19.3,1,4,7,7,6.8,17000,15749,1574.9,-1232,-1465,0
3587,-3720,-2126,1401.9,14019,17177,6.6,1,1,0,206,20.6,1,1,0,1,0,251,25.1,0,10,8,8,7.4,19303,17739,1773.9,2126,3720,1
3588,-1825,-1174,1616.3,16163,16956,6.8,8,8,2,201,20.1,0,0,0,1,1,196,19.6,1,13,10,10,7.2,18130,17988,1798.8,1174,1825,0
3589,-2082,-1005,1574.5,15745,17708,6.8,5,5,7,225,22.5,2,1,0,1,0,264,26.4,0,5,7,7,7.0,18713,17827,1782.7,1005,2082,0
3590,2109,3154,1893.3,18933,19905,7.4,13,13,13,210,21.0,0,0,0,1,0,194,19.4,0,10,6,6,6.6,16751,16824,1682.4,-3154,-2109,1
3591,772,702,1645.2,16452,19169,7.4,4,4,4,266,26.6,1,1,0,1,0,215,21.5,0,2,4,4,7.0,18467,15680,1568.0,-702,-772,1
3592,1338,-385,1652.7,16527,17257,7.0,6,6,11,225,22.5,0,0,1,0,0,191,19.1,0,7,4,4,7.0,17642,15189,1518.9,385,-1338,0
3593,841,-678,1697.7,16977,16961,6.6,7,7,8,222,22.2,0,0,0,1,0,216,21.6,0,8,6,6,6.8,17639,16136,1613.6,678,-841,0
3594,-2933,-2159,1387.4,13874,15799,6.4,1,1,1,219,21.9,0,0,0,1,1,215,21.5,2,8,7,7,7.0,17958,16807,1680.7,2159,2933,0
3595,-88,555,1727.2,17272,18189,7.0,10,10,10,210,21.0,2,1,0,1,0,223,22.3,0,13,8,8,7.0,17634,17360,1736.0,-555,88,0
3596,-3346,-1685,1512.5,15125,17217,6.8,4,4,2,223,22.3,0,0,0,1,1,219,21.9,2,8,7,7,7.2,18902,18471,1847.1,1685,3346,0
3597,-4024,-1999,1469.1,14691,17573,6.8,2,2,4,207,20.7,0,0,0,1,1,242,24.2,1,18,9,9,7.4,19572,18715,1871.5,1999,4024,0
3598,1155,868,1696.1,16961,18707,7.2,6,6,3,240,24.0,0,0,1,0,1,201,20.1,1,6,5,5,6.8,17839,15806,1580.6,-868,-1155,0
3599,1004,458,1668.8,16688,18637,7.0,3,3,4,215,21.5,0,0,0,1,0,231,23.1,0,4,3,3,7.0,18179,15684,1568.4,-458,-1004,1
3600,2043,1866,1714.3,17143,18702,7.2,4,4,3,237,23.7,1,0,1,0,1,236,23.6,1,4,3,3,6.4,16836,15100,1510.0,-1866,-2043,1
3601,811,426,1809.7,18097,18058,7.0,7,7,6,243,24.3,1,0,1,0,1,194,19.4,1,12,9,9,6.6,17632,17286,1728.6,-426,-811,1
3602,4275,2943,1927.6,19276,19210,7.4,11,11,14,237,23.7,1,1,1,0,0,205,20.5,0,6,3,3,6.4,16267,15001,1500.1,-2943,-4275,1
3603,-218,-840,1711.4,17114,18783,7.0,7,7,8,210,21.0,1,1,0,1,0,226,22.6,0,6,7,7,7.4,19623,17332,1733.2,840,218,0
3604,-786,-808,1660.2,16602,16879,6.8,8,8,8,163,16.3,0,0,0,1,0,206,20.6,0,2,6,6,6.8,17687,17388,1738.8,808,786,1
3605,-3359,-2255,1497.5,14975,15932,6.4,5,5,4,194,19.4,0,0,0,1,1,221,22.1,1,8,11,11,7.0,18187,18334,1833.4,2255,3359,0
3606,-2292,-810,1584.3,15843,16910,7.0,6,6,7,206,20.6,1,1,0,1,0,210,21.0,0,11,9,9,6.8,17720,18135,1813.5,810,2292,1
3607,-1838,-366,1577.7,15777,18110,6.8,6,6,3,203,20.3,0,0,0,1,1,214,21.4,1,8,7,7,7.0,18476,17615,1761.5,366,1838,0
3608,2121,1813,1714.2,17142,18615,7.0,10,10,5,221,22.1,0,0,1,0,0,200,20.0,0,3,6,6,6.4,16802,15021,1502.1,-1813,-2121,1
3609,2394,873,1802.7,18027,17905,7.0,7,7,11,217,21.7,0,0,1,0,1,219,21.9,1,5,6,6,6.8,17032,15633,1563.3,-873,-2394,1
3610,-1084,-1632,1600.3,16003,17885,6.8,4,4,6,238,23.8,1,1,1,0,0,244,24.4,0,8,5,5,7.2,19517,17087,1708.7,1632,1084,1
3611,1159,3144,1911.6,19116,19104,7.0,11,11,9,220,22.0,1,1,0,1,0,169,16.9,0,14,11,11,6.4,15960,17957,1795.7,-3144,-1159,1
3612,1328,1106,1807.8,18078,18102,6.8,11,11,17,192,19.2,1,1,0,1,0,197,19.7,0,6,7,7,6.8,16996,16750,1675.0,-1106,-1328,1
3613,1522,277,1801.1,18011,18540,7.0,8,8,8,243,24.3,1,1,0,1,0,210,21.0,0,7,8,8,7.2,18263,16489,1648.9,-277,-1522,1
3614,-3534,-1814,1533.6,15336,16216,6.8,6,6,6,196,19.6,0,0,1,0,1,208,20.8,1,13,13,13,7.0,18030,18870,1887.0,1814,3534,0
3615,292,760,1727.3,17273,18685,7.2,6,6,6,226,22.6,1,1,0,1,0,225,22.5,0,10,7,7,6.8,17925,16981,1698.1,-760,-292,0
3616,2561,1875,1787.5,17875,18320,7.0,9,9,8,203,20.3,0,0,1,0,0,179,17.9,0,6,7,7,6.6,16445,15314,1531.4,-1875,-2561,0
3617,-1908,-994,1721.5,17215,17349,6.8,9,9,14,198,19.8,0,0,0,1,0,235,23.5,0,11,10,10,7.2,18343,19123,1912.3,994,1908,0
3618,-1815,-1309,1557.9,15579,16747,6.8,6,6,10,204,20.4,0,0,0,1,1,205,20.5,2,8,8,8,7.0,18056,17394,1739.4,1309,1815,1
3619,-266,-65,1647.9,16479,16357,6.6,6,6,9,230,23.0,0,0,0,1,1,186,18.6,2,13,8,8,6.6,16422,16745,1674.5,65,266,0
3620,-1382,-271,1391.8,13918,17189,6.8,2,2,6,209,20.9,1,1,0,1,0,260,26.0,0,1,3,3,6.8,17460,15300,1530.0,271,1382,0
3621,2643,3340,1761.5,17615,19117,7.2,9,9,8,218,21.8,2,1,0,1,0,194,19.4,0,6,5,5,6.4,15777,14972,1497.2,-3340,-2643,1
3622,1259,720,1584.8,15848,18490,7.0,3,3,1,251,25.1,1,1,1,0,0,220,22.0,0,2,3,3,6.8,17770,14589,1458.9,-720,-1259,0
3623,1231,93,1594.1,15941,17560,7.2,6,6,6,228,22.8,0,0,1,0,0,212,21.2,0,3,3,3,6.8,17467,14710,1471.0,-93,-1231,0
3624,-2279,-958,1444.8,14448,17294,6.8,2,2,1,198,19.8,2,1,1,0,0,239,23.9,0,7,6,6,7.2,18252,16727,1672.7,958,2279,1
3625,753,263,1571.9,15719,19029,7.4,3,3,4,230,23.0,0,0,1,0,1,236,23.6,1,3,2,2,7.2,18766,14966,1496.6,-263,-753,1
3626,-201,-1063,1713.9,17139,16389,6.6,8,8,9,199,19.9,0,0,0,1,1,167,16.7,1,11,10,10,6.8,17452,17340,1734.0,1063,201,0
3627,1033,1209,1597.7,15977,17115,6.8,4,4,4,224,22.4,1,1,0,1,0,185,18.5,0,3,4,4,6.4,15906,14944,1494.4,-1209,-1033,0
3628,-353,-370,1493.8,14938,17538,6.8,2,2,2,246,24.6,1,1,1,0,0,230,23.0,0,6,4,4,7.0,17908,15291,1529.1,370,353,1
3629,619,1021,1718.7,17187,18709,7.0,9,9,13,199,19.9,0,0,1,0,1,214,21.4,1,6,6,6,6.8,17688,16568,1656.8,-1021,-619,0
3630,-483,-427,1755.8,17558,17905,6.8,8,8,10,202,20.2,1,0,1,0,1,205,20.5,1,9,9,9,7.2,18332,18041,1804.1,427,483,1
3631,2404,1129,1794.5,17945,18758,7.0,6,6,5,268,26.8,2,1,1,0,0,260,26.0,0,1,2,2,6.8,17629,15541,1554.1,-1129,-2404,1
3632,-244,78,1515.1,15151,16795,6.8,5,5,10,203,20.3,0,0,0,1,0,215,21.5,0,6,5,5,6.4,16717,15395,1539.5,-78,244,1
3633,-2653,-1372,1498.3,14983,16993,6.8,4,4,5,208,20.8,0,0,0,1,1,207,20.7,1,16,11,11,7.0,18365,17636,1763.6,1372,2653,1
3634,94,-487,1652.7,16527,16322,6.6,6,6,7,229,22.9,1,1,0,1,0,190,19.0,0,11,7,7,6.8,16809,16433,1643.3,487,-94,1
3635,-736,-226,1635.9,16359,17830,7.0,8,8,4,204,20.4,1,1,0,1,0,232,23.2,1,7,8,8,7.2,18056,17095,1709.5,226,736,0
3636,4034,1938,1903.8,19038,18856,7.2,8,8,12,239,23.9,1,1,1,0,0,228,22.8,0,4,3,3,6.8,16918,15004,1500.4,-1938,-4034,1
3637,609,-609,1597.6,15976,17352,6.8,5,5,10,232,23.2,1,1,0,1,0,235,23.5,1,5,4,4,7.0,17961,15367,1536.7,609,-609,0
3638,-2327,-742,1351.2,13512,16628,6.4,1,1,1,224,22.4,0,0,0,1,1,215,21.5,1,6,4,4,7.0,17370,15839,1583.9,742,2327,0
3639,-3916,-2883,1492.3,14923,17285,6.8,5,5,6,173,17.3,0,0,1,0,1,239,23.9,1,8,9,9,7.4,20168,18839,1883.9,2883,3916,0
3640,-725,-925,1612.4,16124,17227,6.6,6,6,6,225,22.5,1,0,1,0,1,246,24.6,1,6,6,6,6.8,18152,16849,1684.9,925,725,0
3641,-2675,-2192,1405.8,14058,16215,6.6,1,1,1,213,21.3,0,0,0,1,0,229,22.9,1,4,6,6,7.0,18407,16733,1673.3,2192,2675,0
3642,-2346,-1871,1442.2,14422,16781,6.8,3,3,4,201,20.1,0,0,1,0,0,237,23.7,0,6,6,6,7.2,18652,16768,1676.8,1871,2346,0
3643,-65,1208,1653.9,16539,19570,7.4,5,5,7,242,24.2,1,1,0,1,0,230,23.0,0,7,6,6,7.0,18362,16604,1660.4,-1208,65,1
3644,-3750,-1447,1579.4,15794,16652,6.6,5,5,6,203,20.3,0,0,0,1,1,212,21.2,1,13,10,10,6.8,18099,19544,1954.4,1447,3750,0
3645,150,-446,1686.7,16867,17923,6.8,8,8,15,228,22.8,0,0,1,0,1,222,22.2,1,5,7,7,7.2,18369,16717,1671.7,446,-150,0
3646,-1383,-970,1719.7,17197,18127,7.2,9,9,9,205,20.5,0,0,1,0,0,232,23.2,0,12,9,9,7.0,19097,18580,1858.0,970,1383,0
3647,-1441,-938,1588.1,15881,16164,6.4,5,5,5,204,20.4,1,0,1,0,1,197,19.7,1,16,9,9,6.8,17102,17322,1732.2,938,1441,1
3648,4898,3092,1937.3,19373,19208,7.2,11,11,14,228,22.8,0,0,0,1,1,190,19.0,1,2,3,3,6.6,16116,14475,1447.5,-3092,-4898,1
3649,503,-194,1654.8,16548,17430,6.6,6,6,10,230,23.0,0,0,0,1,1,211,21.1,2,8,5,5,7.0,17624,16045,1604.5,194,-503,0
3650,-6319,-3391,1412.6,14126,15246,6.4,3,3,4,200,20.0,0,0,0,1,1,193,19.3,1,22,13,13,7.2,18637,20445,2044.5,3391,6319,0
3651,238,275,1651.8,16518,17024,6.6,7,7,9,202,20.2,0,0,0,1,0,210,21.0,0,9,5,5,6.6,16749,16280,1628.0,-275,-238,1
3652,-3048,-3175,1589.7,15897,17075,6.8,5,5,7,215,21.5,0,0,1,0,1,245,24.5,1,8,11,11,7.4,20250,18945,1894.5,3175,3048,1
3653,8234,6026,2284.5,22845,19608,7.4,13,13,8,250,25.0,0,0,0,1,0,158,15.8,0,5,5,5,6.0,13582,14611,1461.1,-6026,-8234,1
3654,-925,41,1444.5,14445,17594,6.8,1,1,2,232,23.2,1,1,0,1,0,211,21.1,0,9,5,5,7.0,17553,15370,1537.0,-41,925,0
3655,1339,614,1729.3,17293,18795,7.0,6,6,3,231,23.1,1,0,1,0,1,236,23.6,1,6,5,5,7.2,18181,15954,1595.4,-614,-1339,1
3656,1201,-46,1723.9,17239,18339,6.8,8,8,7,210,21.0,0,0,1,0,1,225,22.5,1,4,4,4,7.0,18385,16038,1603.8,46,-1201,0
3657,-59,1231,1833.9,18339,19765,7.2,8,8,8,233,23.3,2,1,0,1,0,212,21.2,0,9,9,9,7.0,18534,18398,1839.8,-1231,59,1
3658,1294,1165,1654.1,16541,19056,7.0,6,6,7,249,24.9,1,1,0,1,0,211,21.1,0,6,4,4,7.0,17891,15247,1524.7,-1165,-1294,1
3659,4535,1970,2048.8,20488,17390,6.8,14,14,13,201,20.1,1,1,0,1,0,191,19.1,0,5,7,7,6.2,15420,15953,1595.3,-1970,-4535,1
3660,-1925,-904,1507.2,15072,17951,7.0,5,5,4,189,18.9,1,0,0,1,0,244,24.4,0,5,6,6,7.2,18855,16997,1699.7,904,1925,1
3661,-1629,-287,1543.3,15433,18889,7.2,4,4,4,218,21.8,1,1,0,1,0,249,24.9,0,4,6,6,7.4,19176,17062,1706.2,287,1629,0
3662,-856,-642,1576.6,15766,16923,6.8,4,4,7,213,21.3,0,0,0,1,1,239,23.9,1,6,6,6,6.6,17565,16622,1662.2,642,856,1
3663,2955,1124,1845.9,18459,17936,7.0,10,10,14,187,18.7,1,1,1,0,0,196,19.6,0,7,5,5,6.8,16812,15504,1550.4,-1124,-2955,1
3664,1418,129,1646.7,16467,17952,6.8,7,7,7,209,20.9,2,1,1,0,0,231,23.1,0,2,3,3,6.8,17823,15049,1504.9,-129,-1418,0
3665,1263,-392,1838.4,18384,18583,7.2,11,11,13,208,20.8,1,1,1,0,0,207,20.7,0,7,8,8,7.0,18975,17121,1712.1,392,-1263,1
3666,3187,1811,1847.9,18479,19708,7.4,11,11,11,232,23.2,1,0,1,0,1,258,25.8,1,2,3,3,6.8,17897,15292,1529.2,-1811,-3187,1
3667,-3244,-1208,1481.2,14812,16674,6.8,3,3,4,199,19.9,1,0,0,1,1,205,20.5,1,12,9,9,6.8,17882,18056,1805.6,1208,3244,0
3668,-1626,-849,1470.2,14702,17961,6.8,2,2,1,212,21.2,1,1,1,0,0,243,24.3,1,5,6,6,7.2,18810,16328,1632.8,849,1626,1
3669,-1235,-956,1571.5,15715,18159,7.0,3,3,4,246,24.6,0,0,1,0,1,252,25.2,1,4,7,7,7.2,19115,16950,1695.0,956,1235,1
3670,1271,531,1673.6,16736,18330,7.2,8,8,9,227,22.7,0,0,1,0,0,221,22.1,0,4,5,5,7.0,17799,15465,1546.5,-531,-1271,0
3671,706,766,1734.4,17344,18253,7.0,10,10,9,184,18.4,1,1,0,1,0,206,20.6,1,7,8,8,6.6,17487,16638,1663.8,-766,-706,0
3672,1430,916,1862.5,18625,17323,6.6,11,11,13,190,19.0,1,0,0,1,1,215,21.5,1,9,8,8,6.6,16407,17195,1719.5,-916,-1430,1
3673,-2891,-3196,1382.5,13825,15977,6.6,2,2,2,185,18.5,0,0,0,1,0,229,22.9,0,7,7,7,7.4,19173,16716,1671.6,3196,2891,1
3674,-3333,-379,1460.4,14604,17494,6.6,3,3,1,198,19.8,1,1,0,1,0,245,24.5,1,10,7,7,6.8,17873,17937,1793.7,379,3333,0
3675,-2580,-3307,1577.0,15770,16913,6.4,5,5,5,241,24.1,0,0,0,1,0,224,22.4,1,6,8,8,7.2,20220,18350,1835.0,3307,2580,0
3676,-1838,-1127,1656.6,16566,18723,7.2,8,8,4,214,21.4,0,0,0,1,1,238,23.8,2,7,9,9,7.2,19850,18404,1840.4,1127,1838,1
3677,1440,247,1712.9,17129,17586,6.8,7,7,6,228,22.8,0,0,1,0,1,211,21.1,1,4,4,4,7.0,17339,15689,1568.9,-247,-1440,0
3678,-992,-804,1617.6,16176,18293,7.0,4,4,5,254,25.4,0,0,0,1,1,262,26.2,1,6,7,7,6.8,19097,17168,1716.8,804,992,0
3679,5433,3364,2105.6,21056,19016,7.2,15,15,15,206,20.6,1,0,0,1,0,193,19.3,0,3,5,5,6.4,15652,15623,1562.3,-3364,-5433,1
3680,3941,3044,2047.1,20471,20212,7.6,12,12,10,230,23.0,1,1,1,0,0,198,19.8,0,6,7,7,6.6,17168,16530,1653.0,-3044,-3941,1
3681,4509,2253,1882.3,18823,18188,6.6,8,8,14,245,24.5,0,0,0,1,1,218,21.8,1,2,3,3,6.6,15935,14314,1431.4,-2253,-4509,1
3682,2385,966,1720.4,17204,19558,7.4,7,7,6,255,25.5,0,0,1,0,1,215,21.5,1,4,3,3,7.0,18592,14819,1481.9,-966,-2385,1
3683,4007,970,1762.8,17628,14939,6.2,12,12,23,184,18.4,0,0,1,0,0,183,18.3,0,3,2,2,6.2,13969,13621,1362.1,-970,-4007,1
3684,438,196,1656.2,16562,17625,7.0,7,7,11,180,18.0,1,1,1,0,0,201,20.1,0,5,8,8,7.0,17429,16124,1612.4,-196,-438,0
3685,-3032,-1002,1654.3,16543,17893,7.0,6,6,6,213,21.3,1,1,0,1,0,240,24.0,0,16,11,11,7.2,18895,19575,1957.5,1002,3032,0
3686,4062,2332,1929.2,19292,18197,6.8,9,9,12,213,21.3,0,0,0,1,1,191,19.1,2,6,4,4,6.4,15865,15230,1523.0,-2332,-4062,0
3687,-816,332,1559.0,15590,18314,7.2,5,5,6,211,21.1,0,0,0,1,0,227,22.7,0,4,6,6,7.0,17982,16406,1640.6,-332,816,0
3688,2107,464,1588.5,15885,17852,7.0,5,5,5,250,25.0,0,0,0,1,1,231,23.1,1,1,1,1,6.6,17388,13778,1377.8,-464,-2107,1
3689,-2542,-1008,1593.6,15936,17184,6.6,6,6,6,233,23.3,1,1,0,1,0,233,23.3,0,9,10,10,7.0,18192,18478,1847.8,1008,2542,1
3690,-952,-1268,1504.0,15040,16582,6.6,3,3,3,205,20.5,0,0,1,0,1,205,20.5,2,4,7,7,7.0,17850,15992,1599.2,1268,952,1
3691,1824,638,1592.7,15927,17735,6.8,6,6,9,198,19.8,1,1,0,1,0,202,20.2,0,1,3,3,7.0,17097,14103,1410.3,-638,-1824,1
3692,-2681,-1877,1423.1,14231,17522,6.8,0,0,0,230,23.0,0,0,0,1,1,248,24.8,2,6,5,5,7.2,19399,16912,1691.2,1877,2681,0
3693,-993,-1150,1499.8,14998,17859,7.0,3,3,2,218,21.8,0,0,0,1,1,236,23.6,1,6,6,6,7.0,19009,15991,1599.1,1150,993,0
3694,-337,-1295,1831.5,18315,17665,6.6,11,11,12,232,23.2,1,0,0,1,1,197,19.7,1,14,13,13,7.2,18960,18652,1865.2,1295,337,0
3695,3115,2163,1697.7,16977,19499,7.4,8,8,9,199,19.9,1,1,1,0,0,217,21.7,0,0,0,0,6.8,17336,13862,1386.2,-2163,-3115,1
3696,-2748,-2417,1485.7,14857,17267,6.6,3,3,2,228,22.8,1,1,1,0,0,208,20.8,1,8,7,7,7.4,19684,17605,1760.5,2417,2748,1
3697,-3477,-3301,1481.9,14819,15937,6.4,5,5,5,183,18.3,0,0,1,0,1,227,22.7,1,7,9,9,7.2,19238,18296,1829.6,3301,3477,0
3698,-61,-100,1557.0,15570,18813,7.2,3,3,5,236,23.6,1,1,1,0,0,260,26.0,0,2,2,2,7.2,18913,15631,1563.1,100,61,0
3699,-5316,-3648,1423.1,14231,15543,6.2,3,3,7,208,20.8,0,0,0,1,0,214,21.4,0,21,14,14,7.4,19191,19547,1954.7,3648,5316,0
3700,3257,1407,1955.8,19558,19133,7.0,13,13,12,215,21.5,1,1,1,0,0,203,20.3,0,5,7,7,6.8,17726,16301,1630.1,-1407,-3257,1
3701,1492,-676,1853.1,18531,18550,7.2,10,10,9,217,21.7,1,1,1,0,0,214,21.4,0,4,9,9,7.0,19226,17039,1703.9,676,-1492,1
3702,-1310,-1595,1521.1,15211,16678,6.6,5,5,6,179,17.9,0,0,0,1,0,222,22.2,0,4,5,5,6.8,18273,16521,1652.1,1595,1310,0
3703,-2032,-1876,1368.3,13683,16232,6.8,1,1,2,198,19.8,2,1,0,1,0,262,26.2,0,1,2,2,6.8,18108,15715,1571.5,1876,2032,0
3704,846,680,1688.7,16887,19954,7.4,6,6,7,232,23.2,0,0,1,0,1,242,24.2,1,1,3,3,7.2,19274,16041,1604.1,-680,-846,1
3705,-248,-1557,1631.7,16317,17928,7.0,4,4,4,228,22.8,0,0,1,0,1,225,22.5,2,4,6,6,7.2,19485,16565,1656.5,1557,248,1
3706,4181,1584,1900.0,19000,18072,7.0,12,12,15,210,21.0,1,0,1,0,0,193,19.3,0,4,4,4,6.4,16488,14819,1481.9,-1584,-4181,1
3707,121,-123,1642.1,16421,18535,7.4,6,6,8,222,22.2,0,0,0,1,1,240,24.0,1,4,6,6,7.2,18658,16300,1630.0,123,-121,0
3708,1567,1637,1634.1,16341,19567,7.4,4,4,8,236,23.6,1,1,1,0,0,203,20.3,1,3,4,4,6.8,17930,14774,1477.4,-1637,-1567,1
3709,2972,1799,1890.1,18901,19110,7.2,13,13,13,244,24.4,0,0,1,0,0,206,20.6,0,4,6,6,6.8,17311,15929,1592.9,-1799,-2972,1
3710,-2807,-1537,1386.0,13860,16835,6.6,2,2,1,193,19.3,0,0,0,1,0,249,24.9,0,6,5,5,6.8,18372,16667,1666.7,1537,2807,1
3711,-1742,-357,1531.7,15317,18310,7.0,4,4,4,225,22.5,0,0,0,1,1,221,22.1,1,7,7,7,6.8,18667,17059,1705.9,357,1742,0
3712,4588,930,2011.1,20111,18316,7.0,11,11,13,231,23.1,1,1,1,0,0,153,15.3,0,6,6,6,7.0,17386,15523,1552.3,-930,-4588,1
3713,3123,3364,1863.1,18631,19229,7.4,11,11,19,229,22.9,1,1,1,0,0,194,19.4,0,10,6,6,6.6,15865,15508,1550.8,-3364,-3123,1
3714,-1174,-1478,1476.6,14766,16685,6.8,2,2,5,236,23.6,0,0,1,0,1,190,19.0,1,7,7,7,7.0,18163,15940,1594.0,1478,1174,0
3715,-844,-640,1596.7,15967,17567,6.8,6,6,6,222,22.2,0,0,0,1,0,234,23.4,0,6,6,6,7.0,18207,16811,1681.1,640,844,1
3716,5779,5212,1811.7,18117,19804,7.4,7,7,7,236,23.6,1,1,1,0,0,197,19.7,0,0,2,2,5.6,14592,12338,1233.8,-5212,-5779,1
3717,377,372,1637.9,16379,17323,6.8,7,7,8,207,20.7,1,1,1,0,0,243,24.3,0,9,5,5,6.8,16951,16002,1600.2,-372,-377,1
3718,-673,-1416,1653.0,16530,17332,6.8,6,6,5,226,22.6,0,0,0,1,0,198,19.8,0,6,8,8,7.2,18748,17203,1720.3,1416,673,1
3719,-3380,-2659,1545.1,15451,17544,6.8,3,3,2,243,24.3,0,0,0,1,0,234,23.4,0,11,11,11,7.4,20203,18831,1883.1,2659,3380,0
3720,2034,2002,1755.3,17553,19041,7.4,8,8,5,203,20.3,1,0,0,1,1,211,21.1,1,4,4,4,6.8,17039,15519,1551.9,-2002,-2034,1
3721,2411,1852,1872.1,18721,19444,7.2,9,9,15,240,24.0,0,0,1,0,1,219,21.9,1,6,5,5,6.8,17592,16310,1631.0,-1852,-2411,1
3722,912,505,1661.1,16611,18323,6.8,7,7,3,216,21.6,0,0,1,0,1,195,19.5,1,6,6,6,7.0,17818,15699,1569.9,-505,-912,1
3723,-345,-715,1505.9,15059,17260,6.8,4,4,5,196,19.6,1,1,1,0,0,237,23.7,0,2,4,4,6.6,17975,15404,1540.4,715,345,0
3724,-2290,-1334,1471.5,14715,17406,7.0,3,3,3,198,19.8,0,0,0,1,1,229,22.9,1,8,6,6,7.0,18740,17005,1700.5,1334,2290,0
3725,204,-830,1675.3,16753,18557,6.8,8,8,9,233,23.3,1,1,0,1,0,217,21.7,1,4,5,5,7.2,19387,16549,1654.9,830,-204,0
3726,-2653,-376,1567.6,15676,17356,6.6,6,6,3,210,21.0,0,0,0,1,1,191,19.1,1,15,12,12,7.0,17732,18329,1832.9,376,2653,0
3727,356,565,1761.6,17616,18731,7.0,9,9,11,195,19.5,0,0,0,1,0,208,20.8,0,8,7,7,7.0,18166,17260,1726.0,-565,-356,0
3728,613,-602,1672.7,16727,18834,7.2,6,6,5,220,22.0,2,1,1,0,0,247,24.7,0,3,4,4,7.4,19436,16114,1611.4,602,-613,1
3729,4400,3092,1962.6,19626,20682,7.6,12,12,13,228,22.8,1,1,1,0,0,223,22.3,0,2,3,3,6.6,17590,15226,1522.6,-3092,-4400,1
3730,54,-119,1676.3,16763,17822,6.8,6,6,6,207,20.7,0,0,0,1,1,214,21.4,1,7,6,6,6.8,17941,16709,1670.9,119,-54,1
3731,126,290,1568.6,15686,18036,7.0,4,4,4,206,20.6,0,0,1,0,0,224,22.4,0,6,4,4,6.8,17746,15560,1556.0,-290,-126,1
3732,-430,53,1450.2,14502,17745,7.0,3,3,2,217,21.7,1,1,0,1,0,223,22.3,0,1,2,2,6.8,17692,14932,1493.2,-53,430,1
3733,-2528,-1326,1513.0,15130,16749,6.6,3,3,3,220,22.0,0,0,0,1,0,218,21.8,0,13,10,10,7.0,18075,17658,1765.8,1326,2528,0
3734,558,-1308,1671.8,16718,18415,7.0,7,7,7,200,20.0,0,0,1,0,0,225,22.5,0,2,3,3,7.2,19723,16160,1616.0,1308,-558,1
3735,1134,1146,1692.9,16929,18100,7.0,8,8,10,200,20.0,0,0,1,0,1,239,23.9,1,3,4,4,6.6,16954,15795,1579.5,-1146,-1134,1
3736,-949,-297,1640.7,16407,18871,7.4,6,6,6,168,16.8,0,0,0,1,1,216,21.6,1,3,9,9,7.2,19168,17356,1735.6,297,949,1
3737,4297,2642,1916.5,19165,20050,7.4,11,11,11,219,21.9,1,1,1,0,0,177,17.7,0,4,4,4,6.8,17408,14868,1486.8,-2642,-4297,1
3738,-1838,-1430,1569.8,15698,16251,6.4,3,3,6,189,18.9,1,0,1,0,1,211,21.1,1,9,8,8,6.8,17681,17536,1753.6,1430,1838,0
3739,-2115,-1147,1539.8,15398,17682,6.6,6,6,3,184,18.4,0,0,0,1,0,233,23.3,0,6,9,9,7.0,18829,17513,1751.3,1147,2115,0
3740,2184,419,1720.1,17201,17943,6.8,6,6,6,186,18.6,2,1,1,0,0,211,21.1,0,4,3,3,6.8,17524,15017,1501.7,-419,-2184,1
3741,-406,-1050,1596.4,15964,18056,7.0,4,4,3,199,19.9,1,0,0,1,1,190,19.0,1,5,7,7,7.2,19106,16370,1637.0,1050,406,1
3742,-6707,-5252,1312.1,13121,14672,6.0,2,2,1,172,17.2,0,0,0,1,1,203,20.3,2,13,14,14,7.6,19924,19828,1982.8,5252,6707,0
3743,826,-382,1570.1,15701,17966,7.0,3,3,1,245,24.5,1,1,0,1,0,193,19.3,0,6,4,4,7.0,18348,14875,1487.5,382,-826,0
3744,-1074,-1029,1791.7,17917,17997,6.8,10,10,13,199,19.9,0,0,1,0,1,233,23.3,1,9,10,10,7.2,19026,18991,1899.1,1029,1074,1
3745,2616,3108,1828.8,18288,19406,7.4,11,11,8,207,20.7,0,0,1,0,1,177,17.7,1,9,7,7,6.6,16298,15672,1567.2,-3108,-2616,1
3746,1292,812,1885.7,18857,18670,7.2,12,12,17,195,19.5,1,1,1,0,0,207,20.7,0,10,9,9,7.0,17858,17565,1756.5,-812,-1292,1
3747,562,243,1737.4,17374,17514,6.8,10,10,12,214,21.4,0,0,1,0,1,204,20.4,1,9,6,6,6.8,17271,16812,1681.2,-243,-562,0
3748,1345,1361,1762.0,17620,18344,6.8,6,6,4,227,22.7,1,0,1,0,1,199,19.9,1,14,7,7,6.6,16983,16275,1627.5,-1361,-1345,0
3749,-2693,-709,1723.8,17238,17907,7.0,8,8,8,204,20.4,0,0,0,1,0,228,22.8,0,9,13,13,7.2,18616,19931,1993.1,709,2693,0
3750,-1696,-1748,1570.9,15709,17814,7.0,4,4,1,207,20.7,1,0,1,0,1,239,23.9,1,6,9,9,7.2,19562,17405,1740.5,1748,1696,0
3751,-384,-345,1769.3,17693,19111,7.2,8,8,6,202,20.2,1,0,0,1,1,199,19.9,1,10,11,11,7.2,19456,18077,1807.7,345,384,0
3752,77,239,1634.3,16343,18250,6.8,5,5,5,233,23.3,0,0,0,1,1,203,20.3,1,9,7,7,6.8,18011,16266,1626.6,-239,-77,1
3753,2789,2000,1703.3,17033,18063,6.8,7,7,7,225,22.5,1,1,0,1,0,210,21.0,0,2,2,2,6.4,16063,14244,1424.4,-2000,-2789,1
3754,56,-587,1595.6,15956,17947,7.0,6,6,4,229,22.9,0,0,1,0,1,231,23.1,1,2,5,5,7.0,18534,15900,1590.0,587,-56,0
3755,-2568,-2314,1478.0,14780,16972,6.8,3,3,1,215,21.5,0,0,0,1,1,215,21.5,1,10,7,7,7.2,19286,17348,1734.8,2314,2568,0
3756,728,2095,1670.9,16709,18855,7.0,5,5,8,222,22.2,2,1,0,1,0,224,22.4,0,8,5,5,6.8,16760,15981,1598.1,-2095,-728,1
3757,2236,337,1874.8,18748,17735,7.0,13,13,12,181,18.1,1,1,1,0,0,194,19.4,0,2,5,5,6.6,17398,16512,1651.2,-337,-2236,1
3758,-518,868,1559.8,15598,18672,7.0,4,4,2,204,20.4,0,0,1,0,0,225,22.5,0,10,5,5,7.0,17804,16116,1611.6,-868,518,0
3759,-3086,-1701,1510.8,15108,17595,6.8,5,5,3,202,20.2,0,0,0,1,1,222,22.2,1,8,9,9,7.2,19296,18194,1819.4,1701,3086,0
3760,-4365,-2883,1367.9,13679,16597,6.4,1,1,1,209,20.9,0,0,0,1,1,243,24.3,1,6,6,6,7.2,19480,18044,1804.4,2883,4365,0
3761,1478,483,1745.3,17453,17851,7.0,7,7,7,237,23.7,2,1,1,0,0,199,19.9,0,8,6,6,7.0,17368,15975,1597.5,-483,-1478,1
3762,-5023,-1374,1512.0,15120,16829,6.8,3,3,3,191,19.1,0,0,0,1,1,217,21.7,2,28,15,15,7.2,18203,20143,2014.3,1374,5023,0
3763,233,-1221,1749.1,17491,16826,6.6,9,9,12,200,20.0,0,0,1,0,0,216,21.6,0,8,7,7,6.8,18047,17258,1725.8,1221,-233,1
3764,916,780,1679.8,16798,18520,7.0,7,7,8,225,22.5,0,0,0,1,0,236,23.6,0,4,4,4,7.0,17740,15882,1588.2,-780,-916,1
3765,-411,430,1437.9,14379,17751,6.8,1,1,1,247,24.7,2,1,0,1,0,228,22.8,0,2,1,1,7.0,17321,14790,1479.0,-430,411,1
3766,-1047,-193,1595.3,15953,16466,6.8,5,5,5,223,22.3,0,0,1,0,1,179,17.9,1,10,9,9,6.4,16659,17000,1700.0,193,1047,0
3767,3111,1587,1730.3,17303,18048,7.0,7,7,5,216,21.6,0,0,0,1,1,165,16.5,1,2,5,5,6.6,16461,14192,1419.2,-1587,-3111,1
3768,1694,1199,1611.4,16114,18458,7.0,4,4,4,233,23.3,1,1,1,0,0,210,21.0,1,3,3,3,6.6,17259,14420,1442.0,-1199,-1694,1
3769,6950,3536,2131.4,21314,19360,7.2,15,15,19,245,24.5,1,1,1,0,0,193,19.3,0,2,4,4,6.4,15824,14364,1436.4,-3536,-6950,1
3770,413,947,1566.0,15660,18225,6.8,5,5,2,224,22.4,2,1,1,0,0,226,22.6,0,2,4,4,6.8,17278,15247,1524.7,-947,-413,1
3771,-92,-1411,1716.9,17169,17934,6.8,9,9,13,216,21.6,1,1,1,0,0,221,22.1,1,6,6,6,7.2,19345,17261,1726.1,1411,92,0
3772,-2822,-1240,1564.9,15649,17052,6.8,6,6,7,186,18.6,2,1,0,1,0,248,24.8,0,9,9,9,7.0,18292,18471,1847.1,1240,2822,1
3773,180,893,1708.8,17088,18086,7.0,7,7,8,204,20.4,0,0,1,0,1,230,23.0,2,9,5,5,6.8,17193,16908,1690.8,-893,-180,1
3774,2006,346,1804.2,18042,19223,7.0,7,7,8,239,23.9,1,1,1,0,0,222,22.2,1,4,5,5,7.2,18877,16036,1603.6,-346,-2006,1
3775,-4585,-3125,1542.4,15424,17248,6.8,5,5,3,191,19.1,0,0,0,1,1,228,22.8,2,13,14,14,7.4,20373,20009,2000.9,3125,4585,0
3776,-174,231,1545.9,15459,18000,7.0,3,3,3,230,23.0,0,0,0,1,1,212,21.2,2,5,4,4,7.0,17769,15633,1563.3,-231,174,1
3777,3864,2988,1958.8,19588,19987,7.2,14,14,12,217,21.7,0,0,1,0,0,162,16.2,0,10,6,6,6.8,16999,15724,1572.4,-2988,-3864,1
3778,-32,-204,1695.1,16951,18684,7.0,8,8,6,200,20.0,1,0,1,0,1,216,21.6,1,9,9,9,7.0,18888,16983,1698.3,204,32,1
3779,-3728,-2079,1553.3,15533,18431,7.0,4,4,3,214,21.4,1,1,0,1,0,259,25.9,0,8,9,9,7.4,20510,19261,1926.1,2079,3728,0
3780,2962,2430,1765.3,17653,18461,7.0,7,7,8,231,23.1,0,0,1,0,0,210,21.0,0,5,4,4,6.4,16031,14691,1469.1,-2430,-2962,0
3781,-2076,-679,1481.1,14811,17429,6.6,4,4,2,224,22.4,0,0,0,1,0,235,23.5,0,6,7,7,6.8,18108,16887,1688.7,679,2076,0
3782,-1266,-1255,1453.8,14538,15395,6.2,3,3,3,177,17.7,0,0,1,0,1,200,20.0,1,6,6,6,6.4,16650,15804,1580.4,1255,1266,1
3783,2735,1076,2018.8,20188,18981,7.2,12,12,20,226,22.6,0,0,1,0,0,198,19.8,0,19,9,9,6.8,17905,17453,1745.3,-1076,-2735,1
3784,-470,1524,1602.1,16021,19551,7.2,5,5,3,216,21.6,0,0,0,1,0,237,23.7,0,4,4,4,6.8,18027,16491,1649.1,-1524,470,0
3785,922,146,1611.2,16112,17631,6.8,6,6,6,207,20.7,0,0,0,1,1,199,19.9,2,5,4,4,7.0,17485,15190,1519.0,-146,-922,1
3786,-999,-778,1596.7,15967,18611,7.0,6,6,2,237,23.7,1,1,0,1,0,250,25.0,1,5,5,5,7.2,19389,16966,1696.6,778,999,1
3787,-3823,-2613,1312.6,13126,17066,6.6,1,1,1,173,17.3,0,0,0,1,1,234,23.4,2,3,6,6,7.2,19679,16949,1694.9,2613,3823,0
3788,2122,1958,1750.1,17501,19153,7.2,6,6,8,248,24.8,2,1,1,0,0,229,22.9,0,2,2,2,6.6,17195,15379,1537.9,-1958,-2122,1
3789,3988,4246,1882.6,18826,20300,7.4,11,11,8,225,22.5,1,1,1,0,0,195,19.5,1,3,3,3,6.4,16054,14838,1483.8,-4246,-3988,1
3790,-1963,-45,1416.5,14165,17829,6.8,1,1,2,218,21.8,1,1,0,1,0,205,20.5,0,7,6,6,7.0,17874,16128,1612.8,45,1963,0
3791,2607,657,1811.0,18110,18193,6.8,10,10,17,193,19.3,1,1,1,0,0,236,23.6,0,5,3,3,6.6,17536,15503,1550.3,-657,-2607,0
3792,1675,2022,1673.1,16731,19377,7.4,5,5,5,238,23.8,1,0,1,0,1,218,21.8,1,2,4,4,6.8,17355,15056,1505.6,-2022,-1675,0
3793,-1720,-1376,1698.4,16984,18400,7.0,8,8,8,206,20.6,0,0,0,1,1,226,22.6,1,6,9,9,7.2,19776,18704,1870.4,1376,1720,0
3794,-1929,-680,1434.1,14341,17715,6.8,2,2,2,233,23.3,1,1,0,1,0,233,23.3,0,8,6,6,7.0,18395,16270,1627.0,680,1929,1
3795,2461,1779,1766.7,17667,19486,7.4,8,8,10,237,23.7,1,1,1,0,0,217,21.7,0,6,5,5,6.8,17707,15206,1520.6,-1779,-2461,1
3796,-5578,-2480,1370.4,13704,16135,6.6,1,1,1,202,20.2,0,0,0,1,1,247,24.7,2,9,8,8,7.0,18615,19282,1928.2,2480,5578,0
3797,-3479,-2205,1586.3,15863,17107,7.0,6,6,11,191,19.1,1,1,1,0,0,222,22.2,0,18,12,12,7.4,19312,19342,1934.2,2205,3479,0
3798,-4063,-2598,1483.4,14834,17374,7.0,2,2,2,198,19.8,0,0,0,1,0,243,24.3,0,12,12,12,7.4,19972,18897,1889.7,2598,4063,0
3799,2861,1432,1924.6,19246,19668,7.2,12,12,16,231,23.1,0,0,0,1,0,213,21.3,0,5,7,7,6.8,18236,16385,1638.5,-1432,-2861,1
3800,940,503,1709.1,17091,17740,6.8,9,9,12,214,21.4,2,1,1,0,0,210,21.0,0,6,7,7,6.8,17237,16151,1615.1,-503,-940,1
3801,-5226,-3701,1380.3,13803,15972,6.4,2,2,3,181,18.1,1,1,0,1,0,259,25.9,1,9,8,8,7.2,19673,19029,1902.9,3701,5226,0
3802,-264,315,1648.5,16485,19097,7.2,4,4,3,250,25.0,2,1,1,0,0,233,23.3,0,9,6,6,7.2,18782,16749,1674.9,-315,264,1
3803,-1187,-1561,1487.6,14876,18374,7.0,2,2,0,218,21.8,0,0,0,1,1,222,22.2,1,3,4,4,7.4,19935,16063,1606.3,1561,1187,0
3804,2264,1006,1759.4,17594,18431,7.0,6,6,6,237,23.7,0,0,1,0,0,190,19.0,0,5,5,5,6.8,17425,15330,1533.0,-1006,-2264,1
3805,-2725,-2117,1623.0,16230,17275,6.8,6,6,9,225,22.5,0,0,0,1,1,221,22.1,1,12,11,11,7.0,19392,18955,1895.5,2117,2725,0
3806,-251,231,1523.9,15239,18213,7.2,4,4,3,222,22.2,1,1,1,0,0,213,21.3,1,6,4,4,6.8,17982,15490,1549.0,-231,251,1
3807,-3023,-3630,1624.7,16247,16555,6.6,8,8,7,189,18.9,0,0,1,0,0,244,24.4,0,9,12,12,7.6,20185,19270,1927.0,3630,3023,0
3808,-375,180,1522.3,15223,18081,6.8,4,4,4,216,21.6,0,0,1,0,1,226,22.6,1,7,5,5,7.2,17901,15598,1559.8,-180,375,0
3809,-1367,-1526,1609.9,16099,18159,7.0,5,5,2,244,24.4,1,1,1,0,0,197,19.7,1,9,9,9,7.4,19685,17466,1746.6,1526,1367,0
3810,3828,2549,1794.0,17940,19752,7.4,9,9,8,224,22.4,0,0,1,0,1,200,20.0,1,3,3,3,6.8,17203,14112,1411.2,-2549,-3828,1
3811,-194,459,1565.2,15652,19647,7.6,2,2,0,270,27.0,0,0,1,0,1,276,27.6,1,2,2,2,7.0,19188,15846,1584.6,-459,194,0
3812,1926,2400,1816.1,18161,19168,7.0,9,9,8,213,21.3,1,1,1,0,0,202,20.2,0,9,6,6,6.8,16768,16235,1623.5,-2400,-1926,0
3813,-3535,-3197,1356.9,13569,14129,6.0,2,2,1,165,16.5,0,0,0,1,1,215,21.5,2,11,9,9,7.0,17326,17104,1710.4,3197,3535,0
3814,1831,994,1804.8,18048,18082,7.2,8,8,9,242,24.2,0,0,0,1,1,218,21.8,2,11,7,7,6.8,17088,16217,1621.7,-994,-1831,1
3815,-190,-576,1704.6,17046,18406,7.2,6,6,2,197,19.7,1,1,0,1,0,229,22.9,1,5,7,7,7.2,18982,17236,1723.6,576,190,0
3816,744,878,1664.7,16647,19826,7.4,4,4,6,227,22.7,1,1,0,1,0,242,24.2,0,2,3,3,7.0,18948,15903,1590.3,-878,-744,1
3817,-152,71,1628.3,16283,18397,7.0,6,6,8,228,22.8,1,1,1,0,0,253,25.3,0,8,5,5,6.8,18326,16435,1643.5,-71,152,1
3818,7621,4647,2243.3,22433,20086,7.4,15,15,16,230,23.0,0,0,1,0,1,192,19.2,1,9,4,4,6.4,15439,14812,1481.2,-4647,-7621,1
3819,1043,-1408,1542.9,15429,16480,6.8,5,5,9,202,20.2,0,0,1,0,0,203,20.3,0,3,2,2,6.8,17888,14386,1438.6,1408,-1043,0
3820,-1289,-1384,1623.9,16239,17518,7.0,8,8,8,186,18.6,0,0,0,1,1,204,20.4,1,8,10,10,7.0,18902,17528,1752.8,1384,1289,0
3821,3419,4709,1822.8,18228,19423,7.2,10,10,11,250,25.0,0,0,1,0,1,193,19.3,1,2,4,4,6.2,14714,14809,1480.9,-4709,-3419,1
3822,-851,-115,1698.3,16983,18017,7.0,5,5,9,238,23.8,1,1,1,0,0,228,22.8,1,5,5,5,6.8,18132,17834,1783.4,115,851,0
3823,1484,469,1695.7,16957,18220,7.0,8,8,10,204,20.4,0,0,0,1,0,226,22.6,0,3,5,5,6.6,17751,15473,1547.3,-469,-1484,1
3824,3833,2849,1896.2,18962,20021,7.6,13,13,13,207,20.7,1,1,1,0,0,203,20.3,1,3,4,4,6.8,17172,15129,1512.9,-2849,-3833,1
3825,993,783,1688.8,16888,17236,6.8,9,9,15,200,20.0,1,1,0,1,0,206,20.6,0,7,5,5,6.4,16453,15895,1589.5,-783,-993,0
3826,-3416,-2347,1499.3,14993,16201,6.4,4,4,5,208,20.8,0,0,0,1,1,206,20.6,1,12,10,10,7.2,18548,18409,1840.9,2347,3416,0
3827,143,-603,1607.6,16076,14942,6.2,8,8,10,181,18.1,1,1,1,0,0,178,17.8,0,18,9,9,6.4,15545,15933,1593.3,603,-143,1
3828,3332,2410,1700.7,17007,19713,7.4,6,6,4,242,24.2,0,0,1,0,1,194,19.4,1,2,1,1,6.8,17303,13675,1367.5,-2410,-3332,1
3829,-1208,-2526,1600.0,16000,16023,6.4,6,6,7,212,21.2,1,1,0,1,0,210,21.0,0,13,8,8,7.2,18549,17208,1720.8,2526,1208,0
3830,-217,571,1602.1,16021,18017,6.8,4,4,4,209,20.9,1,0,1,0,1,236,23.6,1,6,5,5,6.8,17446,16238,1623.8,-571,217,0
3831,1421,-792,1734.5,17345,18111,7.0,8,8,9,183,18.3,0,0,0,1,1,207,20.7,1,4,5,5,7.0,18903,15924,1592.4,792,-1421,1
3832,1642,1965,1797.6,17976,18454,7.4,10,10,13,176,17.6,0,0,0,1,1,195,19.5,1,5,6,6,6.4,16489,16334,1633.4,-1965,-1642,0
3833,-1590,-1867,1685.3,16853,18059,7.0,6,6,9,225,22.5,0,0,0,1,1,242,24.2,1,9,10,10,7.2,19926,18443,1844.3,1867,1590,0
3834,286,-12,1630.0,16300,18376,7.0,7,7,6,226,22.6,1,0,1,0,1,239,23.9,1,2,3,3,6.8,18388,16014,1601.4,12,-286,0
3835,1930,793,1641.7,16417,18579,7.0,4,4,3,248,24.8,1,1,1,0,0,257,25.7,0,1,1,1,6.8,17786,14487,1448.7,-793,-1930,1
3836,2887,2085,1746.6,17466,17536,6.8,7,7,5,239,23.9,1,1,1,0,0,174,17.4,0,7,5,5,6.2,15451,14579,1457.9,-2085,-2887,0
3837,2594,2485,1983.0,19830,19377,7.2,14,14,13,217,21.7,1,1,0,1,0,185,18.5,0,9,9,9,6.6,16892,17236,1723.6,-2485,-2594,1
3838,897,366,1672.6,16726,18564,7.0,6,6,9,234,23.4,0,0,0,1,1,214,21.4,1,2,4,4,7.0,18198,15829,1582.9,-366,-897,0
3839,778,548,1716.2,17162,18004,7.0,9,9,9,193,19.3,0,0,1,0,1,200,20.0,1,14,6,6,7.0,17456,16384,1638.4,-548,-778,0
3840,4778,4324,1953.5,19535,19835,7.4,13,13,12,231,23.1,1,1,1,0,0,173,17.3,0,5,5,5,6.2,15511,14757,1475.7,-4324,-4778,1
3841,-81,882,1551.4,15514,18840,7.2,4,4,4,235,23.5,0,0,0,1,0,261,26.1,0,1,2,2,7.0,17958,15595,1559.5,-882,81,1
3842,344,1298,1600.8,16008,19253,7.2,4,4,4,247,24.7,0,0,1,0,0,264,26.4,0,2,1,1,7.0,17955,15664,1566.4,-1298,-344,1
3843,2483,2299,1698.1,16981,19106,7.2,7,7,9,232,23.2,0,0,1,0,1,190,19.0,1,3,3,3,6.6,16807,14498,1449.8,-2299,-2483,1
3844,-2208,-2862,1472.2,14722,17262,6.6,4,4,4,190,19.0,0,0,0,1,1,210,21.0,2,4,8,8,7.6,20124,16930,1693.0,2862,2208,0
3845,-1425,-1296,1571.5,15715,17843,7.0,5,5,3,237,23.7,0,0,0,1,0,228,22.8,0,9,7,7,7.4,19139,17140,1714.0,1296,1425,1
3846,-281,110,1610.2,16102,19258,7.2,3,3,2,257,25.7,0,0,0,1,1,251,25.1,1,4,5,5,7.0,19148,16383,1638.3,-110,281,0
3847,-2000,-1473,1499.1,14991,17681,7.0,5,5,1,180,18.0,0,0,1,0,1,208,20.8,1,6,7,7,7.2,19154,16991,1699.1,1473,2000,0
3848,3021,347,1937.9,19379,18120,7.0,11,11,14,215,21.5,0,0,1,0,0,186,18.6,0,8,7,7,6.8,17773,16358,1635.8,-347,-3021,1
3849,2294,1989,1710.1,17101,17725,7.0,8,8,8,214,21.4,0,0,0,1,1,182,18.2,2,6,3,3,6.4,15736,14807,1480.7,-1989,-2294,1
3850,2478,1105,1718.6,17186,19734,7.0,4,4,4,263,26.3,0,0,1,0,1,209,20.9,2,3,2,2,7.0,18629,14708,1470.8,-1105,-2478,1
3851,-90,982,1511.5,15115,19609,7.2,3,3,1,219,21.9,1,1,0,1,0,213,21.3,1,1,4,4,7.2,18627,15205,1520.5,-982,90,1
3852,1210,1410,1612.7,16127,17245,6.8,4,4,6,235,23.5,2,1,0,1,0,191,19.1,0,3,5,5,6.4,15835,14917,1491.7,-1410,-1210,1
3853,-3473,-1314,1544.5,15445,16320,6.4,6,6,9,188,18.8,0,0,0,1,0,217,21.7,0,11,10,10,6.8,17634,18918,1891.8,1314,3473,1
3854,-627,-998,1658.5,16585,18064,7.0,8,8,8,207,20.7,0,0,0,1,0,222,22.2,0,4,7,7,7.2,19062,17212,1721.2,998,627,0
3855,671,881,1578.8,15788,18264,6.8,4,4,7,243,24.3,1,1,1,0,0,228,22.8,0,5,4,4,7.0,17383,15117,1511.7,-881,-671,0
3856,567,-8,1740.0,17400,19175,7.4,7,7,5,239,23.9,1,1,1,0,0,237,23.7,0,10,7,7,7.2,19183,16833,1683.3,8,-567,1
3857,-3421,-2978,1415.7,14157,16183,6.4,2,2,3,198,19.8,1,0,1,0,1,238,23.8,1,10,9,9,7.2,19161,17578,1757.8,2978,3421,0
3858,-415,1224,1499.2,14992,18110,6.8,2,2,5,226,22.6,1,0,1,0,1,222,22.2,1,5,3,3,6.6,16886,15407,1540.7,-1224,415,0
3859,946,357,1718.2,17182,18530,7.2,7,7,6,243,24.3,1,0,1,0,1,228,22.8,1,5,5,5,7.0,18173,16236,1623.6,-357,-946,0
3860,846,-1893,1642.6,16426,17766,6.8,7,7,7,187,18.7,1,0,1,0,1,231,23.1,1,0,5,5,7.4,19659,15580,1558.0,1893,-846,1
3861,-2299,-3211,1613.5,16135,16250,6.8,7,7,11,184,18.4,0,0,0,1,1,235,23.5,2,11,10,10,7.2,19461,18434,1843.4,3211,2299,1
3862,1284,25,1583.3,15833,17979,7.0,5,5,4,196,19.6,0,0,1,0,1,202,20.2,2,0,3,3,6.8,17954,14549,1454.9,-25,-1284,1
3863,2449,1146,1806.2,18062,19711,7.4,9,9,10,223,22.3,2,1,1,0,0,233,23.3,0,2,4,4,7.2,18565,15613,1561.3,-1146,-2449,1
3864,-2928,-110,1431.8,14318,17405,7.0,2,2,3,207,20.7,1,1,0,1,0,240,24.0,0,10,4,4,7.0,17515,17246,1724.6,110,2928,0
3865,-1404,-509,1496.9,14969,16927,6.8,4,4,4,195,19.5,1,1,0,1,0,206,20.6,0,6,7,7,6.8,17436,16373,1637.3,509,1404,1
3866,3368,2352,1717.7,17177,19119,7.0,7,7,8,223,22.3,0,0,1,0,1,205,20.5,1,1,1,1,6.6,16767,13809,1380.9,-2352,-3368,1
3867,-985,-1441,1661.7,16617,17480,7.0,8,8,7,184,18.4,0,0,1,0,1,222,22.2,1,7,9,9,7.2,18921,17602,1760.2,1441,985,0
3868,383,1668,1690.8,16908,18246,7.2,8,8,7,208,20.8,0,0,1,0,1,182,18.2,1,14,9,9,6.6,16578,16525,1652.5,-1668,-383,0
3869,1773,1953,1841.9,18419,19957,7.6,9,9,6,246,24.6,2,1,0,1,0,244,24.4,0,7,5,5,6.8,18004,16646,1664.6,-1953,-1773,1
3870,-2365,-1443,1557.0,15570,15894,6.8,7,7,9,198,19.8,0,0,1,0,0,204,20.4,0,14,9,9,6.8,17337,17935,1793.5,1443,2365,0
3871,-2188,-1753,1501.6,15016,17172,6.8,3,3,3,216,21.6,0,0,0,1,1,217,21.7,1,11,10,10,7.0,18925,17204,1720.4,1753,2188,0
3872,-1506,-500,1440.2,14402,17604,7.0,2,2,2,193,19.3,1,1,1,0,0,227,22.7,0,6,4,4,6.8,18104,15908,1590.8,500,1506,1
3873,-6027,-3955,1499.9,14999,15530,6.4,6,6,6,192,19.2,1,1,0,1,0,228,22.8,0,24,16,16,7.4,19485,21026,2102.6,3955,6027,0
3874,-1887,-567,1514.9,15149,16969,6.8,4,4,4,217,21.7,1,1,1,0,0,241,24.1,0,9,7,7,6.8,17536,17036,1703.6,567,1887,0
3875,-839,-800,1576.1,15761,17003,6.6,5,5,7,187,18.7,1,1,1,0,0,206,20.6,1,9,6,6,7.2,17803,16600,1660.0,800,839,1
3876,-2484,-1989,1471.4,14714,17620,6.8,2,2,2,217,21.7,0,0,0,1,0,232,23.2,0,7,9,9,7.4,19609,17198,1719.8,1989,2484,0
3877,1087,-1278,1515.4,15154,15685,6.4,5,5,8,206,20.6,0,0,1,0,0,192,19.2,0,1,3,3,6.8,16963,14067,1406.7,1278,-1087,1
3878,8347,5234,2099.8,20998,19521,7.2,13,13,10,228,22.8,0,0,1,0,0,181,18.1,0,0,2,2,5.8,14287,12651,1265.1,-5234,-8347,1
3879,716,601,1760.7,17607,19309,7.2,9,9,7,212,21.2,0,0,1,0,1,204,20.4,1,6,7,7,7.2,18708,16891,1689.1,-601,-716,1
3880,-770,196,1514.1,15141,17975,6.8,6,6,2,196,19.6,0,0,0,1,1,178,17.8,1,10,7,7,6.8,17779,15911,1591.1,-196,770,0
3881,5154,3837,2128.5,21285,20332,7.4,16,16,12,229,22.9,1,1,0,1,0,174,17.4,0,6,7,7,6.8,16495,16131,1613.1,-3837,-5154,1
3882,1580,605,1698.4,16984,17014,6.8,9,9,7,214,21.4,0,0,0,1,0,194,19.4,0,8,5,5,6.8,16409,15404,1540.4,-605,-1580,1
3883,-2345,-2959,1348.9,13489,14875,6.0,3,3,2,192,19.2,0,0,0,1,1,198,19.8,1,5,6,6,6.8,17834,15834,1583.4,2959,2345,0
3884,758,502,1465.3,14653,17643,7.0,2,2,3,224,22.4,2,1,1,0,0,221,22.1,0,0,2,2,6.8,17141,13895,1389.5,-502,-758,1
3885,-3983,-3676,1533.5,15335,16838,6.4,4,4,3,187,18.7,0,0,0,1,0,242,24.2,0,9,12,12,7.4,20514,19318,1931.8,3676,3983,0
3886,-1448,-908,1585.3,15853,17174,7.0,5,5,3,192,19.2,0,0,1,0,1,197,19.7,2,11,8,8,7.0,18082,17301,1730.1,908,1448,1
3887,-2199,-2258,1547.6,15476,16691,6.8,6,6,5,198,19.8,0,0,0,1,1,218,21.8,1,10,10,10,7.2,18949,17675,1767.5,2258,2199,0
3888,464,1520,1521.1,15211,18741,7.0,4,4,3,200,20.0,2,1,1,0,0,242,24.2,0,2,3,3,6.8,17221,14747,1474.7,-1520,-464,1
3889,-1044,-487,1579.6,15796,17121,6.6,5,5,8,184,18.4,0,0,0,1,1,226,22.6,1,11,7,7,7.0,17608,16840,1684.0,487,1044,0
3890,-136,-807,1542.0,15420,18542,7.2,3,3,3,237,23.7,1,1,1,0,0,237,23.7,1,2,4,4,7.2,19349,15556,1555.6,807,136,0
3891,6387,3453,2096.1,20961,19939,7.6,13,13,14,225,22.5,1,1,1,0,0,182,18.2,1,2,3,3,6.6,16486,14574,1457.4,-3453,-6387,1
3892,-811,-410,1763.3,17633,18304,7.0,9,9,9,218,21.8,1,1,1,0,0,230,23.0,0,11,10,10,7.0,18714,18444,1844.4,410,811,0
3893,2179,2663,1664.7,16647,20048,7.4,4,4,5,240,24.0,1,1,1,0,0,226,22.6,0,1,2,2,6.8,17385,14468,1446.8,-2663,-2179,1
3894,-2749,-800,1414.1,14141,16555,6.6,2,2,1,211,21.1,0,0,0,1,0,206,20.6,0,14,8,8,6.8,17355,16890,1689.0,800,2749,1
3895,825,1066,1637.4,16374,18573,7.0,4,4,3,263,26.3,1,1,0,1,0,253,25.3,0,6,3,3,6.6,17507,15549,1554.9,-1066,-825,1
3896,1294,453,1712.5,17125,17861,7.0,10,10,6,210,21.0,0,0,0,1,1,223,22.3,1,3,4,4,7.0,17408,15831,1583.1,-453,-1294,0
3897,-1814,-2306,1553.1,15531,17609,7.0,4,4,6,218,21.8,0,0,0,1,1,256,25.6,1,5,5,5,7.4,19915,17345,1734.5,2306,1814,0
3898,3048,472,1852.9,18529,18907,7.0,6,6,14,252,25.2,1,1,1,0,0,203,20.3,0,6,4,4,7.0,18435,15481,1548.1,-472,-3048,1
3899,-4637,-3355,1445.0,14450,15750,6.4,4,4,2,186,18.6,0,0,0,1,0,210,21.0,0,19,14,14,7.2,19105,19087,1908.7,3355,4637,0
3900,2363,2162,1818.5,18185,19645,7.4,11,11,11,204,20.4,2,1,0,1,0,204,20.4,0,7,6,6,7.0,17483,15822,1582.2,-2162,-2363,0
3901,-89,-41,1542.3,15423,18346,7.0,3,3,2,244,24.4,0,0,0,1,1,228,22.8,1,3,5,5,7.0,18387,15512,1551.2,41,89,0
3902,-1749,-1502,1467.5,14675,18039,7.0,1,1,2,231,23.1,2,1,1,0,0,264,26.4,0,2,3,3,7.4,19541,16424,1642.4,1502,1749,0
3903,4246,3880,1872.2,18722,18618,7.2,12,12,11,212,21.2,1,1,1,0,0,176,17.6,0,6,3,3,6.0,14738,14476,1447.6,-3880,-4246,1
3904,-837,-451,1442.1,14421,18228,7.0,2,2,1,234,23.4,1,0,1,0,1,229,22.9,1,1,2,2,7.0,18679,15258,1525.8,451,837,0
3905,1068,1295,1753.2,17532,18592,7.2,9,9,6,233,23.3,0,0,1,0,0,200,20.0,0,10,8,8,6.8,17297,16464,1646.4,-1295,-1068,1
3906,4290,1900,1927.1,19271,18923,7.2,10,10,14,245,24.5,1,0,1,0,0,193,19.3,0,7,4,4,6.8,17023,14981,1498.1,-1900,-4290,1
3907,-942,244,1865.5,18655,18368,6.8,12,12,16,173,17.3,1,1,1,0,0,226,22.6,0,15,12,12,6.8,18124,19597,1959.7,-244,942,0
3908,-5120,-2590,1416.4,14164,16392,6.8,2,2,2,202,20.2,1,0,0,1,0,232,23.2,0,18,11,11,7.2,18982,19284,1928.4,2590,5120,0
3909,-3638,-1582,1447.6,14476,15711,6.4,4,4,2,180,18.0,1,0,0,1,0,189,18.9,0,13,14,14,7.0,17293,18114,1811.4,1582,3638,0
3910,694,1305,1833.9,18339,19803,7.4,8,8,12,232,23.2,1,0,1,0,1,245,24.5,1,10,7,7,7.4,18498,17645,1764.5,-1305,-694,1
3911,555,-1022,1745.0,17450,17226,6.6,5,5,9,226,22.6,2,1,0,1,0,232,23.2,0,12,6,6,7.0,18248,16895,1689.5,1022,-555,1
3912,134,-1142,1638.1,16381,18126,7.0,7,7,6,221,22.1,0,0,1,0,1,231,23.1,2,3,5,5,7.2,19268,16247,1624.7,1142,-134,0
3913,-1257,-1406,1544.6,15446,16681,6.6,5,5,1,183,18.3,0,0,1,0,1,186,18.6,1,5,7,7,6.8,18087,16703,1670.3,1406,1257,1
3914,-1187,-1058,1497.0,14970,16402,6.6,3,3,1,208,20.8,1,1,0,1,0,208,20.8,0,6,7,7,6.8,17460,16157,1615.7,1058,1187,1
3915,-2625,-3375,1471.1,14711,16207,6.6,2,2,3,221,22.1,0,0,1,0,1,244,24.4,1,5,7,7,7.6,19582,17336,1733.6,3375,2625,0
3916,-55,-298,1721.9,17219,18432,7.2,8,8,8,212,21.2,0,0,0,1,1,251,25.1,1,7,7,7,7.0,18730,17274,1727.4,298,55,1
3917,2585,2288,1801.0,18010,19401,7.2,7,7,9,239,23.9,1,0,1,0,1,226,22.6,1,5,5,5,6.6,17113,15425,1542.5,-2288,-2585,1
3918,5186,2739,1970.8,19708,18711,7.2,13,13,15,201,20.1,1,1,0,1,0,170,17.0,0,4,6,6,6.4,15972,14522,1452.2,-2739,-5186,1
3919,2492,1176,1682.5,16825,18820,7.0,6,6,6,247,24.7,1,1,1,0,0,205,20.5,0,2,2,2,7.0,17644,14333,1433.3,-1176,-2492,1
3920,1371,2146,1475.5,14755,18264,6.8,1,1,1,223,22.3,1,0,1,0,0,230,23.0,0,0,0,0,6.2,16118,13384,1338.4,-2146,-1371,1
3921,1635,1705,1759.2,17592,18440,7.0,8,8,11,224,22.4,0,0,1,0,0,195,19.5,0,7,7,7,6.4,16735,15957,1595.7,-1705,-1635,1
3922,-2885,-3602,1535.1,15351,16664,6.6,5,5,5,179,17.9,0,0,0,1,1,222,22.2,2,8,10,10,7.2,20266,18236,1823.6,3602,2885,0
3923,2360,1439,1778.7,17787,18660,7.2,7,7,7,232,23.2,1,1,1,0,0,161,16.1,0,6,5,5,6.6,17221,15427,1542.7,-1439,-2360,0
3924,421,-160,1503.1,15031,17787,6.8,2,2,2,246,24.6,0,0,0,1,1,239,23.9,1,1,1,1,6.8,17947,14610,1461.0,160,-421,1
3925,-1207,-2081,1540.7,15407,16669,6.6,4,4,4,223,22.3,0,0,1,0,0,226,22.6,0,4,7,7,7.4,18750,16614,1661.4,2081,1207,1
3926,-1195,-56,1456.9,14569,17180,6.6,4,4,4,194,19.4,0,0,0,1,1,194,19.4,1,6,5,5,6.6,17236,15764,1576.4,56,1195,0
3927,-2343,-2076,1645.2,16452,17156,6.8,7,7,7,191,19.1,1,1,1,0,0,261,26.1,1,5,9,9,7.2,19232,18795,1879.5,2076,2343,1
3928,3156,3919,1743.7,17437,18302,7.2,3,3,3,255,25.5,1,1,0,1,0,196,19.6,0,6,4,4,6.0,14383,14281,1428.1,-3919,-3156,1
3929,-2277,-1804,1466.5,14665,15242,6.6,5,5,4,188,18.8,0,0,0,1,0,225,22.5,0,6,8,8,6.6,17046,16942,1694.2,1804,2277,1
3930,3354,2318,1839.5,18395,19241,7.0,6,6,8,236,23.6,1,1,1,0,0,185,18.5,0,6,4,4,6.8,16923,15041,1504.1,-2318,-3354,1
3931,4060,3257,1696.1,16961,19188,7.2,7,7,5,245,24.5,0,0,1,0,0,176,17.6,0,1,1,1,6.4,15931,12901,1290.1,-3257,-4060,1
3932,-4043,-4142,1401.1,14011,15027,6.4,3,3,2,197,19.7,0,0,0,1,1,207,20.7,1,6,7,7,7.2,19169,18054,1805.4,4142,4043,0
3933,659,-111,1687.1,16871,18870,7.2,5,5,8,227,22.7,0,0,0,1,1,238,23.8,1,5,5,5,7.0,18981,16212,1621.2,111,-659,1
3934,-3290,-2697,1612.5,16125,17377,6.8,7,7,5,196,19.6,0,0,1,0,0,231,23.1,0,14,12,12,7.2,20074,19415,1941.5,2697,3290,0
3935,-3660,-3282,1377.3,13773,16568,6.6,2,2,2,192,19.2,0,0,0,1,1,239,23.9,1,8,10,10,7.6,19850,17433,1743.3,3282,3660,0
3936,-913,-192,1845.8,18458,18924,7.0,9,9,15,243,24.3,0,0,1,0,0,231,23.1,0,20,12,12,7.2,19116,19371,1937.1,192,913,1
3937,585,570,1625.8,16258,18533,7.0,5,5,4,255,25.5,0,0,0,1,0,180,18.0,0,9,6,6,6.8,17963,15673,1567.3,-570,-585,0
3938,1176,3600,1699.7,16997,20958,7.8,9,9,8,222,22.2,1,1,0,1,0,196,19.6,1,9,5,5,6.8,17358,15821,1582.1,-3600,-1176,1
3939,-3505,-778,1535.6,15356,18213,7.2,3,3,3,186,18.6,1,0,0,1,1,247,24.7,1,10,9,9,7.2,18991,18861,1886.1,778,3505,0
3940,4909,2760,1887.0,18870,18945,7.0,9,9,9,252,25.2,1,0,1,0,1,202,20.2,1,1,2,2,6.6,16185,13961,1396.1,-2760,-4909,1
3941,-1003,-1777,1563.9,15639,16156,6.6,5,5,6,196,19.6,0,0,0,1,1,204,20.4,1,7,7,7,6.8,17933,16642,1664.2,1777,1003,0
3942,84,992,1963.2,19632,20057,7.6,15,15,14,228,22.8,1,1,0,1,0,237,23.7,0,9,12,12,7.2,19065,19548,1954.8,-992,-84,0
3943,330,-308,1694.2,16942,17991,7.2,6,6,12,247,24.7,1,1,0,1,0,192,19.2,1,6,7,7,7.0,18299,16612,1661.2,308,-330,0
3944,974,-1050,1707.7,17077,16354,6.6,8,8,14,171,17.1,0,0,1,0,1,200,20.0,1,4,7,7,6.8,17404,16103,1610.3,1050,-974,0
3945,3331,1795,2026.9,20269,20117,7.4,14,14,16,242,24.2,1,1,1,0,0,192,19.2,0,7,7,7,7.0,18322,16938,1693.8,-1795,-3331,0
3946,4371,2705,1907.9,19079,20020,7.4,9,9,13,249,24.9,1,1,1,0,0,237,23.7,0,2,2,2,6.8,17315,14708,1470.8,-2705,-4371,1
3947,-1754,-211,1581.5,15815,16869,6.6,6,6,6,196,19.6,1,1,0,1,0,201,20.1,0,10,10,10,6.6,17080,17569,1756.9,211,1754,1
3948,381,108,1697.0,16970,17789,6.8,3,3,3,252,25.2,1,0,1,0,1,199,19.9,1,9,6,6,7.0,17681,16589,1658.9,-108,-381,0
3949,2321,1274,1806.4,18064,19192,7.2,9,9,10,252,25.2,0,0,1,0,1,198,19.8,1,5,7,7,6.8,17918,15743,1574.3,-1274,-2321,1
3950,1574,1353,1716.9,17169,18362,7.0,5,5,5,239,23.9,0,0,0,1,1,252,25.2,2,3,2,2,6.4,17009,15595,1559.5,-1353,-1574,1
3951,188,-1124,1641.3,16413,16989,6.8,7,7,8,209,20.9,1,1,0,1,0,248,24.8,0,6,4,4,6.8,18113,16225,1622.5,1124,-188,0
3952,679,-691,1546.4,15464,17053,6.8,6,6,7,219,21.9,1,1,0,1,0,220,22.0,1,2,3,3,6.8,17744,14785,1478.5,691,-679,1
3953,-475,-1451,1560.0,15600,16815,6.6,5,5,10,207,20.7,1,1,1,0,0,233,23.3,0,4,5,5,6.8,18266,16075,1607.5,1451,475,0
3954,-3276,-2790,1380.2,13802,15859,6.2,1,1,1,216,21.6,0,0,0,1,1,217,21.7,1,9,9,9,7.0,18649,17078,1707.8,2790,3276,0
3955,-1520,-613,1503.3,15033,16265,6.6,3,3,4,226,22.6,0,0,1,0,0,201,20.1,0,14,7,7,6.6,16878,16553,1655.3,613,1520,0
3956,1349,924,1680.3,16803,18053,7.0,5,5,4,251,25.1,1,1,1,0,0,182,18.2,0,6,6,6,6.8,17129,15454,1545.4,-924,-1349,1
3957,-352,176,1544.4,15444,18334,7.0,4,4,7,215,21.5,1,1,1,0,0,257,25.7,0,3,2,2,6.8,18158,15796,1579.6,-176,352,0
3958,-987,89,1765.9,17659,18496,7.0,7,7,11,244,24.4,0,0,0,1,1,206,20.6,2,17,11,11,7.2,18407,18646,1864.6,-89,987,1
3959,520,897,1872.0,18720,19060,7.2,10,10,18,232,23.2,0,0,1,0,1,202,20.2,2,9,9,9,7.0,18163,18200,1820.0,-897,-520,1
3960,1181,-683,1763.9,17639,17826,7.0,6,6,5,247,24.7,1,1,1,0,0,240,24.0,1,6,5,5,7.2,18509,16458,1645.8,683,-1181,0
3961,2516,1053,1730.7,17307,18013,7.0,8,8,12,249,24.9,0,0,1,0,1,203,20.3,1,3,4,4,6.6,16960,14791,1479.1,-1053,-2516,1
3962,66,-361,1571.2,15712,17867,6.8,4,4,6,241,24.1,1,1,0,1,0,245,24.5,0,4,3,3,6.8,18228,15646,1564.6,361,-66,1
3963,2590,1018,1761.6,17616,18140,7.0,7,7,6,243,24.3,1,1,0,1,0,248,24.8,1,4,2,2,6.6,17122,15026,1502.6,-1018,-2590,1
3964,2648,2595,1723.5,17235,19915,7.4,7,7,5,257,25.7,0,0,0,1,0,191,19.1,0,3,3,3,6.8,17320,14587,1458.7,-2595,-2648,0
3965,2763,3068,2006.5,20065,18844,7.2,12,12,10,204,20.4,2,1,1,0,0,168,16.8,0,11,10,10,6.4,15776,17302,1730.2,-3068,-2763,1
3966,1024,415,1553.7,15537,17374,6.8,2,2,2,244,24.4,2,1,0,1,0,224,22.4,0,2,3,3,6.8,16959,14513,1451.3,-415,-1024,0
3967,1462,249,1835.9,18359,17074,6.8,10,10,9,190,19.0,0,0,0,1,0,160,16.0,0,12,8,8,6.6,16825,16897,1689.7,-249,-1462,0
3968,739,1639,1588.4,15884,17698,6.8,4,4,3,251,25.1,0,0,1,0,1,175,17.5,1,6,5,5,6.4,16059,15145,1514.5,-1639,-739,1
3969,-3476,-4019,1451.2,14512,16088,6.6,3,3,3,226,22.6,0,0,0,1,1,249,24.9,2,6,9,9,7.4,20107,17988,1798.8,4019,3476,0
3970,-2494,-2755,1544.0,15440,17277,6.8,5,5,7,175,17.5,0,0,1,0,0,237,23.7,0,10,9,9,7.2,20032,17934,1793.4,2755,2494,0
3971,1576,1573,1629.6,16296,18093,7.0,7,7,6,222,22.2,1,1,0,1,0,192,19.2,0,2,4,4,6.6,16520,14720,1472.0,-1573,-1576,1
3972,-2607,59,1497.9,14979,18306,7.0,1,1,1,232,23.2,0,0,0,1,1,238,23.8,2,5,6,6,6.8,18247,17586,1758.6,-59,2607,0
3973,978,315,1636.4,16364,17787,6.8,6,6,5,226,22.6,1,1,1,0,0,194,19.4,0,5,5,5,7.0,17472,15386,1538.6,-315,-978,1
3974,-5945,-2122,1400.3,14003,16419,6.6,4,4,1,195,19.5,0,0,0,1,0,232,23.2,0,15,13,13,7.0,18541,19948,1994.8,2122,5945,0
3975,-2021,-1891,1645.9,16459,18612,7.0,6,6,5,201,20.1,0,0,1,0,0,235,23.5,0,7,8,8,7.4,20503,18480,1848.0,1891,2021,0
3976,-1226,-2432,1536.1,15361,17290,7.0,3,3,4,235,23.5,0,0,1,0,0,221,22.1,0,5,7,7,7.4,19722,16587,1658.7,2432,1226,0
3977,3272,3059,1834.5,18345,20002,7.4,7,7,6,247,24.7,1,0,0,1,1,183,18.3,1,8,5,5,6.8,16943,15073,1507.3,-3059,-3272,0
3978,3609,3620,1849.7,18497,19069,7.2,10,10,8,223,22.3,1,1,0,1,0,174,17.4,0,5,5,5,6.4,15449,14888,1488.8,-3620,-3609,0
3979,-744,-1255,1464.2,14642,16219,6.6,3,3,3,229,22.9,0,0,0,1,1,212,21.2,2,4,4,4,6.8,17474,15386,1538.6,1255,744,0
3980,-2925,-2112,1553.9,15539,17792,6.8,3,3,1,214,21.4,0,0,0,1,1,242,24.2,2,9,8,8,7.2,19904,18464,1846.4,2112,2925,0
3981,2348,1462,1878.1,18781,17690,6.8,13,13,19,204,20.4,0,0,1,0,0,191,19.1,0,12,7,7,6.6,16228,16433,1643.3,-1462,-2348,0
3982,-1997,-2590,1650.9,16509,17298,6.8,7,7,6,210,21.0,0,0,0,1,0,228,22.8,0,10,11,11,7.4,19888,18506,1850.6,2590,1997,0
3983,-292,-127,1482.0,14820,16751,6.8,3,3,3,215,21.5,1,1,0,1,0,222,22.2,1,3,3,3,6.6,16878,15112,1511.2,127,292,1
3984,-398,-763,1546.5,15465,17217,6.8,4,4,5,217,21.7,0,0,0,1,1,249,24.9,1,1,4,4,6.8,17980,15863,1586.3,763,398,0
3985,-1514,-1033,1524.1,15241,18179,7.0,3,3,1,252,25.2,0,0,0,1,1,224,22.4,2,8,8,8,7.4,19212,16755,1675.5,1033,1514,0
3986,-1214,-840,1584.2,15842,17016,6.8,4,4,8,211,21.1,0,0,0,1,1,198,19.8,2,11,7,7,6.8,17856,17056,1705.6,840,1214,0
3987,-420,-1518,1638.8,16388,17168,7.0,4,4,4,220,22.0,1,0,0,1,0,239,23.9,0,10,7,7,7.2,18686,16808,1680.8,1518,420,0
3988,425,422,1583.7,15837,18178,7.0,4,4,6,226,22.6,2,1,1,0,0,255,25.5,0,1,2,2,7.0,17756,15412,1541.2,-422,-425,1
3989,4175,3930,1892.9,18929,19632,7.4,11,11,12,220,22.0,1,1,0,1,0,201,20.1,1,3,3,3,6.6,15702,14754,1475.4,-3930,-4175,1
3990,2866,1474,1733.6,17336,18459,7.0,7,7,10,231,23.1,1,1,1,0,0,198,19.8,0,0,2,2,6.8,16985,14470,1447.0,-1474,-2866,1
3991,-3645,-1801,1580.2,15802,17403,6.8,4,4,3,218,21.8,0,0,0,1,1,214,21.4,1,14,13,13,7.2,19204,19447,1944.7,1801,3645,0
3992,930,567,1699.5,16995,18679,7.0,6,6,9,230,23.0,1,1,1,0,0,221,22.1,0,3,5,5,7.0,18112,16065,1606.5,-567,-930,0
3993,2617,3735,1652.8,16528,20454,7.4,2,2,1,262,26.2,0,0,1,0,1,231,23.1,1,1,1,1,6.6,16719,13911,1391.1,-3735,-2617,1
3994,1276,1161,1718.2,17182,18588,7.2,7,7,8,233,23.3,1,1,0,1,0,213,21.3,0,8,5,5,6.8,17427,15906,1590.6,-1161,-1276,0
3995,-1031,-570,1601.7,16017,17524,6.6,4,4,4,202,20.2,0,0,0,1,0,226,22.6,0,7,7,7,7.0,18094,17048,1704.8,570,1031,0
3996,-396,795,1628.6,16286,18048,6.8,6,6,4,230,23.0,0,0,0,1,1,229,22.9,1,3,7,7,6.6,17253,16682,1668.2,-795,396,1
3997,2445,-81,1908.4,19084,17286,6.8,9,9,7,225,22.5,1,0,0,1,1,189,18.9,1,5,8,8,6.8,17367,16639,1663.9,81,-2445,0
3998,-5515,-3391,1489.9,14899,16761,6.8,4,4,5,190,19.0,0,0,0,1,0,239,23.9,0,19,12,12,7.4,20152,20414,2041.4,3391,5515,0
3999,-3502,-2187,1729.0,17290,17418,7.0,9,9,8,223,22.3,0,0,0,1,1,228,22.8,1,19,18,18,7.4,19605,20792,2079.2,2187,3502,0
4000,1613,80,1756.9,17569,17848,6.8,4,4,8,265,26.5,0,0,1,0,1,214,21.4,2,4,6,6,6.8,17768,15956,1595.6,-80,-1613,0
4001,3311,3991,1796.4,17964,19813,7.4,9,9,9,213,21.3,1,1,0,1,0,198,19.8,0,2,2,2,6.4,15822,14653,1465.3,-3991,-3311,1
4002,-1255,-121,1540.0,15400,18242,7.0,5,5,6,197,19.7,0,0,0,1,1,250,25.0,1,8,5,5,7.2,18363,16655,1665.5,121,1255,1
4003,642,-3,1776.1,17761,19090,7.2,8,8,6,220,22.0,1,1,1,0,0,218,21.8,0,6,8,8,7.2,19093,17119,1711.9,3,-642,0
4004,-1428,-1532,1648.0,16480,17338,7.0,8,8,5,183,18.3,1,1,1,0,0,192,19.2,0,10,10,10,7.4,18870,17908,1790.8,1532,1428,1
4005,1735,2029,1697.5,16975,19639,7.4,8,8,6,238,23.8,0,0,1,0,0,228,22.8,0,2,3,3,6.6,17610,15240,1524.0,-2029,-1735,0
4006,785,1188,1645.9,16459,18670,7.2,5,5,7,222,22.2,1,1,0,1,0,229,22.9,0,1,4,4,6.6,17482,15674,1567.4,-1188,-785,1
4007,-1117,-509,1663.6,16636,17569,6.8,7,7,7,207,20.7,1,1,1,0,0,230,23.0,0,4,7,7,7.0,18078,17753,1775.3,509,1117,1
4008,-748,-1865,1655.0,16550,17563,6.8,5,5,5,204,20.4,0,0,0,1,0,227,22.7,1,9,8,8,7.2,19428,17298,1729.8,1865,748,0
4009,-125,537,1640.0,16400,18604,6.8,8,8,10,181,18.1,1,1,1,0,0,247,24.7,0,2,5,5,7.0,18067,16525,1652.5,-537,125,1
4010,-3613,-1592,1447.8,14478,16901,6.6,2,2,1,237,23.7,1,1,0,1,0,232,23.2,0,9,9,9,7.0,18493,18091,1809.1,1592,3613,0
4011,3723,2815,1905.8,19058,19477,7.2,12,12,12,214,21.4,1,1,1,0,0,200,20.0,1,7,4,4,6.6,16662,15335,1533.5,-2815,-3723,1
4012,5073,1803,2031.6,20316,18784,7.4,9,9,12,230,23.0,1,1,1,0,0,224,22.4,1,3,3,3,6.4,16981,15243,1524.3,-1803,-5073,1
4013,1031,98,1708.3,17083,18817,7.2,5,5,3,248,24.8,0,0,1,0,1,220,22.0,2,6,6,6,7.2,18719,16052,1605.2,-98,-1031,1
4014,2470,1917,1761.3,17613,18689,6.8,8,8,8,225,22.5,1,1,1,0,0,199,19.9,0,3,4,4,6.4,16772,15143,1514.3,-1917,-2470,1
4015,2748,842,1773.1,17731,18766,7.0,9,9,9,252,25.2,1,1,1,0,0,214,21.4,0,3,3,3,7.0,17924,14983,1498.3,-842,-2748,1
4016,-2861,-2348,1431.2,14312,16196,6.6,4,4,4,144,14.4,2,1,0,1,0,217,21.7,0,12,8,8,7.2,18544,17173,1717.3,2348,2861,1
4017,2524,2733,1690.3,16903,19854,7.4,8,8,10,207,20.7,2,1,1,0,0,199,19.9,0,1,3,3,6.8,17121,14379,1437.9,-2733,-2524,1
4018,2191,2220,1713.7,17137,18628,7.0,7,7,8,240,24.0,1,1,0,1,0,203,20.3,0,7,4,4,6.4,16408,14946,1494.6,-2220,-2191,1
4019,5014,3238,1887.0,18870,18880,7.0,9,9,8,232,23.2,0,0,1,0,0,173,17.3,0,5,3,3,6.2,15642,13856,1385.6,-3238,-5014,1
4020,-1023,92,1527.9,15279,18515,7.0,3,3,3,240,24.0,1,1,0,1,0,243,24.3,1,4,4,4,7.0,18423,16302,1630.2,-92,1023,1
4021,1497,1555,1926.2,19262,18021,7.0,10,10,12,223,22.3,1,0,1,0,1,211,21.1,1,7,7,7,6.6,16466,17765,1776.5,-1555,-1497,1
4022,-1554,-781,1565.1,15651,16491,6.6,5,5,8,211,21.1,0,0,1,0,0,203,20.3,0,10,9,9,6.8,17272,17205,1720.5,781,1554,0
4023,2310,4456,1768.2,17682,20336,7.6,10,10,7,201,20.1,0,0,1,0,1,210,21.0,1,10,6,6,6.4,15880,15372,1537.2,-4456,-2310,1
4024,-907,-1159,1620.9,16209,18802,7.2,4,4,4,235,23.5,1,1,1,0,0,242,24.2,0,7,6,6,7.2,19961,17116,1711.6,1159,907,0
4025,3227,1158,1899.6,18996,18231,7.2,10,10,12,231,23.1,0,0,0,1,1,175,17.5,1,5,7,7,6.6,17073,15769,1576.9,-1158,-3227,0
4026,4083,3740,2085.5,20855,20164,7.2,15,15,12,196,19.6,1,1,1,0,0,171,17.1,0,8,8,8,6.6,16424,16772,1677.2,-3740,-4083,1
4027,-1397,-730,1548.5,15485,17345,6.8,5,5,6,208,20.8,0,0,0,1,1,225,22.5,1,5,7,7,7.2,18075,16882,1688.2,730,1397,0
4028,-564,-422,1604.3,16043,17912,7.0,5,5,6,227,22.7,1,1,1,0,0,236,23.6,1,9,5,5,7.0,18334,16607,1660.7,422,564,0
4029,-1221,-214,1647.6,16476,17056,7.0,5,5,10,215,21.5,0,0,0,1,1,186,18.6,1,18,11,11,6.6,17270,17697,1769.7,214,1221,0
4030,-1093,-449,1547.3,15473,17491,6.8,4,4,3,215,21.5,0,0,0,1,1,236,23.6,1,7,7,7,7.0,17940,16566,1656.6,449,1093,0
4031,-1301,-502,1515.7,15157,17194,6.8,5,5,6,218,21.8,2,1,1,0,0,209,20.9,0,8,7,7,7.0,17696,16458,1645.8,502,1301,0
4032,-2393,-881,1481.2,14812,17359,6.8,6,6,3,183,18.3,0,0,1,0,0,214,21.4,0,8,10,10,7.0,18240,17205,1720.5,881,2393,0
4033,66,-115,1595.9,15959,16675,6.8,6,6,4,236,23.6,0,0,0,1,1,187,18.7,1,5,5,5,6.6,16790,15893,1589.3,115,-66,0
4034,1994,1541,1685.0,16850,19499,7.2,7,7,7,228,22.8,1,1,1,0,0,224,22.4,1,2,1,1,7.0,17958,14856,1485.6,-1541,-1994,1
4035,-1131,-1921,1494.0,14940,16977,6.6,3,3,4,238,23.8,0,0,0,1,0,247,24.7,0,2,3,3,7.0,18898,16071,1607.1,1921,1131,1
4036,1055,1659,1755.0,17550,19690,7.2,8,8,8,218,21.8,1,0,0,1,1,248,24.8,1,7,5,5,7.2,18031,16495,1649.5,-1659,-1055,0
4037,798,-1263,1654.2,16542,17667,6.8,7,7,9,214,21.4,0,0,0,1,1,195,19.5,1,4,5,5,7.2,18930,15744,1574.4,1263,-798,0
4038,1134,157,1729.7,17297,17523,6.8,7,7,11,196,19.6,1,0,0,1,1,238,23.8,1,4,5,5,6.6,17366,16163,1616.3,-157,-1134,1
4039,2883,1059,1958.1,19581,18509,6.8,9,9,10,232,23.2,1,0,0,1,1,201,20.1,1,8,7,7,7.2,17450,16698,1669.8,-1059,-2883,0
4040,-3226,-2335,1471.2,14712,17001,6.6,2,2,0,230,23.0,1,0,1,0,1,237,23.7,1,9,9,9,7.2,19336,17938,1793.8,2335,3226,0
4041,814,2199,1658.7,16587,17630,7.0,9,9,7,212,21.2,2,1,1,0,0,176,17.6,0,7,5,5,6.4,15431,15773,1577.3,-2199,-814,1
4042,-1209,-747,1742.9,17429,18630,7.0,8,8,9,198,19.8,1,0,1,0,0,212,21.2,0,10,11,11,7.4,19377,18638,1863.8,747,1209,1
4043,256,241,1554.7,15547,17921,7.2,4,4,5,208,20.8,1,0,1,0,1,222,22.2,1,2,4,4,6.8,17680,15291,1529.1,-241,-256,1
4044,-3881,-447,1495.7,14957,17705,6.8,4,4,4,173,17.3,0,0,0,1,0,223,22.3,0,12,12,12,7.0,18152,18838,1883.8,447,3881,0
4045,3610,2295,1745.0,17450,19276,7.2,6,6,9,233,23.3,1,1,1,0,0,226,22.6,0,1,1,1,6.4,16981,13840,1384.0,-2295,-3610,1
4046,3013,2244,1719.9,17199,19353,7.4,7,7,8,235,23.5,1,1,1,0,0,205,20.5,0,0,2,2,6.6,17109,14186,1418.6,-2244,-3013,1
4047,1353,1332,1661.0,16610,18953,7.0,6,6,6,231,23.1,1,1,1,0,0,236,23.6,0,2,2,2,6.8,17621,15257,1525.7,-1332,-1353,1
4048,-2914,-2683,1479.5,14795,16454,6.6,5,5,3,178,17.8,1,1,0,1,0,229,22.9,1,11,8,8,7.2,19137,17709,1770.9,2683,2914,0
4049,1974,861,1826.9,18269,19161,7.2,10,10,6,228,22.8,0,0,0,1,1,199,19.9,2,8,7,7,7.0,18300,16295,1629.5,-861,-1974,0
4050,-3012,-1300,1388.9,13889,16427,6.8,2,2,3,205,20.5,1,0,0,1,1,195,19.5,1,10,7,7,7.2,17727,16901,1690.1,1300,3012,0
4051,-30,-200,1595.0,15950,17916,7.2,5,5,7,220,22.0,1,1,0,1,0,238,23.8,1,3,4,4,7.0,18116,15980,1598.0,200,30,1
4052,-1747,-1827,1523.5,15235,16288,6.6,6,6,5,189,18.9,2,1,0,1,0,223,22.3,0,9,7,7,6.8,18115,16982,1698.2,1827,1747,1
4053,-333,1358,1669.7,16697,19017,7.4,7,7,5,205,20.5,1,0,0,1,1,222,22.2,1,8,8,8,6.8,17659,17030,1703.0,-1358,333,1
4054,1294,213,1745.0,17450,18559,7.0,7,7,11,236,23.6,0,0,0,1,0,213,21.3,0,4,5,5,7.2,18346,16156,1615.6,-213,-1294,0
4055,-1773,-422,1589.6,15896,17492,6.8,6,6,3,171,17.1,0,0,1,0,1,221,22.1,1,10,9,9,6.8,17914,17669,1766.9,422,1773,0
4056,-325,772,1594.3,15943,19085,7.2,4,4,5,239,23.9,0,0,1,0,1,226,22.6,1,5,5,5,6.8,18313,16268,1626.8,-772,325,0
4057,-163,-674,1806.3,18063,16794,6.6,7,7,8,228,22.8,1,0,1,0,1,201,20.1,1,19,10,10,6.8,17468,18226,1822.6,674,163,0
4058,-2281,-1283,1617.7,16177,17721,6.8,5,5,6,214,21.4,0,0,0,1,1,229,22.9,1,12,12,12,7.2,19004,18458,1845.8,1283,2281,1
4059,-1243,-635,1489.6,14896,17066,6.8,2,2,2,205,20.5,1,0,1,0,1,195,19.5,1,7,6,6,6.6,17701,16139,1613.9,635,1243,0
4060,1522,1737,1695.9,16959,19261,7.0,8,8,4,215,21.5,1,0,1,0,1,218,21.8,1,4,4,4,6.8,17524,15437,1543.7,-1737,-1522,0
4061,2448,1861,1636.3,16363,17356,6.8,6,6,10,209,20.9,1,0,1,0,0,184,18.4,0,4,3,3,6.4,15495,13915,1391.5,-1861,-2448,1
4062,-3701,-2739,1666.5,16665,17063,6.8,10,10,6,189,18.9,0,0,0,1,1,220,22.0,1,11,14,14,7.4,19802,20366,2036.6,2739,3701,0
4063,-166,-712,1537.7,15377,17617,7.0,2,2,1,229,22.9,1,1,1,0,0,214,21.4,0,2,4,4,7.0,18329,15543,1554.3,712,166,1
4064,-2707,-3132,1397.7,13977,15961,6.6,3,3,2,185,18.5,0,0,1,0,1,226,22.6,2,5,6,6,7.4,19093,16684,1668.4,3132,2707,0
4065,-1932,-41,1391.8,13918,17849,7.0,1,1,0,200,20.0,0,0,0,1,1,225,22.5,1,7,3,3,6.8,17890,15850,1585.0,41,1932,1
4066,13,2012,1763.0,17630,18364,7.0,9,9,14,230,23.0,1,1,0,1,0,165,16.5,0,10,9,9,6.4,16352,17617,1761.7,-2012,-13,1
4067,-621,-784,1577.7,15777,17261,6.8,4,4,4,229,22.9,0,0,0,1,1,204,20.4,1,14,7,7,7.0,18045,16398,1639.8,784,621,1
4068,-689,-1668,1604.3,16043,17403,6.8,5,5,6,237,23.7,0,0,0,1,1,231,23.1,1,5,7,7,7.0,19071,16732,1673.2,1668,689,0
4069,3028,2524,1902.2,19022,19112,7.0,11,11,8,217,21.7,0,0,1,0,0,190,19.0,0,8,6,6,6.4,16588,15994,1599.4,-2524,-3028,1
4070,-2788,-1304,1395.7,13957,16250,6.4,3,3,4,187,18.7,1,1,1,0,0,210,21.0,0,10,7,7,6.8,17554,16745,1674.5,1304,2788,0
4071,-5367,-3464,1454.7,14547,16366,6.6,2,2,3,212,21.2,1,1,0,1,0,238,23.8,1,9,9,9,7.2,19830,19914,1991.4,3464,5367,0
4072,-1209,-1184,1564.9,15649,17165,6.6,5,5,10,240,24.0,1,1,1,0,0,238,23.8,0,9,6,6,7.0,18349,16858,1685.8,1184,1209,1
4073,1405,2118,1765.4,17654,19048,7.0,9,9,11,249,24.9,1,1,1,0,0,204,20.4,1,6,5,5,6.8,16930,16249,1624.9,-2118,-1405,1
4074,3335,2786,1985.8,19858,19501,7.4,11,11,12,216,21.6,1,0,1,0,1,168,16.8,1,12,9,9,6.4,16715,16523,1652.3,-2786,-3335,1
4075,-3700,-2130,1351.7,13517,16278,6.2,1,1,0,222,22.2,0,0,0,1,1,247,24.7,1,10,6,6,7.2,18408,17217,1721.7,2130,3700,0
4076,2763,1017,1779.1,17791,18557,7.2,7,7,12,250,25.0,2,1,1,0,0,200,20.0,0,5,3,3,6.8,17540,15028,1502.8,-1017,-2763,1
4077,1060,952,1681.7,16817,17889,6.8,7,7,5,208,20.8,1,1,1,0,0,185,18.5,1,5,6,6,6.4,16937,15757,1575.7,-952,-1060,1
4078,-1959,-630,1492.0,14920,17487,6.8,3,3,4,217,21.7,1,0,0,1,1,242,24.2,1,6,6,6,7.0,18117,16879,1687.9,630,1959,1
4079,2613,1450,1716.0,17160,18450,7.0,7,7,8,221,22.1,0,0,0,1,1,213,21.3,1,3,5,5,6.4,17000,14547,1454.7,-1450,-2613,0
4080,-684,-742,1543.6,15436,18911,7.0,5,5,5,220,22.0,1,0,0,1,1,267,26.7,1,6,4,4,7.2,19653,16120,1612.0,742,684,1
4081,-79,-815,1544.2,15442,18590,7.2,4,4,3,220,22.0,1,1,0,1,0,217,21.7,1,4,3,3,7.2,19405,15521,1552.1,815,79,1
4082,-1929,-655,1576.4,15764,17960,6.8,4,4,1,237,23.7,0,0,1,0,0,236,23.6,1,6,7,7,7.2,18615,17693,1769.3,655,1929,1
4083,-615,-150,1674.4,16744,18061,6.8,6,6,8,231,23.1,1,1,0,1,0,237,23.7,0,7,6,6,7.0,18211,17359,1735.9,150,615,0
4084,5058,1536,2030.8,20308,18069,7.0,13,13,16,216,21.6,1,1,1,0,0,197,19.7,0,3,4,4,6.6,16533,15250,1525.0,-1536,-5058,1
4085,1601,459,1873.1,18731,18892,6.8,9,9,8,191,19.1,1,0,1,0,1,240,24.0,1,6,8,8,7.2,18433,17130,1713.0,-459,-1601,1
4086,-2347,-1346,1552.9,15529,17544,6.8,5,5,5,200,20.0,0,0,0,1,0,229,22.9,1,9,9,9,7.2,18890,17876,1787.6,1346,2347,0
4087,585,2037,1516.9,15169,18276,6.8,4,4,1,208,20.8,0,0,0,1,0,196,19.6,0,5,4,4,6.4,16239,14584,1458.4,-2037,-585,1
4088,-372,177,1707.5,17075,17991,6.8,7,7,4,218,21.8,1,0,0,1,0,217,21.7,0,11,9,9,7.0,17814,17447,1744.7,-177,372,1
4089,3407,3210,1746.7,17467,20584,7.4,5,5,5,245,24.5,0,0,1,0,0,214,21.4,0,3,1,1,6.8,17374,14060,1406.0,-3210,-3407,1
4090,2452,1600,1725.9,17259,19920,7.4,6,6,5,249,24.9,1,1,1,0,0,221,22.1,0,5,2,2,7.0,18320,14807,1480.7,-1600,-2452,1
4091,2507,2680,1797.9,17979,18648,7.0,10,10,9,214,21.4,0,0,0,1,1,214,21.4,1,6,4,4,6.4,15968,15472,1547.2,-2680,-2507,1
4092,-2153,-1519,1426.9,14269,16548,6.6,2,2,3,196,19.6,0,0,1,0,0,211,21.1,0,8,7,7,7.0,18067,16422,1642.2,1519,2153,0
4093,3039,2335,1830.9,18309,20268,7.6,9,9,11,234,23.4,1,1,1,0,0,223,22.3,0,3,3,3,7.0,17933,15270,1527.0,-2335,-3039,1
4094,286,786,1711.6,17116,19586,7.4,7,7,9,246,24.6,1,1,0,1,0,219,21.9,0,5,6,6,7.2,18800,16830,1683.0,-786,-286,0
4095,-336,-681,1597.0,15970,17491,6.8,7,7,8,200,20.0,1,1,1,0,0,220,22.0,0,4,7,7,7.0,18172,16306,1630.6,681,336,0
4096,-4726,-2067,1462.6,14626,16067,6.4,6,6,4,154,15.4,0,0,0,1,1,224,22.4,1,11,10,10,7.0,18134,19352,1935.2,2067,4726,0
4097,-3441,-1876,1642.7,16427,17468,6.8,8,8,7,191,19.1,0,0,1,0,0,259,25.9,0,15,10,10,7.2,19344,19868,1986.8,1876,3441,1
4098,-4489,-4047,1467.6,14676,14842,6.2,3,3,4,191,19.1,1,1,0,1,0,224,22.4,0,13,13,13,7.0,18889,19165,1916.5,4047,4489,0
4099,-5302,-3981,1394.3,13943,16274,6.2,1,1,1,204,20.4,0,0,0,1,0,238,23.8,0,13,11,11,7.4,20255,19245,1924.5,3981,5302,0
4100,-4903,-3146,1548.8,15488,16539,6.6,4,4,4,184,18.4,0,0,0,1,1,204,20.4,1,16,17,17,7.4,19685,20391,2039.1,3146,4903,1
4101,-152,-901,1543.7,15437,16652,6.6,6,6,6,198,19.8,1,1,1,0,0,220,22.0,1,6,4,4,7.0,17553,15589,1558.9,901,152,0
4102,2263,1666,1708.3,17083,19485,7.2,6,6,7,241,24.1,0,0,1,0,1,250,25.0,1,1,2,2,7.0,17819,14820,1482.0,-1666,-2263,0
4103,-3103,-2355,1482.5,14825,17113,6.8,2,2,3,236,23.6,1,0,0,1,1,230,23.0,1,16,10,10,7.2,19468,17928,1792.8,2355,3103,0
4104,5650,4520,1940.2,19402,19955,7.4,12,12,10,242,24.2,1,1,1,0,0,188,18.8,0,4,3,3,6.4,15435,13752,1375.2,-4520,-5650,1
4105,-1330,-639,1512.9,15129,17887,7.0,4,4,4,197,19.7,1,1,0,1,0,241,24.1,0,4,5,5,7.0,18526,16459,1645.9,639,1330,0
4106,-3526,-1273,1505.3,15053,17983,6.8,2,2,3,248,24.8,0,0,1,0,0,234,23.4,0,9,5,5,7.2,19256,18579,1857.9,1273,3526,0
4107,-1209,-2033,1467.2,14672,16400,6.6,2,2,2,229,22.9,0,0,1,0,1,252,25.2,1,2,5,5,7.0,18433,15881,1588.1,2033,1209,0
4108,2171,1839,1828.0,18280,19939,7.4,10,10,8,241,24.1,1,1,1,0,0,196,19.6,0,4,6,6,7.0,18100,16109,1610.9,-1839,-2171,0
4109,-2387,-2353,1529.0,15290,17203,6.6,4,4,4,219,21.9,1,1,0,1,0,242,24.2,0,6,8,8,7.4,19556,17677,1767.7,2353,2387,0
4110,2252,1086,1732.9,17329,18182,7.0,9,9,13,189,18.9,1,0,0,1,0,244,24.4,0,2,1,1,7.0,17096,15077,1507.7,-1086,-2252,1
4111,596,486,1640.9,16409,18420,6.8,6,6,3,232,23.2,1,1,0,1,0,202,20.2,0,4,4,4,7.0,17934,15813,1581.3,-486,-596,1
4112,206,257,1823.7,18237,17871,6.6,10,10,8,235,23.5,1,0,1,0,0,175,17.5,0,14,11,11,6.8,17614,18031,1803.1,-257,-206,1
4113,3146,2257,1725.9,17259,18091,7.0,9,9,11,214,21.4,2,1,0,1,0,221,22.1,0,1,2,2,6.4,15834,14113,1411.3,-2257,-3146,1
4114,1789,244,1781.6,17816,18186,7.0,8,8,10,226,22.6,1,0,1,0,1,210,21.0,1,11,6,6,6.8,17942,16027,1602.7,-244,-1789,1
4115,84,-1185,1646.5,16465,17106,6.6,8,8,11,215,21.5,1,1,1,0,0,203,20.3,0,5,7,7,7.2,18291,16381,1638.1,1185,-84,0
4116,340,1086,1902.9,19029,19459,7.4,10,10,9,234,23.4,0,0,1,0,0,182,18.2,0,14,11,11,7.2,18373,18689,1868.9,-1086,-340,0
4117,1531,-222,1707.5,17075,17444,6.8,7,7,13,202,20.2,1,1,1,0,0,252,25.2,0,2,2,2,6.8,17666,15544,1554.4,222,-1531,1
4118,-177,-38,1668.9,16689,19570,7.4,6,6,7,233,23.3,0,0,1,0,0,236,23.6,0,4,4,4,7.2,19608,16866,1686.6,38,177,1
4119,-688,-577,1440.2,14402,17052,6.6,1,1,2,233,23.3,0,0,0,1,1,258,25.8,1,3,2,2,6.8,17629,15090,1509.0,577,688,1
4120,1429,1224,1637.9,16379,18268,6.8,5,5,4,240,24.0,1,1,1,0,0,226,22.6,0,4,3,3,6.8,17044,14950,1495.0,-1224,-1429,0
4121,-3603,-3793,1457.9,14579,15951,6.6,3,3,3,227,22.7,0,0,0,1,0,232,23.2,0,9,11,11,7.2,19744,18182,1818.2,3793,3603,0
4122,-614,-1330,1645.5,16455,18248,7.2,6,6,8,214,21.4,0,0,1,0,1,243,24.3,2,5,5,5,7.4,19578,17069,1706.9,1330,614,0
4123,-2374,-2316,1377.0,13770,15846,6.4,3,3,4,192,19.2,1,1,0,1,0,239,23.9,0,5,5,5,7.0,18162,16144,1614.4,2316,2374,0
4124,-1416,-362,1604.2,16042,17983,6.8,6,6,5,218,21.8,1,1,0,1,0,243,24.3,0,6,9,9,7.2,18345,17458,1745.8,362,1416,1
4125,-1090,522,1490.5,14905,18468,6.8,2,2,2,244,24.4,1,1,0,1,0,243,24.3,0,4,4,4,6.8,17946,15995,1599.5,-522,1090,1
4126,3925,4105,1873.3,18733,19592,7.4,11,11,12,201,20.1,0,0,0,1,1,179,17.9,1,9,4,4,6.4,15487,14808,1480.8,-4105,-3925,1
4127,-2574,-2554,1749.6,17496,17522,6.8,9,9,11,185,18.5,0,0,1,0,1,198,19.8,1,13,14,14,7.4,20076,20070,2007.0,2554,2574,0
4128,2667,1951,1830.3,18303,18032,7.0,11,11,7,202,20.2,2,1,1,0,0,174,17.4,0,5,7,7,6.4,16081,15636,1563.6,-1951,-2667,1
4129,-1421,-1367,1539.5,15395,17472,6.6,4,4,5,221,22.1,1,1,0,1,0,212,21.2,1,6,9,9,7.0,18839,16816,1681.6,1367,1421,0
4130,-41,307,1654.0,16540,18026,6.8,6,6,4,230,23.0,1,1,1,0,0,254,25.4,1,5,4,4,6.6,17719,16581,1658.1,-307,41,1
4131,-2579,-1094,1634.2,16342,17877,6.8,7,7,9,211,21.1,1,0,1,0,1,238,23.8,1,6,7,7,7.2,18971,18921,1892.1,1094,2579,0
4132,-468,-581,1554.0,15540,17724,6.8,4,4,6,236,23.6,0,0,0,1,1,234,23.4,2,5,6,6,7.0,18305,16008,1600.8,581,468,0
4133,-2884,-2378,1499.3,14993,17460,6.6,4,4,2,208,20.8,0,0,0,1,1,226,22.6,1,8,11,11,7.4,19838,17877,1787.7,2378,2884,0
4134,318,370,1602.2,16022,17931,6.8,6,6,9,227,22.7,0,0,1,0,1,210,21.0,1,4,5,5,6.8,17561,15704,1570.4,-370,-318,0
4135,2604,432,1797.8,17978,18771,7.4,7,7,10,216,21.6,1,1,0,1,0,220,22.0,0,0,4,4,7.0,18339,15374,1537.4,-432,-2604,1
4136,1388,441,1789.8,17898,18357,6.8,9,9,12,215,21.5,0,0,1,0,1,212,21.2,1,10,6,6,7.0,17916,16510,1651.0,-441,-1388,0
4137,-5455,-2144,1317.0,13170,15312,6.2,2,2,1,162,16.2,0,0,0,1,0,211,21.1,0,10,12,12,6.8,17456,18625,1862.5,2144,5455,0
4138,-3333,-1389,1436.4,14364,17602,7.0,3,3,2,190,19.0,0,0,0,1,1,251,25.1,1,6,6,6,7.2,18991,17697,1769.7,1389,3333,0
4139,4570,2205,1929.4,19294,18363,7.0,9,9,10,234,23.4,1,0,1,0,0,162,16.2,0,8,5,5,6.6,16158,14724,1472.4,-2205,-4570,1
4140,900,1093,1744.6,17446,18714,7.0,11,11,15,186,18.6,0,0,1,0,1,220,22.0,1,8,7,7,6.8,17621,16546,1654.6,-1093,-900,1
4141,1493,33,1794.3,17943,18261,6.8,11,11,5,220,22.0,1,1,1,0,0,197,19.7,0,2,6,6,7.0,18228,16450,1645.0,-33,-1493,1
4142,1786,-261,1665.6,16656,17435,6.8,7,7,4,214,21.4,1,1,1,0,0,206,20.6,0,3,3,3,6.8,17696,14870,1487.0,261,-1786,1
4143,1819,1262,1614.9,16149,18239,6.8,6,6,6,220,22.0,2,1,1,0,0,206,20.6,0,1,2,2,6.6,16977,14330,1433.0,-1262,-1819,1
4144,-433,445,1556.4,15564,17895,6.8,4,4,4,216,21.6,0,0,0,1,1,225,22.5,1,7,5,5,6.8,17450,15997,1599.7,-445,433,0
4145,-860,-334,1512.8,15128,17938,7.0,2,2,3,251,25.1,0,0,0,1,1,226,22.6,1,9,5,5,7.0,18272,15988,1598.8,334,860,0
4146,43,-1092,1555.1,15551,17278,6.8,4,4,3,206,20.6,1,0,0,1,1,218,21.8,1,2,4,4,6.8,18370,15508,1550.8,1092,-43,1
4147,-642,-397,1642.6,16426,18382,7.0,5,5,8,231,23.1,0,0,1,0,1,193,19.3,1,6,9,9,7.0,18779,17068,1706.8,397,642,1
4148,-1328,333,1559.4,15594,18180,7.0,5,5,5,201,20.1,2,1,0,1,0,227,22.7,0,7,6,6,6.8,17847,16922,1692.2,-333,1328,1
4149,-622,59,1567.4,15674,17096,6.6,5,5,8,215,21.5,2,1,1,0,0,189,18.9,0,8,7,7,6.8,17037,16296,1629.6,-59,622,0
4150,1903,2160,1844.4,18444,19294,7.2,12,12,11,196,19.6,0,0,0,1,1,173,17.3,1,4,8,8,6.6,17134,16541,1654.1,-2160,-1903,1
4151,580,2959,1692.9,16929,19809,7.2,10,10,5,222,22.2,1,1,1,0,0,192,19.2,0,11,6,6,6.8,16850,16349,1634.9,-2959,-580,1
4152,2252,1577,1770.1,17701,19075,7.2,8,8,11,246,24.6,1,1,0,1,0,228,22.8,0,3,3,3,6.8,17498,15449,1544.9,-1577,-2252,1
4153,1686,2152,1702.0,17020,19853,7.2,5,5,5,238,23.8,2,1,0,1,0,253,25.3,0,3,2,2,7.0,17701,15334,1533.4,-2152,-1686,1
4154,718,1313,1839.5,18395,18790,7.2,12,12,11,193,19.3,1,1,0,1,0,206,20.6,0,9,9,9,7.0,17477,17677,1767.7,-1313,-718,1
4155,3767,3277,1864.6,18646,19823,7.6,9,9,8,253,25.3,1,1,1,0,0,195,19.5,0,6,4,4,6.6,16546,14879,1487.9,-3277,-3767,1
4156,-2596,-2891,1588.7,15887,16048,6.4,6,6,8,191,19.1,0,0,0,1,0,220,22.0,0,13,11,11,7.2,18939,18483,1848.3,2891,2596,0
4157,-2511,-2288,1409.8,14098,14987,6.2,3,3,2,198,19.8,1,1,1,0,0,216,21.6,0,6,5,5,6.8,17275,16609,1660.9,2288,2511,0
4158,189,-2888,1552.1,15521,15093,6.2,6,6,10,146,14.6,1,1,0,1,0,193,19.3,1,1,5,5,6.8,17981,15332,1533.2,2888,-189,0
4159,192,616,1646.0,16460,18782,7.0,7,7,9,222,22.2,1,1,0,1,0,236,23.6,0,8,5,5,7.2,18166,16268,1626.8,-616,-192,1
4160,-3586,-2840,1674.9,16749,15390,6.2,6,6,5,203,20.3,1,0,0,1,1,194,19.4,1,25,14,14,7.2,18230,20335,2033.5,2840,3586,0
4161,881,2559,1732.9,17329,19915,7.4,8,8,5,226,22.6,1,0,1,0,0,199,19.9,0,7,7,7,6.8,17356,16448,1644.8,-2559,-881,1
4162,-157,-2594,1658.2,16582,15066,6.4,7,7,12,203,20.3,0,0,0,1,1,219,21.9,2,8,6,6,7.0,17660,16739,1673.9,2594,157,0
4163,-6001,-5404,1320.6,13206,15553,6.6,1,1,0,195,19.5,0,0,0,1,1,244,24.4,1,6,11,11,7.4,20957,19207,1920.7,5404,6001,0
4164,-859,919,1642.3,16423,18901,7.2,7,7,6,212,21.2,0,0,0,1,0,226,22.6,0,6,8,8,7.0,17982,17282,1728.2,-919,859,0
4165,949,591,1707.4,17074,17874,7.2,6,6,7,214,21.4,2,1,0,1,0,225,22.5,0,6,6,6,6.8,17283,16125,1612.5,-591,-949,1
4166,-1641,-500,1344.9,13449,16803,6.6,1,1,1,189,18.9,0,0,0,1,0,224,22.4,0,4,2,2,7.0,17303,15090,1509.0,500,1641,0
4167,1499,2469,1746.6,17466,18793,7.4,6,6,10,246,24.6,2,1,1,0,0,215,21.5,0,8,5,5,6.6,16324,15967,1596.7,-2469,-1499,1
4168,2104,1643,1694.1,16941,18581,7.0,6,6,5,229,22.9,2,1,0,1,0,213,21.3,0,3,3,3,7.0,16938,14837,1483.7,-1643,-2104,1
4169,1939,166,1860.1,18601,18627,7.0,9,9,10,220,22.0,1,1,1,0,0,174,17.4,0,7,11,11,7.0,18461,16662,1666.2,-166,-1939,1
4170,253,-1300,1700.3,17003,17843,6.8,8,8,13,222,22.2,1,1,0,1,0,218,21.8,0,7,6,6,7.2,19143,16750,1675.0,1300,-253,0
4171,-1742,-1210,1457.7,14577,17474,6.8,1,1,1,263,26.3,0,0,1,0,1,234,23.4,1,6,6,6,7.0,18684,16319,1631.9,1210,1742,1
4172,986,549,1781.3,17813,17461,6.8,9,9,13,202,20.2,1,1,0,1,0,216,21.6,0,13,8,8,6.6,16912,16827,1682.7,-549,-986,1
4173,-1442,-1048,1533.2,15332,18496,7.0,5,5,1,215,21.5,1,0,1,0,1,220,22.0,1,9,6,6,7.2,19544,16774,1677.4,1048,1442,0
4174,-1113,-1417,1462.7,14627,16759,6.8,2,2,5,214,21.4,1,1,0,1,0,235,23.5,0,5,3,3,7.0,18176,15740,1574.0,1417,1113,1
4175,-229,-487,1618.7,16187,15234,6.2,9,9,11,156,15.6,0,0,1,0,1,169,16.9,1,11,8,8,6.2,15721,16416,1641.6,487,229,0
4176,4284,2585,1978.7,19787,19493,7.2,11,11,12,242,24.2,2,1,1,0,0,205,20.5,0,6,5,5,6.8,16908,15503,1550.3,-2585,-4284,1
4177,3378,3168,1859.6,18596,18850,7.2,12,12,15,188,18.8,0,0,0,1,1,207,20.7,1,6,4,4,6.4,15682,15218,1521.8,-3168,-3378,1
4178,70,-928,1623.3,16233,17076,7.0,6,6,10,223,22.3,0,0,1,0,1,225,22.5,2,7,5,5,7.0,18004,16163,1616.3,928,-70,0
4179,-2507,-1473,1546.8,15468,17872,7.0,5,5,5,203,20.3,0,0,0,1,1,243,24.3,1,7,9,9,7.4,19345,17975,1797.5,1473,2507,0
4180,320,-743,1669.9,16699,17881,7.0,8,8,8,240,24.0,0,0,0,1,1,216,21.6,1,6,7,7,7.2,18624,16379,1637.9,743,-320,0
4181,-1768,-963,1531.1,15311,16384,6.8,3,3,4,234,23.4,1,1,1,0,0,217,21.7,1,12,7,7,6.6,17347,17079,1707.9,963,1768,0
4182,1586,1273,1658.0,16580,19213,7.4,7,7,6,210,21.0,1,1,1,0,0,232,23.2,0,1,2,2,7.0,17940,14994,1499.4,-1273,-1586,1
4183,-57,-1339,1645.0,16450,17381,6.6,6,6,6,224,22.4,0,0,1,0,0,220,22.0,0,5,8,8,7.2,18720,16507,1650.7,1339,57,1
4184,-2941,-3143,1619.7,16197,15405,6.4,6,6,6,203,20.3,0,0,1,0,1,194,19.4,1,16,14,14,7.0,18548,19138,1913.8,3143,2941,0
4185,-2175,-2305,1577.3,15773,16701,6.6,4,4,4,216,21.6,1,0,1,0,1,216,21.6,1,12,10,10,7.2,19006,17948,1794.8,2305,2175,0
4186,-7866,-5377,1481.5,14815,14755,6.2,5,5,4,183,18.3,0,0,0,1,1,219,21.9,2,23,19,19,7.4,20132,22681,2268.1,5377,7866,0
4187,1870,1167,1773.1,17731,18498,7.2,6,6,11,257,25.7,1,1,1,0,0,216,21.6,1,6,6,6,6.8,17331,15861,1586.1,-1167,-1870,1
4188,-2729,-1427,1395.2,13952,17089,6.6,3,3,1,197,19.7,0,0,0,1,1,252,25.2,1,4,6,6,7.0,18516,16681,1668.1,1427,2729,1
4189,2842,1125,1850.4,18504,19037,7.2,11,11,6,212,21.2,1,0,1,0,1,192,19.2,1,3,7,7,7.0,17912,15662,1566.2,-1125,-2842,1
4190,-1276,-1016,1477.7,14777,17450,6.8,2,2,3,215,21.5,0,0,0,1,1,241,24.1,2,1,5,5,7.2,18466,16053,1605.3,1016,1276,0
4191,152,-1124,1401.8,14018,16730,7.0,1,1,1,233,23.3,0,0,0,1,1,220,22.0,1,1,1,1,7.2,17854,13866,1386.6,1124,-152,0
4192,556,879,1614.0,16140,17727,7.0,6,6,8,211,21.1,0,0,0,1,1,215,21.5,1,3,6,6,6.6,16848,15584,1558.4,-879,-556,1
4193,750,786,1624.6,16246,18652,7.2,6,6,5,199,19.9,0,0,1,0,0,199,19.9,0,6,5,5,6.8,17866,15496,1549.6,-786,-750,1
4194,-1782,-308,1612.2,16122,17866,7.0,7,7,8,186,18.6,1,1,0,1,0,253,25.3,1,10,8,8,7.0,18174,17904,1790.4,308,1782,0
4195,-2375,-2008,1542.9,15429,17256,6.8,5,5,3,198,19.8,0,0,0,1,1,222,22.2,1,11,8,8,7.2,19264,17804,1780.4,2008,2375,0
4196,-1103,-2692,1427.0,14270,16394,6.6,1,1,2,230,23.0,0,0,1,0,1,244,24.4,1,3,4,4,7.0,19086,15373,1537.3,2692,1103,0
4197,2246,2898,1632.7,16327,19683,7.4,4,4,7,240,24.0,0,0,1,0,0,235,23.5,0,2,1,1,7.0,16785,14081,1408.1,-2898,-2246,1
4198,1868,726,1822.5,18225,18898,7.2,8,8,7,236,23.6,0,0,1,0,0,223,22.3,0,5,5,5,6.8,18172,16357,1635.7,-726,-1868,1
4199,-628,-864,1777.8,17778,18403,7.0,9,9,8,204,20.4,1,0,1,0,1,197,19.7,1,12,12,12,7.2,19267,18406,1840.6,864,628,1
4200,899,969,1668.0,16680,19095,7.2,5,5,7,247,24.7,2,1,0,1,0,209,20.9,0,4,4,4,6.8,18126,15781,1578.1,-969,-899,1
4201,428,-939,1643.4,16434,18059,6.8,6,6,12,214,21.4,1,1,1,0,0,184,18.4,1,2,6,6,7.2,18998,16006,1600.6,939,-428,0
4202,1721,1678,1872.1,18721,18774,7.4,13,13,22,164,16.4,0,0,0,1,1,195,19.5,2,9,8,8,6.8,17096,17000,1700.0,-1678,-1721,1
4203,-2607,-2365,1510.7,15107,17606,6.8,5,5,6,187,18.7,1,1,1,0,0,238,23.8,0,8,8,8,7.4,19971,17714,1771.4,2365,2607,0
4204,3084,3352,1689.7,16897,20576,7.6,7,7,4,240,24.0,1,1,1,0,0,219,21.9,0,0,0,0,6.6,17224,13813,1381.3,-3352,-3084,1
4205,-941,-1717,1701.3,17013,17832,7.0,6,6,10,246,24.6,0,0,0,1,0,240,24.0,0,7,9,9,7.4,19549,17954,1795.4,1717,941,1
4206,2175,506,1804.7,18047,18160,7.2,7,7,5,239,23.9,0,0,1,0,1,229,22.9,1,4,5,5,6.8,17654,15872,1587.2,-506,-2175,1
4207,-1243,-425,1517.5,15175,18100,7.0,3,3,2,232,23.2,1,1,0,1,0,219,21.9,0,6,5,5,7.2,18525,16418,1641.8,425,1243,0
4208,-978,-1232,1672.2,16722,16113,6.6,8,8,9,190,19.0,0,0,0,1,1,200,20.0,1,14,10,10,6.8,17345,17700,1770.0,1232,978,0
4209,679,471,1572.2,15722,16349,6.8,5,5,5,222,22.2,0,0,1,0,0,181,18.1,0,5,5,5,6.4,15878,15043,1504.3,-471,-679,1
4210,-995,-1497,1707.7,17077,16829,6.8,6,6,7,175,17.5,1,0,1,0,1,228,22.8,1,10,9,9,7.2,18326,18072,1807.2,1497,995,0
4211,3266,1337,1701.6,17016,19237,7.2,6,6,4,214,21.4,2,1,1,0,0,218,21.8,0,0,1,1,6.8,17900,13750,1375.0,-1337,-3266,0
4212,792,-474,1723.1,17231,17227,6.8,5,5,5,175,17.5,2,1,1,0,0,177,17.7,0,10,9,9,7.0,17701,16439,1643.9,474,-792,0
4213,3032,2096,1703.9,17039,18656,7.2,7,7,7,220,22.0,2,1,1,0,0,185,18.5,0,0,2,2,6.6,16560,14007,1400.7,-2096,-3032,1
4214,3252,3377,1759.6,17596,19377,7.2,11,11,11,203,20.3,1,1,0,1,0,171,17.1,0,2,4,4,6.8,16000,14344,1434.4,-3377,-3252,1
4215,1270,-1625,1688.7,16887,17187,7.0,7,7,8,215,21.5,0,0,0,1,1,212,21.2,1,4,4,4,7.0,18812,15617,1561.7,1625,-1270,0
4216,-549,-805,1515.7,15157,17482,6.8,4,4,3,241,24.1,0,0,0,1,1,223,22.3,2,3,6,6,7.0,18287,15706,1570.6,805,549,1
4217,6210,3599,2025.9,20259,19498,7.0,11,11,10,238,23.8,2,1,1,0,0,180,18.0,0,4,3,3,6.6,15899,14049,1404.9,-3599,-6210,1
4218,-1436,-1406,1638.8,16388,17753,6.8,6,6,5,213,21.3,1,1,1,0,0,220,22.0,0,8,9,9,7.2,19159,17824,1782.4,1406,1436,0
4219,8,84,1726.9,17269,18087,7.0,9,9,6,209,20.9,0,0,1,0,1,216,21.6,2,8,8,8,7.0,18003,17261,1726.1,-84,-8,1
4220,836,883,1738.9,17389,18252,6.8,8,8,9,198,19.8,1,1,1,0,0,237,23.7,0,10,5,5,6.6,17369,16553,1655.3,-883,-836,1
4221,2077,986,1762.2,17622,18672,7.2,7,7,7,247,24.7,0,0,1,0,1,226,22.6,1,5,5,5,6.8,17686,15545,1554.5,-986,-2077,0
4222,-259,555,1573.6,15736,18798,6.8,3,3,3,232,23.2,0,0,0,1,1,220,22.0,2,5,6,6,6.8,18243,15995,1599.5,-555,259,1
4223,-195,646,1796.5,17965,19735,7.2,10,10,11,219,21.9,1,0,1,0,1,244,24.4,1,3,8,8,7.0,19089,18160,1816.0,-646,195,1
4224,-3456,-1621,1506.7,15067,17556,6.6,4,4,2,223,22.3,0,0,0,1,1,235,23.5,1,7,9,9,7.2,19177,18523,1852.3,1621,3456,0
4225,-5043,-4627,1385.5,13855,15500,6.4,2,2,3,215,21.5,0,0,0,1,1,244,24.4,1,9,10,10,7.2,20127,18898,1889.8,4627,5043,0
4226,2134,1500,1756.1,17561,19152,7.0,9,9,11,207,20.7,0,0,1,0,1,204,20.4,1,2,6,6,7.0,17652,15427,1542.7,-1500,-2134,1
4227,-3235,-2207,1628.4,16284,16793,6.6,6,6,9,208,20.8,0,0,0,1,1,215,21.5,2,11,14,14,6.8,19000,19519,1951.9,2207,3235,1
4228,1453,-254,1704.8,17048,16378,6.6,7,7,9,227,22.7,0,0,1,0,0,188,18.8,0,4,6,6,6.6,16632,15595,1559.5,254,-1453,0
4229,613,323,1629.4,16294,18718,7.2,5,5,8,218,21.8,1,1,0,1,0,232,23.2,0,3,3,3,7.2,18395,15681,1568.1,-323,-613,0
4230,-772,-545,1687.7,16877,19179,7.4,6,6,7,225,22.5,1,1,0,1,0,226,22.6,0,11,8,8,7.4,19724,17649,1764.9,545,772,0
4231,-1262,-1379,1522.2,15222,15621,6.2,6,6,6,178,17.8,0,0,0,1,0,178,17.8,0,7,8,8,6.6,17000,16484,1648.4,1379,1262,0
4232,-862,1054,1724.5,17245,18890,7.2,6,6,6,236,23.6,1,0,0,1,1,219,21.9,1,13,9,9,6.8,17836,18107,1810.7,-1054,862,0
4233,-1675,-1382,1718.7,17187,17605,7.0,9,9,12,197,19.7,1,1,1,0,0,206,20.6,1,11,9,9,7.2,18987,18862,1886.2,1382,1675,0
4234,-2997,-3052,1515.6,15156,16017,6.4,5,5,8,156,15.6,2,1,1,0,0,222,22.2,0,5,10,10,7.0,19069,18153,1815.3,3052,2997,0
4235,-4097,-1658,1397.7,13977,17736,6.6,1,1,0,208,20.8,0,0,0,1,0,226,22.6,0,7,6,6,7.2,19394,18074,1807.4,1658,4097,0
4236,1678,1155,1638.3,16383,18625,7.0,6,6,4,258,25.8,0,0,1,0,1,216,21.6,1,1,2,2,7.0,17470,14705,1470.5,-1155,-1678,0
4237,-1445,-694,1539.2,15392,17234,6.8,3,3,4,240,24.0,0,0,1,0,0,225,22.5,0,9,7,7,6.8,17928,16837,1683.7,694,1445,0
4238,1516,709,1539.7,15397,18585,6.8,5,5,3,204,20.4,1,1,1,0,0,196,19.6,0,1,2,2,7.0,17876,13881,1388.1,-709,-1516,1
4239,-1769,-1209,1614.2,16142,18299,7.0,6,6,4,191,19.1,0,0,0,1,1,264,26.4,1,6,8,8,7.4,19508,17911,1791.1,1209,1769,0
4240,2063,2131,1785.5,17855,19265,7.2,9,9,13,200,20.0,0,0,1,0,1,182,18.2,1,10,6,6,7.0,17134,15792,1579.2,-2131,-2063,1
4241,-3535,-1720,1395.6,13956,16492,6.6,2,2,2,210,21.0,0,0,0,1,1,203,20.3,1,12,8,8,7.0,18212,17491,1749.1,1720,3535,0
4242,-1964,-1415,1575.3,15753,16744,6.8,6,6,7,203,20.3,1,1,0,1,0,238,23.8,1,7,8,8,7.0,18159,17717,1771.7,1415,1964,0
4243,-1117,-1207,1627.2,16272,16687,6.6,8,8,7,179,17.9,0,0,0,1,1,223,22.3,1,7,9,9,6.8,17894,17389,1738.9,1207,1117,0
4244,713,-58,1686.9,16869,18297,7.2,7,7,9,230,23.0,0,0,0,1,1,213,21.3,1,9,6,6,6.8,18355,16156,1615.6,58,-713,1
4245,-1534,-1073,1699.0,16990,17317,6.8,9,9,12,198,19.8,0,0,1,0,0,218,21.8,0,11,10,10,6.8,18390,18524,1852.4,1073,1534,0
4246,1350,2355,1799.1,17991,20130,7.4,9,9,8,219,21.9,0,0,0,1,1,208,20.8,2,6,4,4,6.8,17775,16641,1664.1,-2355,-1350,0
4247,129,200,1514.3,15143,18397,7.0,2,2,2,239,23.9,0,0,0,1,1,224,22.4,1,4,3,3,7.0,18197,15014,1501.4,-200,-129,0
4248,926,967,1673.5,16735,17862,6.8,8,8,7,215,21.5,1,1,1,0,0,188,18.8,0,7,5,5,6.6,16895,15809,1580.9,-967,-926,1
4249,603,-932,1597.1,15971,17247,6.8,4,4,4,241,24.1,1,0,0,1,0,215,21.5,0,5,4,4,6.8,18179,15368,1536.8,932,-603,1
4250,1512,447,1775.2,17752,18405,7.0,9,9,12,212,21.2,0,0,0,1,1,219,21.9,1,6,6,6,7.0,17958,16240,1624.0,-447,-1512,1
4251,-2942,-2574,1502.3,15023,17982,7.0,3,3,1,222,22.2,0,0,1,0,1,228,22.8,1,8,7,7,7.6,20556,17965,1796.5,2574,2942,0
4252,701,-628,1600.7,16007,17370,6.8,5,5,6,202,20.2,2,1,1,0,0,236,23.6,0,2,3,3,7.0,17998,15306,1530.6,628,-701,1
4253,-1648,-1354,1545.4,15454,17256,6.8,4,4,5,199,19.9,0,0,1,0,1,217,21.7,2,3,6,6,7.0,18610,17102,1710.2,1354,1648,1
4254,2559,806,1705.8,17058,16737,6.8,8,8,4,207,20.7,0,0,1,0,0,196,19.6,0,4,3,3,6.4,15931,14499,1449.9,-806,-2559,1
4255,1142,969,1837.4,18374,18219,7.2,8,8,9,218,21.8,1,0,1,0,0,188,18.8,0,14,10,10,6.8,17250,17232,1723.2,-969,-1142,0
4256,-1501,-2063,1625.9,16259,16804,6.4,5,5,3,224,22.4,0,0,1,0,1,240,24.0,1,7,9,9,7.2,18867,17760,1776.0,2063,1501,0
4257,409,1405,1589.4,15894,18026,6.8,5,5,6,222,22.2,1,0,0,1,1,241,24.1,1,3,2,2,6.8,16621,15485,1548.5,-1405,-409,0
4258,-2752,-2170,1552.4,15524,17508,6.6,4,4,5,214,21.4,1,1,1,0,0,252,25.2,0,9,8,8,7.4,19678,18276,1827.6,2170,2752,0
4259,3415,1887,1895.6,18956,19208,7.2,11,11,8,243,24.3,0,0,1,0,1,192,19.2,1,6,5,5,6.8,17321,15541,1554.1,-1887,-3415,0
4260,1867,1838,1788.1,17881,19236,7.2,9,9,12,238,23.8,1,1,0,1,0,205,20.5,0,4,5,5,6.6,17398,16014,1601.4,-1838,-1867,1
4261,1692,205,1713.1,17131,19074,7.2,7,7,5,229,22.9,0,0,1,0,1,186,18.6,1,4,6,6,7.0,18869,15439,1543.9,-205,-1692,1
4262,3198,1428,1766.6,17666,18167,7.0,7,7,4,240,24.0,1,0,1,0,1,201,20.1,1,7,3,3,6.6,16739,14468,1446.8,-1428,-3198,1
4263,1652,1714,1753.8,17538,19556,7.4,7,7,5,229,22.9,2,1,1,0,0,209,20.9,0,4,5,5,6.8,17842,15886,1588.6,-1714,-1652,1
4264,2875,3035,1694.2,16942,20255,7.6,4,4,5,261,26.1,1,1,1,0,0,222,22.2,0,1,1,1,6.8,17220,14067,1406.7,-3035,-2875,1
4265,2978,3229,1822.4,18224,19875,7.4,10,10,10,225,22.5,0,0,1,0,0,224,22.4,0,5,4,4,6.8,16646,15246,1524.6,-3229,-2978,0
4266,134,-1022,1634.5,16345,17499,6.8,5,5,6,246,24.6,1,1,1,0,0,239,23.9,0,5,5,5,7.2,18521,16211,1621.1,1022,-134,1
4267,-418,34,1586.5,15865,18437,7.0,4,4,4,238,23.8,0,0,1,0,1,231,23.1,1,8,6,6,7.0,18403,16283,1628.3,-34,418,0
4268,-3446,-1168,1526.6,15266,17065,6.6,5,5,3,209,20.9,0,0,1,0,1,222,22.2,1,13,10,10,7.0,18233,18712,1871.2,1168,3446,0
4269,957,406,1545.4,15454,17213,6.6,4,4,1,226,22.6,1,0,1,0,0,215,21.5,0,3,3,3,6.8,16807,14497,1449.7,-406,-957,0
4270,2358,2590,1705.1,17051,20109,7.6,5,5,2,259,25.9,1,1,0,1,0,248,24.8,0,0,1,1,6.8,17519,14693,1469.3,-2590,-2358,1
4271,-1291,-1067,1770.5,17705,17690,6.8,8,8,6,201,20.1,0,0,1,0,0,213,21.3,0,16,13,13,7.2,18757,18996,1899.6,1067,1291,0
4272,3371,1173,1676.3,16763,17181,6.6,8,8,9,209,20.9,0,0,1,0,0,195,19.5,0,2,1,1,6.4,16008,13392,1339.2,-1173,-3371,0
4273,-400,-539,1680.8,16808,17371,6.8,7,7,10,189,18.9,0,0,0,1,1,194,19.4,1,5,8,8,7.2,17910,17208,1720.8,539,400,0
4274,-4189,-3388,1511.1,15111,16978,6.6,4,4,3,218,21.8,0,0,0,1,1,249,24.9,2,10,12,12,7.4,20366,19300,1930.0,3388,4189,0
4275,-4011,-3207,1499.8,14998,15823,6.4,5,5,6,199,19.9,1,1,1,0,0,233,23.3,0,19,11,11,7.2,19030,19009,1900.9,3207,4011,0
4276,9,-1196,1694.2,16942,17624,7.0,5,5,7,227,22.7,0,0,1,0,1,215,21.5,1,9,9,9,6.8,18820,16933,1693.3,1196,-9,0
4277,-2630,-2204,1527.0,15270,17079,6.4,6,6,7,181,18.1,0,0,0,1,1,238,23.8,1,6,8,8,7.2,19283,17900,1790.0,2204,2630,0
4278,-1494,-700,1458.6,14586,16499,6.6,3,3,4,194,19.4,0,0,0,1,0,231,23.1,0,5,5,5,6.6,17199,16080,1608.0,700,1494,0
4279,2655,2106,1823.2,18232,18215,7.2,8,8,12,228,22.8,1,1,0,1,0,226,22.6,0,3,4,4,6.4,16109,15577,1557.7,-2106,-2655,1
4280,329,-298,1719.0,17190,16876,6.8,9,9,13,204,20.4,0,0,0,1,1,206,20.6,1,10,8,8,7.0,17174,16861,1686.1,298,-329,1
4281,1219,1558,1500.8,15008,17416,6.8,4,4,3,225,22.5,0,0,0,1,1,193,19.3,1,1,2,2,6.6,15858,13789,1378.9,-1558,-1219,0
4282,5494,1987,2175.5,21755,18071,7.2,15,15,15,191,19.1,1,1,1,0,0,168,16.8,0,7,7,7,6.4,16084,16261,1626.1,-1987,-5494,1
4283,1259,2317,1578.7,15787,19141,7.2,4,4,8,223,22.3,1,1,1,0,0,236,23.6,0,0,1,1,6.4,16824,14528,1452.8,-2317,-1259,1
4284,-919,47,1640.4,16404,18840,6.8,6,6,6,245,24.5,0,0,0,1,0,219,21.9,0,10,7,7,7.2,18793,17323,1732.3,-47,919,0
4285,2566,3097,1787.8,17878,20464,7.6,7,7,13,232,23.2,1,1,0,1,0,235,23.5,0,4,4,4,7.0,17367,15312,1531.2,-3097,-2566,1
4286,1428,295,1853.2,18532,18460,7.2,8,8,14,240,24.0,2,1,1,0,0,201,20.1,0,9,9,9,7.0,18165,17104,1710.4,-295,-1428,1
4287,-763,-450,1690.1,16901,16288,6.4,8,8,7,176,17.6,1,0,1,0,0,204,20.4,0,14,10,10,6.6,16738,17664,1766.4,450,763,0
4288,-1360,-1561,1756.3,17563,17585,7.0,7,7,7,199,19.9,0,0,0,1,1,244,24.4,1,11,10,10,7.2,19146,18923,1892.3,1561,1360,0
4289,-553,284,1596.7,15967,17892,7.0,4,4,4,225,22.5,0,0,1,0,1,217,21.7,2,4,4,4,6.8,17608,16520,1652.0,-284,553,1
4290,-3279,-1466,1628.0,16280,17372,6.8,4,4,4,223,22.3,0,0,0,1,1,252,25.2,1,15,12,12,7.2,18838,19559,1955.9,1466,3279,0
4291,2301,2562,1714.2,17142,18245,7.0,8,8,6,221,22.1,1,0,1,0,1,177,17.7,1,8,5,5,6.4,15683,14841,1484.1,-2562,-2301,1
4292,-2462,-1894,1480.7,14807,17294,6.8,4,4,1,201,20.1,0,0,1,0,0,229,22.9,0,6,8,8,7.4,19188,17269,1726.9,1894,2462,0
4293,-198,-1159,1869.7,18697,17238,6.8,10,10,14,213,21.3,0,0,1,0,0,188,18.8,1,9,13,13,6.8,18397,18895,1889.5,1159,198,1
4294,240,-903,1705.7,17057,17009,6.6,8,8,9,190,19.0,0,0,1,0,0,197,19.7,0,9,8,8,7.0,17912,16817,1681.7,903,-240,0
4295,1780,1010,1648.7,16487,18581,6.8,5,5,3,235,23.5,1,1,0,1,0,218,21.8,0,1,3,3,6.8,17571,14707,1470.7,-1010,-1780,1
4296,435,-1039,1572.1,15721,17087,6.6,5,5,6,210,21.0,0,0,1,0,0,229,22.9,0,3,3,3,6.8,18126,15286,1528.6,1039,-435,1
4297,1591,1778,1718.2,17182,19944,7.4,5,5,7,246,24.6,1,1,0,1,0,257,25.7,0,4,3,3,6.8,18166,15591,1559.1,-1778,-1591,1
4298,937,530,1699.3,16993,18608,7.2,8,8,10,212,21.2,2,1,0,1,0,205,20.5,0,3,4,4,7.0,18078,16056,1605.6,-530,-937,1
4299,-2320,-2276,1571.0,15710,17847,7.0,5,5,4,223,22.3,0,0,0,1,1,237,23.7,1,7,8,8,7.6,20123,18030,1803.0,2276,2320,1
4300,496,187,1779.3,17793,18327,7.0,10,10,10,193,19.3,1,0,0,1,1,220,22.0,1,7,8,8,6.8,18140,17297,1729.7,-187,-496,1
4301,6977,5303,1986.7,19867,19401,7.0,13,13,11,236,23.6,1,1,1,0,0,168,16.8,0,4,2,2,5.8,14098,12890,1289.0,-5303,-6977,1
4302,2832,2861,1853.8,18538,19307,7.4,10,10,10,225,22.5,0,0,1,0,0,214,21.4,0,7,5,5,6.6,16446,15706,1570.6,-2861,-2832,1
4303,-4073,-2595,1462.4,14624,16231,6.6,3,3,2,211,21.1,0,0,1,0,0,226,22.6,1,7,9,9,7.2,18826,18697,1869.7,2595,4073,0
4304,1561,621,1600.5,16005,17430,7.0,5,5,4,228,22.8,0,0,1,0,1,187,18.7,1,6,4,4,6.6,16809,14444,1444.4,-621,-1561,1
4305,-2143,-1251,1519.4,15194,17750,6.8,4,4,4,220,22.0,0,0,0,1,0,205,20.5,1,6,8,8,7.2,19001,17337,1733.7,1251,2143,0
4306,6081,4748,2094.3,20943,21575,7.6,13,13,13,235,23.5,1,0,0,1,1,197,19.7,1,5,3,3,6.6,16827,14862,1486.2,-4748,-6081,1
4307,515,1403,1598.3,15983,19092,7.2,6,6,5,218,21.8,0,0,1,0,1,194,19.4,1,5,4,4,6.8,17689,15468,1546.8,-1403,-515,1
4308,-2382,-2219,1451.3,14513,17238,6.6,1,1,1,218,21.8,0,0,0,1,1,248,24.8,1,5,7,7,7.2,19457,16895,1689.5,2219,2382,0
4309,2880,2785,1753.6,17536,19253,7.0,6,6,6,266,26.6,1,1,1,0,0,197,19.7,0,5,3,3,6.6,16468,14656,1465.6,-2785,-2880,1
4310,724,-1747,1579.6,15796,16848,6.8,4,4,7,221,22.1,1,1,1,0,0,209,20.9,0,3,3,3,7.2,18595,15072,1507.2,1747,-724,0
4311,4882,2906,2083.3,20833,20278,7.6,15,15,19,231,23.1,1,1,1,0,0,202,20.2,0,5,7,7,6.8,17372,15951,1595.1,-2906,-4882,1
4312,3877,1762,1865.0,18650,20329,7.4,7,7,8,248,24.8,1,1,1,0,0,220,22.0,0,3,2,2,7.2,18567,14773,1477.3,-1762,-3877,1
4313,-2127,-997,1504.4,15044,17888,7.0,4,4,2,214,21.4,1,1,0,1,0,228,22.8,0,8,6,6,7.2,18885,17171,1717.1,997,2127,0
4314,161,-97,1581.1,15811,17771,7.0,4,4,6,212,21.2,1,1,1,0,0,222,22.2,0,6,4,4,6.6,17868,15650,1565.0,97,-161,0
4315,608,362,1561.2,15612,17757,6.8,4,4,2,228,22.8,0,0,1,0,1,208,20.8,1,2,4,4,7.0,17395,15004,1500.4,-362,-608,0
4316,-4570,-3352,1515.1,15151,16565,6.6,5,5,3,204,20.4,1,1,0,1,0,207,20.7,1,18,13,13,7.4,19917,19721,1972.1,3352,4570,0
4317,120,1543,1649.6,16496,18365,7.0,6,6,6,244,24.4,0,0,0,1,1,206,20.6,1,14,5,5,6.6,16822,16376,1637.6,-1543,-120,0
4318,-1073,-657,1605.9,16059,17499,7.0,8,8,9,190,19.0,0,0,1,0,0,232,23.2,1,7,7,7,6.8,18156,17132,1713.2,657,1073,0
4319,-3181,-2898,1512.0,15120,16083,6.4,4,4,4,189,18.9,0,0,0,1,0,214,21.4,0,14,11,11,7.4,18981,18301,1830.1,2898,3181,1
4320,-226,-262,1618.5,16185,17330,6.8,5,5,4,212,21.2,1,0,1,0,1,228,22.8,1,10,5,5,6.8,17592,16411,1641.1,262,226,1
4321,-3096,-3752,1540.4,15404,17439,6.8,3,3,2,240,24.0,0,0,1,0,1,256,25.6,1,11,8,8,7.6,21191,18500,1850.0,3752,3096,0
4322,2123,2563,1795.2,17952,18161,7.0,8,8,5,210,21.0,0,0,1,0,1,192,19.2,1,8,6,6,6.2,15598,15829,1582.9,-2563,-2123,1
4323,-5760,-4168,1477.6,14776,15469,6.2,5,5,7,161,16.1,0,0,1,0,0,235,23.5,1,12,13,13,7.4,19637,20536,2053.6,4168,5760,0
4324,-2155,-2249,1618.3,16183,17767,7.0,4,4,2,251,25.1,0,0,0,1,1,219,21.9,1,10,10,10,7.2,20016,18338,1833.8,2249,2155,0
4325,-519,1292,1603.7,16037,18122,7.0,4,4,6,231,23.1,0,0,0,1,0,213,21.3,0,10,7,7,6.6,16830,16556,1655.6,-1292,519,1
4326,786,1049,1804.1,18041,18637,7.0,5,5,5,221,22.1,2,1,0,1,0,213,21.3,0,14,9,9,6.8,17588,17255,1725.5,-1049,-786,1
4327,-1671,-1100,1482.0,14820,16224,6.4,5,5,3,167,16.7,1,1,0,1,0,223,22.3,0,10,6,6,6.8,17324,16491,1649.1,1100,1671,1
4328,-4036,-1844,1394.3,13943,17294,6.8,1,1,0,230,23.0,0,0,0,1,1,231,23.1,1,5,5,5,7.2,19138,17979,1797.9,1844,4036,0
4329,-1148,-2197,1702.3,17023,16951,6.4,7,7,4,201,20.1,2,1,0,1,0,226,22.6,0,8,10,10,7.2,19148,18171,1817.1,2197,1148,0
4330,-1399,-763,1501.1,15011,17250,7.0,2,2,2,223,22.3,0,0,1,0,1,208,20.8,1,7,5,5,7.0,18013,16410,1641.0,763,1399,1
4331,4409,4503,2006.7,20067,20095,7.4,13,13,13,229,22.9,0,0,0,1,1,182,18.2,1,5,5,5,6.2,15592,15658,1565.8,-4503,-4409,1
4332,770,-46,1714.9,17149,17815,6.8,6,6,4,196,19.6,1,1,1,0,0,202,20.2,0,7,7,7,7.0,17861,16379,1637.9,46,-770,1
4333,-2193,-1574,1468.8,14688,16866,6.8,3,3,4,199,19.9,1,1,1,0,0,217,21.7,0,10,7,7,7.0,18440,16881,1688.1,1574,2193,0
4334,1236,144,1612.5,16125,19055,7.2,4,4,3,235,23.5,2,1,1,0,0,249,24.9,0,2,2,2,7.4,18911,14889,1488.9,-144,-1236,0
4335,-2144,-2451,1419.7,14197,17212,6.8,1,1,2,225,22.5,1,0,1,0,1,246,24.6,1,3,5,5,7.2,19663,16341,1634.1,2451,2144,0
4336,4785,4475,1886.3,18863,20134,7.6,12,12,8,238,23.8,1,0,1,0,0,206,20.6,0,2,2,2,6.4,15659,14078,1407.8,-4475,-4785,1
4337,-344,1361,1548.8,15488,18538,7.2,4,4,2,240,24.0,1,1,0,1,0,241,24.1,0,4,4,4,6.6,17177,15832,1583.2,-1361,344,1
4338,905,312,1828.3,18283,18662,7.0,7,7,8,209,20.9,0,0,0,1,1,206,20.6,1,6,8,8,7.0,18350,17378,1737.8,-312,-905,1
4339,1806,632,1853.8,18538,19030,7.2,10,10,14,247,24.7,0,0,1,0,1,216,21.6,1,5,5,5,7.0,18398,16732,1673.2,-632,-1806,1
4340,2095,1664,1787.5,17875,20182,7.2,8,8,5,206,20.6,1,0,0,1,1,215,21.5,1,3,5,5,7.0,18518,15780,1578.0,-1664,-2095,1
4341,2589,2509,1695.4,16954,17771,6.8,9,9,11,221,22.1,0,0,0,1,1,187,18.7,1,4,3,3,6.4,15262,14365,1436.5,-2509,-2589,1
4342,-745,-1826,1507.3,15073,16649,6.8,3,3,2,234,23.4,2,1,0,1,0,200,20.0,0,3,5,5,7.0,18475,15818,1581.8,1826,745,0
4343,329,1704,1603.8,16038,18686,7.0,5,5,3,219,21.9,0,0,1,0,1,208,20.8,1,3,6,6,6.8,16982,15709,1570.9,-1704,-329,1
4344,-478,-389,1603.2,16032,18159,7.0,5,5,3,229,22.9,0,0,0,1,1,221,22.1,1,6,6,6,7.0,18548,16510,1651.0,389,478,0
4345,273,-1110,1566.9,15669,17654,7.0,4,4,7,223,22.3,1,1,1,0,0,237,23.7,0,3,3,3,7.2,18764,15396,1539.6,1110,-273,0
4346,2713,464,1819.8,18198,18250,7.0,8,8,8,246,24.6,1,1,1,0,0,187,18.7,1,3,6,6,6.8,17786,15485,1548.5,-464,-2713,1
4347,1852,219,1952.8,19528,18855,7.2,13,13,19,211,21.1,1,1,1,0,0,217,21.7,0,5,9,9,7.2,18636,17676,1767.6,-219,-1852,0
4348,767,796,1731.6,17316,18199,7.0,8,8,6,206,20.6,2,1,0,1,0,216,21.6,0,8,6,6,6.8,17403,16549,1654.9,-796,-767,1
4349,373,-1568,1650.9,16509,18241,7.0,7,7,10,202,20.2,0,0,0,1,1,224,22.4,1,2,5,5,7.2,19809,16136,1613.6,1568,-373,0
4350,2405,1439,1774.1,17741,18253,6.8,10,10,11,230,23.0,0,0,1,0,1,199,19.9,1,6,5,5,6.8,16814,15336,1533.6,-1439,-2405,1
4351,2186,1319,1612.4,16124,18986,7.4,4,4,2,244,24.4,2,1,1,0,0,241,24.1,0,0,0,0,6.8,17667,13938,1393.8,-1319,-2186,0
4352,1315,-99,1639.5,16395,17740,7.0,5,5,8,214,21.4,1,1,1,0,0,209,20.9,0,3,3,3,7.0,17839,15080,1508.0,99,-1315,1
4353,2533,1172,1802.0,18020,18981,7.2,8,8,7,253,25.3,1,1,1,0,0,212,21.2,0,4,5,5,6.8,17809,15487,1548.7,-1172,-2533,1
4354,-1394,-589,1475.9,14759,17310,6.8,3,3,8,194,19.4,0,0,0,1,1,246,24.6,1,7,5,5,6.8,17899,16153,1615.3,589,1394,0
4355,-4413,-5071,1452.1,14521,16346,6.6,4,4,3,186,18.6,0,0,1,0,1,234,23.4,1,12,8,8,7.8,21417,18934,1893.4,5071,4413,0
4356,3347,2958,1834.1,18341,19885,7.2,6,6,6,229,22.9,1,0,1,0,1,206,20.6,1,8,4,4,6.6,16927,14994,1499.4,-2958,-3347,1
4357,4085,2139,1959.9,19599,19082,7.4,14,14,19,211,21.1,0,0,1,0,1,188,18.8,1,6,6,6,6.8,16943,15514,1551.4,-2139,-4085,0
4358,4581,2792,1801.9,18019,17440,6.8,10,10,14,210,21.0,0,0,1,0,0,153,15.3,0,3,4,4,6.0,14648,13438,1343.8,-2792,-4581,0
4359,453,-1745,1649.1,16491,16774,6.6,7,7,7,190,19.0,1,1,1,0,0,238,23.8,0,0,7,7,7.0,18519,16038,1603.8,1745,-453,0
4360,5773,3643,2169.9,21699,20734,7.6,14,14,15,242,24.2,0,0,1,0,1,208,20.8,1,6,7,7,6.8,17091,15926,1592.6,-3643,-5773,1
4361,251,1074,1624.9,16249,18403,7.0,5,5,6,217,21.7,1,0,0,1,1,229,22.9,1,7,5,5,7.0,17329,15998,1599.8,-1074,-251,0
4362,335,731,1647.6,16476,17474,6.6,7,7,6,210,21.0,1,1,0,1,0,206,20.6,0,4,7,7,6.6,16743,16141,1614.1,-731,-335,0
4363,3826,3122,1824.6,18246,17783,6.8,7,7,6,228,22.8,2,1,1,0,0,156,15.6,0,8,5,5,6.2,14661,14420,1442.0,-3122,-3826,1
4364,919,94,1664.6,16646,18549,7.2,6,6,5,242,24.2,2,1,1,0,0,258,25.8,0,6,3,3,7.2,18455,15727,1572.7,-94,-919,1
4365,2150,475,1656.8,16568,18389,7.0,5,5,3,222,22.2,0,0,1,0,1,228,22.8,1,4,2,2,7.0,17914,14418,1441.8,-475,-2150,1
4366,1840,144,1851.9,18519,18555,7.2,8,8,10,223,22.3,1,1,1,0,0,214,21.4,1,6,6,6,7.2,18411,16679,1667.9,-144,-1840,1
4367,-1953,-1854,1549.8,15498,17805,6.8,4,4,2,228,22.8,0,0,0,1,1,259,25.9,2,5,6,6,7.4,19659,17451,1745.1,1854,1953,0
4368,-2435,-850,1492.7,14927,17831,6.8,4,4,4,205,20.5,0,0,0,1,1,227,22.7,1,12,7,7,7.2,18681,17362,1736.2,850,2435,0
4369,-1338,-779,1512.0,15120,17606,6.8,3,3,4,230,23.0,0,0,0,1,1,234,23.4,1,8,4,4,7.0,18385,16458,1645.8,779,1338,0
4370,2072,2367,1714.6,17146,19310,7.2,7,7,10,227,22.7,1,1,0,1,0,241,24.1,0,5,3,3,6.8,16943,15074,1507.4,-2367,-2072,1
4371,-1634,-2844,1614.1,16141,17238,7.0,5,5,3,229,22.9,1,0,1,0,0,240,24.0,0,10,10,10,7.6,20082,17775,1777.5,2844,1634,0
4372,3120,2464,1779.8,17798,18795,7.2,8,8,8,220,22.0,1,1,1,0,0,192,19.2,0,5,4,4,6.6,16331,14678,1467.8,-2464,-3120,1
4373,-781,289,1594.5,15945,17648,6.8,4,4,5,248,24.8,0,0,0,1,1,195,19.5,1,10,9,9,6.8,17359,16726,1672.6,-289,781,1
4374,-620,-1984,1616.9,16169,17326,6.6,6,6,5,214,21.4,0,0,0,1,1,237,23.7,2,4,7,7,7.0,19310,16789,1678.9,1984,620,0
4375,-1716,-2811,1517.7,15177,17645,6.8,3,3,1,220,22.0,0,0,1,0,0,241,24.1,0,4,6,6,7.4,20456,16893,1689.3,2811,1716,0
4376,5027,3394,1830.7,18307,19628,7.4,6,6,9,235,23.5,0,0,1,0,0,211,21.1,0,0,0,0,6.4,16234,13280,1328.0,-3394,-5027,1
4377,-932,150,1647.3,16473,18395,7.0,7,7,7,201,20.1,2,1,0,1,0,246,24.6,0,11,8,8,7.0,18245,17405,1740.5,-150,932,0
4378,5415,2991,1948.3,19483,18561,7.0,10,10,17,211,21.1,1,1,1,0,0,203,20.3,0,4,2,2,6.4,15570,14068,1406.8,-2991,-5415,1
4379,-3832,-3915,1523.0,15230,15161,6.4,5,5,5,185,18.5,0,0,1,0,1,219,21.9,1,11,12,12,7.4,19076,19062,1906.2,3915,3832,0
4380,840,385,1658.3,16583,17389,7.2,7,7,10,222,22.2,1,1,0,1,0,213,21.3,0,4,5,5,6.8,17004,15743,1574.3,-385,-840,1
4381,-990,-2014,1684.0,16840,18376,7.2,6,6,3,221,22.1,1,0,0,1,1,247,24.7,1,7,9,9,7.4,20390,17830,1783.0,2014,990,0
4382,969,1554,1783.6,17836,19027,7.2,9,9,12,214,21.4,1,0,1,0,1,216,21.6,1,7,7,7,6.8,17473,16867,1686.7,-1554,-969,1
4383,6413,3952,2165.8,21658,20318,7.6,16,16,14,211,21.1,0,0,1,0,1,203,20.3,2,1,2,2,6.4,16366,15245,1524.5,-3952,-6413,1
4384,3062,2772,1917.0,19170,18219,7.0,14,14,14,193,19.3,0,0,0,1,0,142,14.2,0,13,9,9,6.2,15447,16108,1610.8,-2772,-3062,1
4385,2765,1407,1822.9,18229,18093,6.8,9,9,7,230,23.0,0,0,1,0,1,195,19.5,2,5,6,6,6.6,16686,15464,1546.4,-1407,-2765,1
4386,3208,3285,1759.1,17591,18925,7.2,6,6,6,235,23.5,0,0,0,1,0,186,18.6,0,2,4,4,6.2,15640,14383,1438.3,-3285,-3208,1
4387,-1641,-1610,1506.7,15067,17232,6.8,4,4,7,172,17.2,0,0,1,0,0,254,25.4,0,10,5,5,7.4,18842,16708,1670.8,1610,1641,0
4388,-5161,-4099,1384.4,13844,15601,6.6,2,2,2,224,22.4,0,0,0,1,1,200,20.0,1,10,12,12,7.2,19700,19005,1900.5,4099,5161,0
4389,-907,-1650,1569.9,15699,17479,6.8,3,3,3,226,22.6,0,0,1,0,1,244,24.4,1,6,5,5,7.4,19129,16606,1660.6,1650,907,0
4390,-162,177,1707.7,17077,19128,7.0,6,6,6,242,24.2,0,0,0,1,0,245,24.5,0,9,6,6,7.0,18951,17239,1723.9,-177,162,1
4391,-3731,-1458,1571.0,15710,16731,6.6,5,5,8,205,20.5,0,0,0,1,1,230,23.0,1,11,10,10,7.2,18189,19441,1944.1,1458,3731,1
4392,1771,1846,1645.0,16450,18801,7.0,5,5,4,229,22.9,0,0,1,0,1,194,19.4,1,4,4,4,6.6,16955,14679,1467.9,-1846,-1771,1
4393,352,639,1622.8,16228,18476,6.8,3,3,0,234,23.4,0,0,0,1,0,203,20.3,0,6,5,5,7.0,17837,15876,1587.6,-639,-352,0
4394,1189,1151,1680.3,16803,18812,7.0,6,6,2,255,25.5,1,1,1,0,0,206,20.6,0,5,4,4,7.2,17661,15614,1561.4,-1151,-1189,0
4395,-1176,-1499,1546.2,15462,17729,7.0,2,2,3,249,24.9,1,1,1,0,0,248,24.8,0,7,5,5,7.2,19228,16638,1663.8,1499,1176,0
4396,1404,1286,1623.3,16233,17972,6.8,4,4,2,210,21.0,1,0,1,0,0,209,20.9,0,3,3,3,6.8,16686,14829,1482.9,-1286,-1404,1
4397,-4876,-3481,1623.9,16239,16109,6.4,7,7,8,202,20.2,1,0,1,0,1,230,23.0,1,19,17,17,7.2,19590,21115,2111.5,3481,4876,1
4398,249,182,1551.4,15514,16759,6.6,4,4,4,223,22.3,0,0,1,0,1,204,20.4,1,5,4,4,6.6,16577,15265,1526.5,-182,-249,0
4399,2220,2300,1846.6,18466,19801,7.6,9,9,7,218,21.8,0,0,1,0,1,185,18.5,1,7,6,6,7.0,17501,16246,1624.6,-2300,-2220,0
4400,1559,814,1690.7,16907,18996,7.2,4,4,4,259,25.9,1,1,1,0,0,189,18.9,0,7,4,4,6.8,18182,15348,1534.8,-814,-1559,0
4401,1673,536,1766.2,17662,18294,7.2,11,11,11,195,19.5,0,0,1,0,0,173,17.3,1,5,7,7,7.0,17758,15989,1598.9,-536,-1673,1
4402,-4785,-3317,1473.8,14738,16575,6.6,4,4,1,199,19.9,0,0,0,1,1,220,22.0,1,15,12,12,7.2,19892,19523,1952.3,3317,4785,0
4403,-2463,-2163,1622.5,16225,17213,6.6,7,7,13,206,20.6,1,1,0,1,0,224,22.4,0,13,11,11,7.4,19376,18688,1868.8,2163,2463,0
4404,5159,4916,1848.6,18486,20095,7.4,7,7,13,264,26.4,0,0,1,0,1,182,18.2,1,2,1,1,6.4,15179,13327,1332.7,-4916,-5159,1
4405,-3805,-2559,1459.7,14597,17317,6.8,2,2,2,220,22.0,0,0,0,1,0,274,27.4,0,13,9,9,7.4,19876,18402,1840.2,2559,3805,0
4406,2274,2694,1681.8,16818,19595,7.2,6,6,3,250,25.0,0,0,1,0,0,202,20.2,0,2,2,2,6.8,16901,14544,1454.4,-2694,-2274,1
4407,-5129,-3055,1371.4,13714,16890,6.6,2,2,2,201,20.1,0,0,0,1,0,250,25.0,1,12,11,11,7.2,19945,18843,1884.3,3055,5129,0
4408,2398,1573,1794.6,17946,18589,7.2,6,6,5,225,22.5,1,1,0,1,0,230,23.0,1,2,4,4,6.6,17016,15548,1554.8,-1573,-2398,1
4409,488,2349,1614.1,16141,19201,7.4,6,6,3,215,21.5,1,0,0,1,1,183,18.3,1,9,5,5,6.6,16852,15653,1565.3,-2349,-488,0
4410,-2489,-2055,1715.1,17151,17131,6.8,7,7,8,215,21.5,0,0,0,1,1,205,20.5,1,18,11,11,7.2,19186,19640,1964.0,2055,2489,0
4411,270,-688,1848.3,18483,18474,7.0,9,9,15,222,22.2,0,0,1,0,1,207,20.7,1,13,10,10,7.2,19162,18213,1821.3,688,-270,1
4412,1219,232,1553.0,15530,17715,6.8,3,3,2,235,23.5,2,1,1,0,0,238,23.8,0,3,1,1,6.8,17483,14311,1431.1,-232,-1219,1
4413,-435,-960,1590.0,15900,18137,7.0,7,7,6,206,20.6,1,1,0,1,0,218,21.8,0,4,5,5,7.0,19097,16335,1633.5,960,435,0
4414,4228,2880,1752.0,17520,19639,7.2,7,7,5,245,24.5,2,1,1,0,0,194,19.4,0,0,0,0,6.6,16759,13292,1329.2,-2880,-4228,1
4415,465,632,1593.3,15933,18047,7.2,5,5,5,246,24.6,0,0,1,0,1,203,20.3,2,5,4,4,6.8,17415,15468,1546.8,-632,-465,0
4416,-1673,-1221,1636.9,16369,18174,7.0,6,6,7,236,23.6,0,0,1,0,0,239,23.9,0,10,9,9,7.4,19395,18042,1804.2,1221,1673,0
4417,-1723,-545,1442.2,14422,17039,6.6,0,0,0,245,24.5,0,0,0,1,1,229,22.9,1,10,5,5,6.8,17584,16145,1614.5,545,1723,1
4418,-6578,-4807,1357.0,13570,15620,6.2,1,1,2,194,19.4,0,0,0,1,1,267,26.7,2,8,9,9,7.2,20427,20148,2014.8,4807,6578,0
4419,-1992,-1588,1570.6,15706,17720,7.0,4,4,6,244,24.4,0,0,0,1,1,256,25.6,2,11,7,7,7.2,19308,17698,1769.8,1588,1992,0
4420,-113,-116,1789.8,17898,18398,7.0,9,9,9,231,23.1,0,0,0,1,1,218,21.8,1,11,9,9,7.2,18514,18011,1801.1,116,113,1
4421,-3517,-3374,1439.7,14397,16267,6.6,3,3,3,210,21.0,0,0,0,1,1,226,22.6,1,9,8,8,7.2,19641,17914,1791.4,3374,3517,0
4422,2582,2655,1722.7,17227,18492,7.0,5,5,6,245,24.5,1,0,0,1,1,200,20.0,1,5,3,3,6.2,15837,14645,1464.5,-2655,-2582,1
4423,533,1187,1608.0,16080,17928,7.0,6,6,7,218,21.8,1,1,0,1,0,219,21.9,0,6,4,4,6.6,16741,15547,1554.7,-1187,-533,0
4424,-973,-1012,1534.6,15346,16812,6.6,4,4,4,230,23.0,1,1,1,0,0,178,17.8,0,6,7,7,6.8,17824,16319,1631.9,1012,973,0
4425,-3650,-3119,1385.3,13853,14781,6.2,2,2,2,205,20.5,1,0,0,1,0,221,22.1,0,7,8,8,7.2,17900,17503,1750.3,3119,3650,0
4426,-1930,-2043,1441.7,14417,16652,6.6,2,2,1,198,19.8,0,0,1,0,1,223,22.3,1,7,6,6,7.2,18695,16347,1634.7,2043,1930,0
4427,3188,2289,1867.6,18676,18018,7.0,13,13,14,196,19.6,0,0,1,0,0,164,16.4,0,5,6,6,6.4,15729,15488,1548.8,-2289,-3188,1
4428,2674,1630,1885.8,18858,18627,7.0,10,10,13,195,19.5,0,0,1,0,0,240,24.0,0,4,4,4,6.4,16997,16184,1618.4,-1630,-2674,0
4429,3002,2125,1846.3,18463,19599,7.4,10,10,8,248,24.8,1,1,1,0,0,218,21.8,1,3,3,3,6.8,17474,15461,1546.1,-2125,-3002,1
4430,-1936,-646,1528.6,15286,16864,6.6,5,5,3,181,18.1,0,0,1,0,1,230,23.0,1,7,7,7,7.0,17510,17222,1722.2,646,1936,0
4431,-2595,-574,1708.8,17088,18472,6.8,6,6,8,206,20.6,1,1,1,0,0,233,23.3,0,9,10,10,7.4,19046,19683,1968.3,574,2595,0
4432,-5092,-4196,1467.4,14674,15727,6.4,3,3,4,184,18.4,0,0,1,0,0,240,24.0,0,5,10,10,7.4,19923,19766,1976.6,4196,5092,0
4433,-978,-1076,1667.6,16676,18316,7.2,9,9,8,201,20.1,0,0,0,1,0,203,20.3,0,11,8,8,7.4,19392,17654,1765.4,1076,978,1
4434,1597,1617,1684.3,16843,19160,7.2,6,6,5,241,24.1,2,1,1,0,0,231,23.1,0,5,3,3,6.8,17543,15246,1524.6,-1617,-1597,0
4435,4035,3311,1764.0,17640,18174,7.0,8,8,10,207,20.7,1,1,1,0,0,155,15.5,0,9,4,4,6.0,14863,13605,1360.5,-3311,-4035,1
4436,473,446,1651.7,16517,16968,6.6,7,7,9,182,18.2,1,0,1,0,1,183,18.3,1,7,7,7,6.6,16522,16044,1604.4,-446,-473,0
4437,5448,4419,1862.6,18626,19683,7.4,9,9,12,205,20.5,1,0,1,0,1,179,17.9,1,1,1,1,6.4,15264,13178,1317.8,-4419,-5448,1
4438,6476,4261,2099.6,20996,19123,7.2,16,16,25,218,21.8,1,1,1,0,0,147,14.7,0,8,5,5,6.2,14862,14520,1452.0,-4261,-6476,1
4439,1584,2449,1659.5,16595,19727,7.2,5,5,4,220,22.0,0,0,0,1,1,204,20.4,2,4,3,3,6.8,17278,15011,1501.1,-2449,-1584,1
4440,-1637,-886,1656.1,16561,18103,7.0,6,6,4,239,23.9,1,0,0,1,1,240,24.0,1,7,8,8,7.2,18989,18198,1819.8,886,1637,0
4441,-2476,-394,1567.6,15676,19519,7.2,4,4,4,223,22.3,0,0,0,1,1,260,26.0,2,7,8,8,7.4,19913,18152,1815.2,394,2476,0
4442,505,-1017,1684.7,16847,17670,7.0,7,7,9,209,20.9,1,1,0,1,0,212,21.2,0,5,5,5,7.2,18687,16342,1634.2,1017,-505,1
4443,-576,-1318,1483.7,14837,17198,6.8,4,4,1,205,20.5,0,0,0,1,1,172,17.2,1,8,5,5,7.2,18516,15413,1541.3,1318,576,1
4444,-1647,-1866,1562.4,15624,18203,6.8,4,4,4,229,22.9,0,0,0,1,1,243,24.3,1,7,7,7,7.4,20069,17271,1727.1,1866,1647,0
4445,-2395,-2214,1458.7,14587,16414,6.8,3,3,3,222,22.2,1,1,0,1,0,254,25.4,1,6,5,5,7.0,18628,16982,1698.2,2214,2395,0
4446,-1067,-1598,1590.4,15904,16786,6.6,4,4,7,232,23.2,1,0,1,0,1,230,23.0,1,5,7,7,7.0,18384,16971,1697.1,1598,1067,0
4447,-1977,-700,1410.3,14103,17162,6.6,0,0,0,230,23.0,1,0,0,1,0,224,22.4,0,4,5,5,7.0,17862,16080,1608.0,700,1977,0
4448,2306,1659,1668.5,16685,18048,7.0,7,7,11,216,21.6,1,1,1,0,0,208,20.8,0,2,2,2,6.6,16389,14379,1437.9,-1659,-2306,1
4449,366,84,1650.1,16501,18178,6.8,5,5,7,234,23.4,1,1,0,1,0,231,23.1,0,4,5,5,6.8,18094,16135,1613.5,-84,-366,1
4450,567,-1018,1569.4,15694,17103,6.6,4,4,6,248,24.8,1,0,1,0,1,245,24.5,1,3,4,4,7.0,18121,15127,1512.7,1018,-567,0
4451,272,1485,1654.4,16544,18907,7.0,7,7,4,247,24.7,1,1,0,1,0,221,22.1,0,6,6,6,7.0,17422,16272,1627.2,-1485,-272,1
4452,1744,454,1892.3,18923,18843,7.0,11,11,15,225,22.5,0,0,1,0,0,219,21.9,1,7,8,8,7.0,18389,17179,1717.9,-454,-1744,0
4453,-2175,-2386,1475.6,14756,16229,6.6,3,3,2,226,22.6,0,0,1,0,0,233,23.3,0,9,7,7,7.2,18615,16931,1693.1,2386,2175,0
4454,-5976,-4619,1445.0,14450,15560,6.4,4,4,5,186,18.6,1,0,0,1,1,264,26.4,1,14,14,14,7.4,20179,20426,2042.6,4619,5976,1
4455,359,-386,1533.2,15332,17832,7.0,3,3,4,229,22.9,0,0,1,0,1,242,24.2,1,0,3,3,7.0,18218,14973,1497.3,386,-359,1
4456,-2478,-1258,1402.6,14026,17348,6.8,2,2,2,210,21.0,0,0,0,1,0,244,24.4,0,7,4,4,7.2,18606,16504,1650.4,1258,2478,0
4457,700,814,1683.5,16835,18378,7.0,7,7,7,220,22.0,0,0,1,0,0,210,21.0,0,6,6,6,7.0,17564,16135,1613.5,-814,-700,0
4458,1207,2244,1730.1,17301,20766,7.8,7,7,4,241,24.1,0,0,1,0,0,243,24.3,0,4,5,5,7.0,18522,16094,1609.4,-2244,-1207,1
4459,-592,-223,1648.9,16489,17951,7.2,6,6,7,219,21.9,0,0,0,1,1,227,22.7,2,9,7,7,7.0,18174,17081,1708.1,223,592,1
4460,684,167,1721.2,17212,17919,7.0,8,8,13,227,22.7,0,0,1,0,0,199,19.9,0,6,7,7,6.8,17752,16528,1652.8,-167,-684,1
4461,-3684,-3135,1509.0,15090,15998,6.6,5,5,7,176,17.6,2,1,1,0,0,246,24.6,0,11,9,9,7.0,19133,18774,1877.4,3135,3684,0
4462,-1272,-2335,1431.9,14319,16364,6.6,2,2,2,219,21.9,0,0,0,1,0,236,23.6,0,1,4,4,7.2,18699,15591,1559.1,2335,1272,0
4463,1788,2424,1672.1,16721,18046,7.0,5,5,6,237,23.7,0,0,0,1,0,210,21.0,0,6,4,4,6.4,15622,14933,1493.3,-2424,-1788,1
4464,-5292,-4004,1508.9,15089,17098,6.6,4,4,1,235,23.5,0,0,1,0,1,234,23.4,1,14,12,12,7.6,21102,20381,2038.1,4004,5292,0
4465,-130,-624,1566.2,15662,17214,6.8,4,4,7,202,20.2,0,0,1,0,1,200,20.0,1,9,7,7,6.8,17838,15792,1579.2,624,130,1
4466,-2791,-2246,1546.3,15463,16939,6.6,5,5,5,206,20.6,0,0,0,1,1,227,22.7,1,13,9,9,7.4,19185,18254,1825.4,2246,2791,0
4467,-2125,-3115,1688.0,16880,17307,7.0,7,7,12,216,21.6,0,0,1,0,0,221,22.1,1,12,12,12,7.4,20422,19005,1900.5,3115,2125,0
4468,-101,-556,1521.6,15216,18894,7.2,5,5,3,216,21.6,2,1,0,1,0,248,24.8,0,0,2,2,7.2,19450,15317,1531.7,556,101,1
4469,1269,788,1767.4,17674,18595,7.0,10,10,13,209,20.9,0,0,1,0,0,205,20.5,0,6,7,7,7.0,17807,16405,1640.5,-788,-1269,1
4470,251,-340,1653.3,16533,17396,6.6,5,5,5,231,23.1,1,1,1,0,0,217,21.7,0,6,6,6,7.0,17736,16282,1628.2,340,-251,0
4471,-3446,-3817,1571.6,15716,16980,6.8,4,4,3,225,22.5,0,0,0,1,1,239,23.9,2,10,12,12,7.8,20797,19162,1916.2,3817,3446,1
4472,2803,2471,1763.1,17631,18398,7.0,6,6,6,261,26.1,0,0,1,0,0,188,18.8,1,7,4,4,6.6,15927,14828,1482.8,-2471,-2803,1
4473,-1416,63,1514.8,15148,18263,7.0,3,3,2,213,21.3,0,0,0,1,1,230,23.0,1,8,5,5,7.0,18200,16564,1656.4,-63,1416,0
4474,-2588,-884,1464.9,14649,17099,6.8,3,3,3,186,18.6,0,0,0,1,1,246,24.6,1,9,7,7,7.0,17983,17237,1723.7,884,2588,0
4475,-409,-2098,1651.7,16517,16913,6.8,6,6,7,238,23.8,1,1,0,1,0,254,25.4,1,7,7,7,7.0,19011,16926,1692.6,2098,409,0
4476,894,639,1802.6,18026,18214,7.0,9,9,11,211,21.1,0,0,0,1,0,195,19.5,0,8,9,9,6.8,17575,17132,1713.2,-639,-894,1
4477,-1977,-944,1639.9,16399,18258,7.0,7,7,3,214,21.4,0,0,1,0,0,231,23.1,0,9,10,10,7.2,19202,18376,1837.6,944,1977,0
4478,2316,1298,1895.9,18959,18151,6.8,13,13,15,186,18.6,1,0,1,0,1,219,21.9,1,4,5,5,6.6,16853,16643,1664.3,-1298,-2316,1
4479,-3220,-4094,1388.8,13888,15518,6.4,2,2,0,172,17.2,0,0,0,1,0,242,24.2,1,6,6,6,7.4,19612,17108,1710.8,4094,3220,0
4480,52,1036,1518.8,15188,17748,7.0,3,3,2,236,23.6,1,1,0,1,0,214,21.4,0,3,3,3,6.6,16712,15136,1513.6,-1036,-52,1
4481,-1386,-335,1439.5,14395,17060,6.6,2,2,0,210,21.0,0,0,0,1,0,211,21.1,0,6,4,4,6.8,17395,15781,1578.1,335,1386,0
4482,1942,890,1766.3,17663,18440,6.8,8,8,13,202,20.2,0,0,1,0,0,205,20.5,1,3,5,5,6.8,17550,15721,1572.1,-890,-1942,0
4483,3111,2739,1834.8,18348,19545,7.2,9,9,7,216,21.6,1,0,1,0,1,202,20.2,1,4,5,5,6.8,16806,15237,1523.7,-2739,-3111,1
4484,-4427,-3299,1333.7,13337,15472,6.4,2,2,2,197,19.7,0,0,0,1,1,236,23.6,1,5,5,5,7.2,18771,17764,1776.4,3299,4427,1
4485,1183,1036,1706.4,17064,18586,7.0,8,8,11,207,20.7,0,0,1,0,0,217,21.7,1,2,4,4,7.0,17550,15881,1588.1,-1036,-1183,1
4486,5236,5547,1859.5,18595,21025,7.6,13,13,8,237,23.7,2,1,1,0,0,199,19.9,0,1,1,1,6.6,15478,13359,1335.9,-5547,-5236,1
4487,-915,-1035,1509.6,15096,17840,7.0,2,2,2,228,22.8,0,0,0,1,0,239,23.9,0,4,4,4,7.2,18875,16011,1601.1,1035,915,0
4488,2507,3436,1774.3,17743,20843,7.6,8,8,3,247,24.7,0,0,0,1,0,186,18.6,0,5,4,4,6.8,17407,15236,1523.6,-3436,-2507,1
4489,-788,151,1708.8,17088,18459,7.2,7,7,6,219,21.9,0,0,1,0,1,226,22.6,2,5,8,8,7.2,18308,17876,1787.6,-151,788,1
4490,3866,3496,1781.0,17810,19743,7.6,8,8,10,248,24.8,1,1,0,1,0,191,19.1,0,1,3,3,6.4,16247,13944,1394.4,-3496,-3866,1
4491,-936,-624,1395.4,13954,17057,6.8,0,0,0,231,23.1,0,0,0,1,0,199,19.9,0,3,3,3,7.0,17681,14890,1489.0,624,936,1
4492,955,1833,1630.0,16300,19402,7.2,5,5,4,244,24.4,0,0,1,0,1,192,19.2,1,3,5,5,7.0,17569,15345,1534.5,-1833,-955,1
4493,-581,146,1609.6,16096,17359,7.0,5,5,7,224,22.4,1,0,0,1,0,204,20.4,0,8,9,9,6.8,17213,16677,1667.7,-146,581,0
4494,-2814,-2623,1633.1,16331,16667,6.6,5,5,6,220,22.0,1,1,1,0,0,220,22.0,1,10,10,10,7.0,19290,19145,1914.5,2623,2814,0
4495,1967,1068,1651.5,16515,18870,7.2,5,5,4,257,25.7,2,1,1,0,0,233,23.3,0,3,2,2,7.0,17802,14548,1454.8,-1068,-1967,1
4496,1245,686,1686.0,16860,18682,7.0,5,5,7,264,26.4,1,1,0,1,0,248,24.8,0,2,3,3,7.0,17996,15615,1561.5,-686,-1245,1
4497,829,-929,1687.0,16870,16180,6.6,8,8,11,212,21.2,0,0,1,0,1,245,24.5,1,5,6,6,6.6,17109,16041,1604.1,929,-829,1
4498,759,467,1700.1,17001,19717,7.2,4,4,5,242,24.2,0,0,0,1,0,242,24.2,0,4,4,4,7.2,19250,16242,1624.2,-467,-759,1
4499,-174,-35,1411.2,14112,16664,6.6,2,2,3,223,22.3,0,0,1,0,0,226,22.6,0,0,0,0,6.6,16699,14286,1428.6,35,174,0
4500,-978,-849,1530.0,15300,18001,7.0,2,2,2,266,26.6,1,1,0,1,0,228,22.8,0,8,6,6,7.0,18850,16278,1627.8,849,978,0
4501,1801,2218,1927.6,19276,19221,7.2,12,12,14,192,19.2,1,1,1,0,0,217,21.7,0,8,7,7,6.8,17003,17475,1747.5,-2218,-1801,1
4502,-1590,-780,1576.6,15766,16789,6.6,4,4,9,220,22.0,0,0,1,0,1,235,23.5,1,11,7,7,6.8,17569,17356,1735.6,780,1590,0
4503,-1805,-504,1529.2,15292,18345,7.0,5,5,8,187,18.7,0,0,1,0,1,241,24.1,1,10,6,6,7.0,18849,17097,1709.7,504,1805,0
4504,-1296,-382,1432.1,14321,16217,6.4,2,2,1,203,20.3,0,0,1,0,1,226,22.6,1,5,5,5,6.6,16599,15617,1561.7,382,1296,0
4505,-2847,-1355,1649.2,16492,17944,6.8,6,6,12,220,22.0,0,0,1,0,1,237,23.7,2,19,9,9,7.4,19299,19339,1933.9,1355,2847,0
4506,1031,829,1735.7,17357,18244,7.0,8,8,12,222,22.2,1,1,1,0,0,208,20.8,1,10,6,6,6.8,17415,16326,1632.6,-829,-1031,1
4507,1953,135,1751.9,17519,17307,6.8,5,5,6,215,21.5,0,0,1,0,0,215,21.5,0,6,4,4,6.6,17172,15566,1556.6,-135,-1953,1
4508,690,444,1613.9,16139,17770,6.8,4,4,5,245,24.5,0,0,1,0,1,206,20.6,1,7,4,4,6.8,17326,15449,1544.9,-444,-690,1
4509,-793,606,1708.8,17088,18568,7.0,7,7,7,201,20.1,1,1,0,1,0,221,22.1,0,9,10,10,7.0,17962,17881,1788.1,-606,793,0
4510,661,735,1560.9,15609,18083,6.8,6,6,6,180,18.0,1,1,0,1,0,199,19.9,0,2,3,3,6.6,17348,14948,1494.8,-735,-661,1
4511,3240,1787,1891.3,18913,19182,7.4,8,8,10,225,22.5,1,0,1,0,1,237,23.7,1,6,4,4,6.8,17395,15673,1567.3,-1787,-3240,0
4512,1859,1271,1805.4,18054,18465,7.2,9,9,12,241,24.1,1,1,0,1,0,197,19.7,0,11,6,6,6.8,17194,16195,1619.5,-1271,-1859,1
4513,903,1110,1569.0,15690,17299,6.8,6,6,5,214,21.4,1,1,0,1,0,199,19.9,0,3,3,3,6.8,16189,14787,1478.7,-1110,-903,1
4514,353,-160,1600.3,16003,17739,6.8,4,4,2,226,22.6,0,0,1,0,1,209,20.9,1,5,4,4,6.8,17899,15650,1565.0,160,-353,0
4515,1520,1110,1818.1,18181,17078,6.6,9,9,10,202,20.2,0,0,0,1,0,165,16.5,0,14,9,9,6.6,15968,16661,1666.1,-1110,-1520,1
4516,-623,-39,1562.8,15628,17683,7.0,5,5,7,221,22.1,0,0,0,1,1,223,22.3,1,6,6,6,6.8,17722,16251,1625.1,39,623,0
4517,2025,-460,1809.3,18093,17986,6.8,11,11,12,211,21.1,1,1,1,0,0,199,19.9,0,3,5,5,6.8,18446,16068,1606.8,460,-2025,1
4518,-315,718,1560.7,15607,18678,7.0,4,4,4,215,21.5,1,0,0,1,1,246,24.6,1,3,4,4,6.8,17960,15922,1592.2,-718,315,1
4519,-1592,-2199,1516.4,15164,17404,6.8,3,3,2,218,21.8,1,1,1,0,0,255,25.5,0,5,5,5,7.2,19603,16756,1675.6,2199,1592,1
4520,736,-349,1809.0,18090,18948,7.0,9,9,5,238,23.8,0,0,0,1,0,213,21.3,0,9,8,8,7.4,19297,17354,1735.4,349,-736,0
4521,3156,1621,1700.1,17001,18549,7.0,6,6,5,240,24.0,1,1,1,0,0,206,20.6,0,2,1,1,6.8,16928,13845,1384.5,-1621,-3156,1
4522,1085,-556,1590.4,15904,17670,7.0,5,5,9,213,21.3,0,0,1,0,0,229,22.9,0,1,2,2,6.8,18226,14819,1481.9,556,-1085,1
4523,3672,4732,1821.5,18215,19165,7.2,11,11,16,239,23.9,1,0,0,1,1,183,18.3,1,6,4,4,6.2,14433,14543,1454.3,-4732,-3672,1
4524,-126,463,1617.7,16177,18401,7.0,5,5,3,216,21.6,0,0,0,1,1,215,21.5,2,6,6,6,6.6,17938,16303,1630.3,-463,126,1
4525,-988,-1321,1708.7,17087,17225,6.8,5,5,5,206,20.6,1,1,0,1,0,201,20.1,1,8,9,9,7.2,18546,18075,1807.5,1321,988,0
4526,466,933,1659.4,16594,18973,7.0,6,6,5,224,22.4,1,0,1,0,1,233,23.3,1,8,5,5,7.0,18040,16128,1612.8,-933,-466,1
4527,-1443,-269,1510.1,15101,18673,7.0,2,2,1,241,24.1,0,0,1,0,1,217,21.7,1,5,4,4,7.0,18942,16544,1654.4,269,1443,0
4528,833,383,1578.7,15787,17255,6.8,5,5,4,209,20.9,1,1,0,1,0,179,17.9,0,10,5,5,6.6,16872,14954,1495.4,-383,-833,1
4529,-189,-709,1593.6,15936,18164,7.0,4,4,3,255,25.5,1,1,1,0,0,252,25.2,0,4,5,5,7.4,18873,16125,1612.5,709,189,1
4530,-233,20,1560.8,15608,18584,7.2,3,3,6,234,23.4,0,0,0,1,1,240,24.0,2,4,4,4,7.2,18564,15841,1584.1,-20,233,0
4531,-193,548,1722.6,17226,19315,7.0,7,7,4,226,22.6,0,0,1,0,1,223,22.3,1,7,8,8,7.2,18767,17419,1741.9,-548,193,1
4532,-1832,-386,1697.2,16972,19143,7.2,8,8,6,198,19.8,0,0,0,1,1,230,23.0,1,10,9,9,7.4,19529,18804,1880.4,386,1832,0
4533,961,849,1642.1,16421,19037,7.4,6,6,6,224,22.4,1,0,0,1,0,194,19.4,0,4,6,6,7.0,18188,15460,1546.0,-849,-961,1
4534,1047,-143,1666.4,16664,18036,6.8,2,2,3,255,25.5,1,0,0,1,1,247,24.7,1,4,3,3,7.0,18179,15617,1561.7,143,-1047,0
4535,-6000,-3856,1492.0,14920,17398,6.8,4,4,4,186,18.6,0,0,0,1,1,246,24.6,1,15,12,12,7.6,21254,20920,2092.0,3856,6000,0
4536,3036,3251,1822.7,18227,19733,7.4,9,9,7,248,24.8,1,1,0,1,0,173,17.3,0,3,5,5,6.6,16482,15191,1519.1,-3251,-3036,0
4537,5422,3259,1988.5,19885,18684,7.0,16,16,21,177,17.7,0,0,1,0,1,182,18.2,1,4,4,4,6.4,15425,14463,1446.3,-3259,-5422,1
4538,-3230,-3243,1522.5,15225,16334,6.4,7,7,7,180,18.0,0,0,0,1,1,227,22.7,1,7,11,11,7.2,19577,18455,1845.5,3243,3230,0
4539,-2692,-1151,1507.0,15070,18012,6.8,3,3,5,217,21.7,1,1,0,1,0,225,22.5,0,14,7,7,7.6,19163,17762,1776.2,1151,2692,0
4540,-336,-124,1642.5,16425,18433,7.0,6,6,3,232,23.2,1,1,0,1,0,197,19.7,0,6,8,8,7.2,18557,16761,1676.1,124,336,0
4541,1089,196,1716.8,17168,17989,7.0,7,7,10,233,23.3,0,0,1,0,1,235,23.5,1,4,5,5,6.8,17793,16079,1607.9,-196,-1089,1
4542,-775,687,1782.2,17822,18329,7.0,9,9,12,209,20.9,1,1,0,1,0,219,21.9,0,8,8,8,6.6,17642,18597,1859.7,-687,775,1
4543,-4331,-2588,1405.5,14055,16334,6.6,1,1,2,208,20.8,0,0,0,1,1,226,22.6,1,10,8,8,7.2,18922,18386,1838.6,2588,4331,0
4544,-916,483,1621.3,16213,17532,6.6,5,5,6,208,20.8,1,1,0,1,0,215,21.5,0,12,7,7,7.0,17049,17129,1712.9,-483,916,0
4545,-2529,-2091,1633.7,16337,16985,7.0,6,6,4,202,20.2,0,0,0,1,1,214,21.4,1,15,12,12,7.2,19076,18866,1886.6,2091,2529,0
4546,705,-208,1573.6,15736,18218,7.0,2,2,3,234,23.4,1,0,1,0,1,250,25.0,1,2,2,2,7.0,18426,15031,1503.1,208,-705,0
4547,1814,619,1679.0,16790,18508,6.8,4,4,3,242,24.2,1,0,0,1,1,185,18.5,1,5,4,4,6.8,17889,14976,1497.6,-619,-1814,1
4548,-1053,-1363,1609.1,16091,17434,6.6,3,3,5,230,23.0,1,1,1,0,0,248,24.8,0,5,5,5,7.0,18797,17144,1714.4,1363,1053,0
4549,-4395,-4086,1443.3,14433,15908,6.4,2,2,3,210,21.0,0,0,0,1,1,219,21.9,2,9,9,9,7.4,19994,18828,1882.8,4086,4395,0
4550,3129,1416,1738.9,17389,18966,7.0,7,7,4,237,23.7,0,0,1,0,1,203,20.3,1,1,2,2,6.8,17550,14260,1426.0,-1416,-3129,1
4551,-4666,-3086,1447.5,14475,16283,6.6,2,2,2,205,20.5,1,0,0,1,1,224,22.4,1,9,9,9,7.2,19369,19141,1914.1,3086,4666,0
4552,599,754,1537.3,15373,18233,7.0,1,1,1,264,26.4,1,0,0,1,0,212,21.2,0,3,3,3,6.8,17479,14774,1477.4,-754,-599,0
4553,-2528,-993,1438.1,14381,16919,6.6,3,3,3,202,20.2,0,0,0,1,1,196,19.6,1,10,7,7,6.8,17912,16909,1690.9,993,2528,0
4554,1283,518,1797.5,17975,18967,7.2,8,8,5,248,24.8,0,0,1,0,1,217,21.7,1,2,7,7,7.0,18449,16692,1669.2,-518,-1283,1
4555,2929,1296,1745.9,17459,19021,7.2,7,7,8,231,23.1,1,1,1,0,0,191,19.1,0,2,2,2,7.0,17725,14530,1453.0,-1296,-2929,1
4556,2638,2423,1905.6,19056,19650,7.4,6,6,8,232,23.2,1,0,1,0,0,204,20.4,0,12,7,7,6.8,17227,16418,1641.8,-2423,-2638,1
4557,-4158,-3452,1411.7,14117,16799,6.6,2,2,2,199,19.9,0,0,0,1,1,248,24.8,2,7,8,8,7.4,20251,18275,1827.5,3452,4158,0
4558,-355,-1775,1719.1,17191,17872,6.8,6,6,12,227,22.7,1,0,1,0,0,204,20.4,0,8,7,7,7.2,19647,17546,1754.6,1775,355,0
4559,3161,2079,1858.5,18585,18660,7.2,9,9,11,216,21.6,1,1,1,0,0,185,18.5,0,4,4,4,6.8,16581,15424,1542.4,-2079,-3161,1
4560,2875,3178,1827.1,18271,20332,7.2,11,11,4,224,22.4,2,1,1,0,0,213,21.3,0,4,4,4,6.8,17154,15396,1539.6,-3178,-2875,1
4561,3363,2997,1795.3,17953,18196,6.8,8,8,8,218,21.8,0,0,1,0,1,176,17.6,1,9,5,5,6.4,15199,14590,1459.0,-2997,-3363,1
4562,6,1023,1564.5,15645,17261,6.8,6,6,8,184,18.4,1,1,1,0,0,230,23.0,1,3,4,4,6.6,16238,15639,1563.9,-1023,-6,0
4563,-2574,-404,1458.8,14588,17460,6.8,1,1,1,241,24.1,0,0,0,1,0,222,22.2,0,6,4,4,6.8,17864,17162,1716.2,404,2574,0
4564,-428,-432,1615.2,16152,17881,7.0,4,4,7,260,26.0,0,0,0,1,1,238,23.8,2,7,5,5,7.2,18313,16580,1658.0,432,428,1
4565,1866,80,1703.0,17030,18285,6.8,8,8,5,212,21.2,1,1,1,0,0,246,24.6,0,2,2,2,7.2,18205,15164,1516.4,-80,-1866,1
4566,1902,3370,1920.4,19204,20520,7.6,15,15,9,215,21.5,1,0,1,0,0,183,18.3,0,12,10,10,6.8,17150,17302,1730.2,-3370,-1902,1
4567,-1375,-850,1492.5,14925,18636,7.0,4,4,3,218,21.8,0,0,0,1,1,220,22.0,1,4,5,5,7.6,19486,16300,1630.0,850,1375,0
4568,2585,3290,1756.1,17561,19417,7.2,8,8,9,222,22.2,2,1,0,1,0,222,22.2,0,4,3,3,6.4,16127,14976,1497.6,-3290,-2585,1
4569,-2353,-2050,1504.9,15049,16534,6.6,4,4,7,211,21.1,0,0,0,1,1,235,23.5,2,7,8,8,7.0,18584,17402,1740.2,2050,2353,0
4570,-279,-411,1552.3,15523,18159,7.0,3,3,4,233,23.3,1,1,1,0,0,247,24.7,0,6,4,4,7.2,18570,15802,1580.2,411,279,0
4571,-2917,-2806,1491.0,14910,16907,6.8,2,2,2,227,22.7,0,0,0,1,1,216,21.6,2,4,11,11,7.0,19713,17827,1782.7,2806,2917,0
4572,-3783,-3300,1578.7,15787,15849,6.6,5,5,4,200,20.0,0,0,1,0,1,201,20.1,1,12,14,14,7.2,19149,19570,1957.0,3300,3783,0
4573,-103,859,1684.0,16840,19282,7.2,5,5,4,264,26.4,0,0,0,1,1,219,21.9,2,3,5,5,7.0,18423,16943,1694.3,-859,103,0
4574,-1345,-621,1454.1,14541,18354,6.8,2,2,2,240,24.0,1,1,0,1,0,260,26.0,0,2,2,2,7.2,18975,15886,1588.6,621,1345,1
4575,-1115,-883,1627.3,16273,17751,7.0,6,6,6,193,19.3,0,0,1,0,1,208,20.8,1,7,8,8,7.2,18634,17388,1738.8,883,1115,1
4576,-1711,-2183,1453.1,14531,16999,6.8,2,2,5,222,22.2,0,0,0,1,1,235,23.5,1,5,5,5,7.2,19182,16242,1624.2,2183,1711,0
4577,1221,-172,1741.3,17413,17940,7.0,9,9,10,229,22.9,0,0,1,0,0,213,21.3,0,7,5,5,7.0,18112,16192,1619.2,172,-1221,1
4578,-2461,-1626,1562.2,15622,17546,6.8,3,3,3,246,24.6,0,0,0,1,1,228,22.8,1,10,9,9,7.2,19172,18083,1808.3,1626,2461,0
4579,2100,1556,1955.6,19556,18530,7.2,10,10,11,198,19.8,2,1,1,0,0,189,18.9,0,11,10,10,6.8,16974,17456,1745.6,-1556,-2100,0
4580,823,2681,1679.7,16797,18636,7.0,6,6,5,213,21.3,0,0,1,0,0,158,15.8,1,11,7,7,6.4,15955,15974,1597.4,-2681,-823,0
4581,-488,-237,1573.5,15735,17073,6.6,5,5,10,225,22.5,1,0,0,1,1,200,20.0,1,8,7,7,6.8,17310,16223,1622.3,237,488,0
4582,2093,2151,1857.0,18570,19063,7.2,13,13,15,206,20.6,1,1,1,0,0,212,21.2,0,11,7,7,6.6,16912,16477,1647.7,-2151,-2093,1
4583,3364,2412,1784.9,17849,18536,7.0,8,8,8,227,22.7,0,0,1,0,1,223,22.3,1,2,3,3,6.4,16124,14485,1448.5,-2412,-3364,1
4584,3356,2257,1936.4,19364,19292,7.4,11,11,16,232,23.2,1,1,1,0,0,198,19.8,0,9,6,6,6.8,17035,16008,1600.8,-2257,-3356,1
4585,1992,2548,1704.7,17047,19134,7.2,9,9,7,226,22.6,0,0,0,1,1,225,22.5,1,4,4,4,6.6,16586,15055,1505.5,-2548,-1992,1
4586,-1198,-833,1610.5,16105,17701,7.0,5,5,4,237,23.7,0,0,1,0,0,230,23.0,1,8,9,9,7.2,18534,17303,1730.3,833,1198,0
4587,-2415,-2092,1561.1,15611,17672,7.0,5,5,5,222,22.2,0,0,0,1,1,231,23.1,1,10,9,9,7.2,19764,18026,1802.6,2092,2415,0
4588,2265,2656,1876.6,18766,20059,7.2,12,12,12,231,23.1,0,0,1,0,0,225,22.5,0,6,6,6,6.8,17403,16501,1650.1,-2656,-2265,1
4589,2708,1906,1759.0,17590,19299,7.2,7,7,6,231,23.1,1,1,1,0,0,223,22.3,1,3,4,4,6.6,17393,14882,1488.2,-1906,-2708,1
4590,-2558,-2878,1522.2,15222,16160,6.4,6,6,3,192,19.2,1,0,1,0,1,205,20.5,1,15,10,10,7.2,19038,17780,1778.0,2878,2558,0
4591,-294,-531,1553.7,15537,18116,7.2,3,3,1,239,23.9,0,0,0,1,0,244,24.4,1,4,4,4,7.2,18647,15831,1583.1,531,294,0
4592,4692,3644,1926.5,19265,20085,7.4,10,10,9,244,24.4,1,1,1,0,0,221,22.1,0,0,5,5,6.6,16441,14573,1457.3,-3644,-4692,1
4593,-1222,-815,1474.6,14746,17859,7.0,2,2,2,237,23.7,1,1,0,1,0,246,24.6,0,2,3,3,7.2,18674,15968,1596.8,815,1222,0
4594,-1107,-2894,1526.1,15261,15935,6.8,4,4,7,227,22.7,1,1,0,1,0,224,22.4,0,4,7,7,7.2,18829,16368,1636.8,2894,1107,1
4595,-3179,-937,1346.5,13465,15462,6.2,2,2,0,191,19.1,0,0,0,1,1,226,22.6,1,6,6,6,6.6,16399,16644,1664.4,937,3179,0
4596,5565,5067,2031.0,20310,20225,7.4,16,16,7,230,23.0,1,0,1,0,1,169,16.9,1,3,5,5,6.2,15158,14745,1474.5,-5067,-5565,1
4597,1863,464,1752.7,17527,18186,7.0,7,7,10,227,22.7,0,0,1,0,1,231,23.1,1,6,4,4,7.0,17722,15664,1566.4,-464,-1863,1
4598,-4179,-4531,1506.1,15061,15124,6.2,7,7,7,183,18.3,0,0,1,0,0,236,23.6,1,8,13,13,7.2,19655,19240,1924.0,4531,4179,0
4599,-923,-229,1676.5,16765,18366,7.2,7,7,7,213,21.3,1,1,1,0,0,214,21.4,0,8,9,9,7.0,18595,17688,1768.8,229,923,1
4600,-1910,-1781,1501.8,15018,17474,6.6,4,4,4,200,20.0,0,0,0,1,0,227,22.7,0,6,7,7,7.2,19255,16928,1692.8,1781,1910,0
4601,4061,3186,1820.5,18205,19871,7.4,9,9,9,225,22.5,0,0,1,0,0,187,18.7,1,2,3,3,6.6,16685,14144,1414.4,-3186,-4061,1
4602,-480,-607,1528.4,15284,16690,6.6,5,5,6,187,18.7,0,0,1,0,1,230,23.0,1,3,3,3,6.6,17297,15764,1576.4,607,480,1
4603,-2243,-3667,1502.6,15026,16386,6.4,3,3,4,202,20.2,1,1,1,0,0,229,22.9,0,8,6,6,7.6,20053,17269,1726.9,3667,2243,0
4604,443,-1437,1582.7,15827,17668,6.8,5,5,5,212,21.2,0,0,1,0,1,232,23.2,1,4,3,3,7.2,19105,15384,1538.4,1437,-443,0
4605,354,816,1646.3,16463,18961,7.2,6,6,8,221,22.1,0,0,0,1,0,225,22.5,0,1,4,4,7.0,18145,16109,1610.9,-816,-354,1
4606,-363,-191,1690.8,16908,17271,6.8,9,9,7,196,19.6,0,0,1,0,1,187,18.7,1,9,8,8,6.8,17462,17271,1727.1,191,363,1
4607,2459,834,1801.7,18017,18923,7.2,6,6,5,228,22.8,1,0,0,1,1,220,22.0,1,3,3,3,6.8,18089,15558,1555.8,-834,-2459,0
4608,-216,882,1525.7,15257,18061,6.8,4,4,2,221,22.1,1,1,1,0,0,244,24.4,0,3,3,3,6.6,17179,15473,1547.3,-882,216,1
4609,-3585,-3405,1364.3,13643,16820,7.0,0,0,0,217,21.7,0,0,0,1,1,266,26.6,1,6,5,5,7.4,20225,17228,1722.8,3405,3585,0
4610,-2778,-2174,1441.8,14418,16672,6.4,3,3,1,206,20.6,0,0,0,1,1,205,20.5,2,7,8,8,7.0,18846,17196,1719.6,2174,2778,1
4611,-2450,-1839,1599.9,15999,18592,7.0,5,5,5,241,24.1,1,1,0,1,0,255,25.5,0,6,8,8,7.2,20431,18449,1844.9,1839,2450,0
4612,-330,-142,1503.1,15031,16824,6.8,3,3,4,202,20.2,0,0,0,1,0,215,21.5,1,5,4,4,6.6,16966,15361,1536.1,142,330,1
4613,2279,2842,1612.9,16129,18567,7.2,6,6,8,210,21.0,1,1,0,1,0,205,20.5,0,1,1,1,6.4,15725,13850,1385.0,-2842,-2279,0
4614,-1694,-1,1605.9,16059,18553,7.0,5,5,8,216,21.6,0,0,0,1,1,231,23.1,2,5,4,4,7.2,18554,17753,1775.3,1,1694,0
4615,709,1296,1773.1,17731,18478,7.0,8,8,13,256,25.6,0,0,0,1,0,229,22.9,0,5,6,6,6.8,17182,17022,1702.2,-1296,-709,1
4616,-6871,-5115,1520.2,15202,16607,6.6,4,4,3,219,21.9,0,0,0,1,1,253,25.3,1,11,12,12,8.0,21722,22073,2207.3,5115,6871,0
4617,987,1253,1578.6,15786,18637,7.2,4,4,1,246,24.6,0,0,0,1,1,200,20.0,1,4,4,4,6.8,17384,14799,1479.9,-1253,-987,1
4618,145,-862,1600.3,16003,17277,7.0,5,5,11,216,21.6,1,0,1,0,0,246,24.6,0,4,3,3,7.0,18139,15858,1585.8,862,-145,1
4619,-3975,-4232,1386.7,13867,15515,6.2,2,2,1,206,20.6,0,0,0,1,0,237,23.7,0,9,9,9,7.0,19747,17842,1784.2,4232,3975,0
4620,683,246,1579.2,15792,17609,7.0,5,5,4,228,22.8,1,1,1,0,0,210,21.0,0,6,4,4,6.6,17363,15109,1510.9,-246,-683,1
4621,-1674,-772,1441.5,14415,17248,6.8,2,2,2,215,21.5,0,0,0,1,1,246,24.6,1,6,5,5,6.8,18020,16089,1608.9,772,1674,0
4622,1630,1924,1666.5,16665,18534,7.0,6,6,6,236,23.6,1,1,0,1,0,235,23.5,0,3,3,3,6.8,16610,15035,1503.5,-1924,-1630,1
4623,-848,-4,1577.5,15775,16946,6.6,5,5,2,249,24.9,0,0,0,1,1,225,22.5,1,7,5,5,6.6,16950,16623,1662.3,4,848,1
4624,217,72,1641.8,16418,17454,6.8,4,4,5,237,23.7,1,1,1,0,0,216,21.6,0,5,7,7,6.6,17382,16201,1620.1,-72,-217,0
4625,3224,2800,1952.5,19525,20374,7.6,12,12,8,242,24.2,0,0,1,0,0,181,18.1,0,10,8,8,7.0,17574,16301,1630.1,-2800,-3224,0
4626,-6973,-3705,1434.9,14349,16821,6.6,4,4,3,159,15.9,0,0,0,1,1,263,26.3,1,11,13,13,7.6,20526,21322,2132.2,3705,6973,0
4627,-1726,63,1648.0,16480,17339,6.6,6,6,9,226,22.6,0,0,1,0,0,229,22.9,1,9,8,8,6.8,17276,18206,1820.6,-63,1726,0
4628,1289,2602,1768.3,17683,20153,7.6,8,8,4,237,23.7,2,1,0,1,0,208,20.8,0,7,7,7,6.6,17551,16394,1639.4,-2602,-1289,1
4629,-3201,-3067,1679.7,16797,17770,6.8,8,8,8,200,20.0,1,1,1,0,0,232,23.2,0,16,13,13,7.6,20837,19998,1999.8,3067,3201,0
4630,-1313,-1476,1461.6,14616,16844,6.6,5,5,3,183,18.3,1,1,1,0,0,217,21.7,0,3,6,6,7.0,18320,15929,1592.9,1476,1313,0
4631,5269,3577,1862.2,18622,19365,7.2,11,11,11,245,24.5,0,0,1,0,0,189,18.9,0,1,1,1,6.6,15788,13353,1335.3,-3577,-5269,1
4632,-5354,-4248,1468.9,14689,16679,6.6,4,4,3,195,19.5,0,0,0,1,1,244,24.4,1,10,11,11,7.6,20927,20043,2004.3,4248,5354,0
4633,-1949,-1074,1784.2,17842,18236,6.8,10,10,13,194,19.4,1,1,0,1,0,228,22.8,0,12,12,12,7.2,19310,19791,1979.1,1074,1949,0
4634,-1318,132,1475.6,14756,18676,7.2,2,2,1,237,23.7,1,1,0,1,0,266,26.6,0,5,3,3,6.8,18544,16074,1607.4,-132,1318,1
4635,3098,2685,1849.4,18494,17736,6.8,12,12,23,212,21.2,1,1,0,1,0,188,18.8,0,9,5,5,6.2,15051,15396,1539.6,-2685,-3098,1
4636,-2809,-2023,1387.0,13870,15601,6.4,2,2,4,202,20.2,1,1,0,1,0,221,22.1,0,7,7,7,6.8,17624,16679,1667.9,2023,2809,0
4637,-108,-914,1440.9,14409,17030,6.4,3,3,2,212,21.2,1,1,0,1,0,200,20.0,1,5,3,3,7.0,17944,14517,1451.7,914,108,0
4638,-3318,-2979,1554.3,15543,17304,6.8,5,5,5,197,19.7,0,0,0,1,1,228,22.8,2,8,11,11,7.6,20283,18861,1886.1,2979,3318,0
4639,-4093,-2844,1574.0,15740,15862,6.4,6,6,5,177,17.7,0,0,0,1,1,208,20.8,1,16,14,14,7.2,18706,19833,1983.3,2844,4093,0
4640,-854,-1069,1569.1,15691,17738,6.8,5,5,4,190,19.0,0,0,1,0,1,227,22.7,2,5,7,7,7.0,18807,16545,1654.5,1069,854,1
4641,-1891,-1211,1531.4,15314,17245,7.0,3,3,4,207,20.7,1,0,1,0,0,226,22.6,0,6,8,8,7.2,18456,17205,1720.5,1211,1891,1
4642,5872,4455,2003.0,20030,18878,7.2,14,14,15,205,20.5,0,0,1,0,0,171,17.1,0,5,3,3,6.0,14423,14158,1415.8,-4455,-5872,1
4643,3713,3023,1812.1,18121,19941,7.4,6,6,5,257,25.7,1,1,1,0,0,241,24.1,1,1,2,2,6.6,16918,14408,1440.8,-3023,-3713,1
4644,3149,2125,1862.5,18625,18897,7.2,10,10,12,223,22.3,2,1,1,0,0,227,22.7,0,4,5,5,6.8,16772,15476,1547.6,-2125,-3149,1
4645,4263,2953,1815.2,18152,19147,7.2,10,10,7,233,23.3,0,0,1,0,0,204,20.4,1,2,1,1,6.6,16194,13889,1388.9,-2953,-4263,1
4646,2896,1979,1735.0,17350,18363,7.2,7,7,10,233,23.3,0,0,1,0,0,199,19.9,0,6,3,3,6.4,16384,14454,1445.4,-1979,-2896,1
4647,2216,1311,1636.3,16363,18353,7.0,6,6,7,218,21.8,1,1,1,0,0,211,21.1,0,2,2,2,6.6,17042,14147,1414.7,-1311,-2216,1
4648,530,227,1610.4,16104,17424,6.8,8,8,5,175,17.5,1,1,1,0,0,227,22.7,0,4,5,5,6.8,17197,15574,1557.4,-227,-530,1
4649,-729,-889,1540.1,15401,16508,6.6,6,6,9,195,19.5,1,1,1,0,0,191,19.1,0,5,5,5,6.6,17397,16130,1613.0,889,729,1
4650,5885,4652,1933.1,19331,20193,7.4,8,8,9,254,25.4,1,1,0,1,0,169,16.9,0,0,1,1,6.4,15541,13446,1344.6,-4652,-5885,1
4651,2607,1862,1753.7,17537,19736,7.2,11,11,9,196,19.6,1,1,1,0,0,183,18.3,0,2,6,6,7.0,17874,14930,1493.0,-1862,-2607,0
4652,1952,1542,1837.9,18379,19031,7.2,11,11,14,203,20.3,0,0,1,0,1,196,19.6,1,9,6,6,6.8,17489,16427,1642.7,-1542,-1952,0
4653,-1726,-1890,1485.7,14857,16453,6.4,2,2,2,210,21.0,0,0,0,1,1,203,20.3,1,17,7,7,7.2,18343,16583,1658.3,1890,1726,0
4654,996,116,1752.0,17520,18523,7.0,8,8,6,220,22.0,0,0,1,0,1,221,22.1,1,6,6,6,6.8,18407,16524,1652.4,-116,-996,1
4655,-4715,-1691,1483.7,14837,17437,6.6,4,4,4,209,20.9,0,0,0,1,1,239,23.9,2,10,9,9,7.4,19128,19552,1955.2,1691,4715,0
4656,928,-633,1693.0,16930,18587,7.2,5,5,8,237,23.7,0,0,0,1,1,241,24.1,1,3,5,5,7.2,19220,16002,1600.2,633,-928,0
4657,-1514,-893,1633.2,16332,17067,6.8,7,7,11,196,19.6,0,0,0,1,1,211,21.1,1,9,10,10,6.8,17960,17846,1784.6,893,1514,0
4658,-281,497,1580.7,15807,18325,7.2,5,5,2,231,23.1,0,0,0,1,0,230,23.0,0,5,6,6,7.0,17828,16088,1608.8,-497,281,0
4659,-438,-669,1872.0,18720,18913,7.2,11,11,10,222,22.2,1,1,0,1,0,186,18.6,0,12,10,10,7.2,19582,19158,1915.8,669,438,1
4660,-579,-379,1421.5,14215,17252,6.6,1,1,1,228,22.8,0,0,0,1,1,233,23.3,1,1,2,2,6.8,17631,14794,1479.4,379,579,0
4661,3579,2679,1912.4,19124,20438,7.2,13,13,9,244,24.4,0,0,1,0,1,191,19.1,1,4,5,5,7.0,17759,15545,1554.5,-2679,-3579,1
4662,-1241,-1045,1435.2,14352,17455,6.8,3,3,1,222,22.2,0,0,0,1,0,232,23.2,1,2,4,4,6.8,18500,15593,1559.3,1045,1241,0
4663,727,-566,1678.4,16784,18136,7.0,5,5,7,252,25.2,0,0,0,1,0,221,22.1,0,2,3,3,7.2,18702,16057,1605.7,566,-727,1
4664,-972,-1814,1632.8,16328,17945,6.8,5,5,6,241,24.1,1,1,1,0,0,233,23.3,0,8,7,7,7.2,19759,17300,1730.0,1814,972,1
4665,-1086,646,1531.8,15318,18578,7.0,5,5,3,200,20.0,0,0,0,1,1,194,19.4,2,8,8,8,6.8,17932,16404,1640.4,-646,1086,0
4666,-2200,-1933,1489.6,14896,17240,6.8,3,3,5,207,20.7,0,0,1,0,1,235,23.5,2,6,5,5,7.4,19173,17096,1709.6,1933,2200,1
4667,481,-259,1566.7,15667,17128,7.0,5,5,6,202,20.2,1,1,1,0,0,219,21.9,0,1,3,3,6.8,17387,15186,1518.6,259,-481,1
4668,4612,2877,2190.8,21908,20909,7.4,13,13,13,227,22.7,1,1,1,0,0,195,19.5,0,12,9,9,7.0,18032,17296,1729.6,-2877,-4612,1
4669,1506,-265,1637.2,16372,17570,6.8,6,6,5,234,23.4,1,0,1,0,1,200,20.0,1,3,5,5,6.8,17835,14866,1486.6,265,-1506,0
4670,2090,468,1599.3,15993,16122,6.4,7,7,9,188,18.8,1,1,1,0,0,209,20.9,0,2,2,2,6.4,15654,13903,1390.3,-468,-2090,1
4671,-2579,-3819,1446.9,14469,15329,6.2,5,5,7,136,13.6,0,0,0,1,0,244,24.4,1,2,5,5,7.2,19148,17048,1704.8,3819,2579,0
4672,1723,740,1695.6,16956,18750,7.2,5,5,6,259,25.9,1,1,1,0,0,262,26.2,1,1,1,1,6.8,18010,15233,1523.3,-740,-1723,1
4673,559,55,1669.9,16699,18064,7.0,7,7,4,212,21.2,1,0,1,0,1,194,19.4,1,7,7,7,7.2,18009,16140,1614.0,-55,-559,0
4674,-3346,-3153,1486.8,14868,16222,6.6,3,3,1,237,23.7,0,0,0,1,1,229,22.9,2,9,8,8,7.2,19375,18214,1821.4,3153,3346,0
4675,785,812,1828.1,18281,17856,7.0,9,9,15,218,21.8,2,1,1,0,0,184,18.4,0,12,11,11,7.0,17044,17496,1749.6,-812,-785,0
4676,-439,775,1514.4,15144,18640,7.4,3,3,4,214,21.4,0,0,0,1,1,241,24.1,2,6,5,5,6.6,17865,15583,1558.3,-775,439,0
4677,-4416,-3186,1413.5,14135,15854,6.4,4,4,4,182,18.2,0,0,0,1,1,231,23.1,1,10,10,10,7.4,19040,18551,1855.1,3186,4416,0
4678,-4523,-3729,1380.8,13808,15418,6.2,3,3,2,169,16.9,0,0,1,0,1,219,21.9,1,9,9,9,7.2,19147,18331,1833.1,3729,4523,0
4679,-3447,-3324,1513.7,15137,15969,6.6,4,4,4,206,20.6,1,1,0,1,0,262,26.2,1,10,9,9,7.2,19293,18584,1858.4,3324,3447,0
4680,2145,870,1724.7,17247,18201,7.0,7,7,7,223,22.3,1,1,1,0,0,231,23.1,0,5,4,4,6.8,17331,15102,1510.2,-870,-2145,1
4681,577,1501,1648.5,16485,18714,7.2,5,5,6,247,24.7,0,0,0,1,1,236,23.6,1,5,4,4,6.8,17213,15908,1590.8,-1501,-577,0
4682,-1883,-873,1686.7,16867,16680,6.8,7,7,11,209,20.9,1,0,1,0,1,226,22.6,1,13,12,12,7.0,17553,18750,1875.0,873,1883,0
4683,-3608,-4288,1427.2,14272,15106,6.0,3,3,2,194,19.4,0,0,0,1,0,259,25.9,0,4,9,9,7.2,19394,17880,1788.0,4288,3608,0
4684,-4690,-3429,1428.2,14282,16446,6.6,3,3,4,182,18.2,0,0,0,1,1,235,23.5,1,11,9,9,7.4,19875,18972,1897.2,3429,4690,0
4685,1705,177,1635.2,16352,17852,6.8,4,4,5,220,22.0,0,0,1,0,1,202,20.2,1,2,3,3,7.0,17675,14647,1464.7,-177,-1705,1
4686,2417,2101,1786.2,17862,19955,7.4,10,10,12,242,24.2,0,0,1,0,1,203,20.3,1,3,3,3,7.0,17854,15445,1544.5,-2101,-2417,0
4687,617,866,1643.1,16431,17901,6.8,7,7,12,204,20.4,2,1,1,0,0,236,23.6,0,6,4,4,6.6,17035,15814,1581.4,-866,-617,0
4688,2861,2287,1711.4,17114,19292,7.4,5,5,5,253,25.3,0,0,1,0,1,248,24.8,1,1,1,1,6.8,17005,14253,1425.3,-2287,-2861,1
4689,503,-222,1900.3,19003,16349,6.6,9,9,11,226,22.6,2,1,0,1,0,209,20.9,0,14,10,10,6.6,16571,18500,1850.0,222,-503,1
4690,-1679,-1569,1545.1,15451,16217,6.4,6,6,10,188,18.8,0,0,1,0,1,188,18.8,2,10,9,9,7.2,17786,17130,1713.0,1569,1679,0
4691,2361,770,1794.1,17941,18842,7.2,9,9,13,205,20.5,1,1,1,0,0,249,24.9,0,3,3,3,6.8,18072,15580,1558.0,-770,-2361,0
4692,4932,3923,1953.7,19537,20680,7.8,12,12,10,246,24.6,1,1,1,0,0,212,21.2,0,2,3,3,6.6,16757,14605,1460.5,-3923,-4932,1
4693,1310,-95,1686.3,16863,17496,6.6,7,7,6,232,23.2,0,0,1,0,1,227,22.7,1,3,3,3,6.8,17591,15553,1555.3,95,-1310,1
4694,-2314,-2460,1531.5,15315,17328,6.8,3,3,3,213,21.3,1,1,1,0,0,237,23.7,0,11,8,8,7.2,19788,17629,1762.9,2460,2314,0
4695,-153,-962,1585.3,15853,17700,7.0,5,5,10,204,20.4,1,1,0,1,0,241,24.1,0,4,6,6,6.8,18662,16006,1600.6,962,153,1
4696,-2186,-1093,1407.2,14072,16596,6.6,2,2,0,207,20.7,0,0,1,0,1,210,21.0,1,7,6,6,7.0,17689,16258,1625.8,1093,2186,0
4697,-1567,1876,1703.0,17030,16983,6.8,9,9,8,176,17.6,0,0,0,1,0,171,17.1,0,15,12,12,6.2,15107,18597,1859.7,-1876,1567,0
4698,-2139,-1844,1561.7,15617,17606,6.8,6,6,5,194,19.4,0,0,1,0,1,200,20.0,1,10,8,8,7.4,19450,17756,1775.6,1844,2139,0
4699,487,-618,1563.4,15634,17475,6.6,3,3,4,213,21.3,1,1,1,0,0,242,24.2,1,0,1,1,7.0,18093,15147,1514.7,618,-487,1
4700,-860,-121,1549.3,15493,17405,6.8,5,5,2,211,21.1,1,0,0,1,1,202,20.2,1,10,7,7,7.0,17526,16353,1635.3,121,860,1
4701,786,1155,1595.9,15959,18751,7.2,5,5,5,244,24.4,1,1,0,1,0,238,23.8,0,5,3,3,6.8,17596,15173,1517.3,-1155,-786,0
4702,-1757,-1856,1594.5,15945,17784,7.0,4,4,2,229,22.9,0,0,1,0,1,209,20.9,2,8,10,10,7.2,19640,17702,1770.2,1856,1757,0
4703,-1067,-523,1738.9,17389,18770,7.0,8,8,8,218,21.8,0,0,0,1,1,234,23.4,1,9,9,9,7.4,19293,18456,1845.6,523,1067,1
4704,3354,2760,1796.1,17961,19152,7.2,11,11,14,205,20.5,1,1,1,0,0,206,20.6,0,5,4,4,6.8,16392,14607,1460.7,-2760,-3354,1
4705,419,1790,1574.4,15744,20593,7.6,4,4,2,234,23.4,0,0,0,1,1,263,26.3,1,0,3,3,7.2,18803,15325,1532.5,-1790,-419,0
4706,1131,1518,1665.7,16657,18425,7.0,7,7,10,231,23.1,1,1,0,1,0,233,23.3,0,3,3,3,6.6,16907,15526,1552.6,-1518,-1131,0
4707,1151,1753,1595.1,15951,19210,7.0,3,3,3,247,24.7,1,1,1,0,0,236,23.6,1,1,2,2,6.8,17457,14800,1480.0,-1753,-1151,0
4708,-1206,-963,1595.6,15956,17011,6.8,7,7,8,191,19.1,0,0,0,1,1,243,24.3,1,7,8,8,7.0,17974,17162,1716.2,963,1206,1
4709,-1620,-720,1618.4,16184,17808,6.8,4,4,4,239,23.9,0,0,0,1,0,218,21.8,0,8,9,9,7.2,18528,17804,1780.4,720,1620,0
4710,731,1627,1751.8,17518,19434,7.2,9,9,7,212,21.2,0,0,0,1,1,192,19.2,1,4,7,7,7.0,17807,16787,1678.7,-1627,-731,1
4711,1182,420,1699.2,16992,17775,6.8,6,6,10,227,22.7,0,0,1,0,0,203,20.3,0,8,6,6,6.6,17355,15810,1581.0,-420,-1182,1
4712,-2155,-1351,1431.7,14317,17076,6.8,3,3,2,224,22.4,0,0,0,1,0,239,23.9,1,4,4,4,7.0,18427,16472,1647.2,1351,2155,0
4713,-792,-9,1493.5,14935,17972,7.2,3,3,2,220,22.0,0,0,1,0,0,221,22.1,0,6,5,5,7.0,17981,15727,1572.7,9,792,1
4714,-635,-1175,1473.6,14736,16670,6.4,2,2,2,235,23.5,0,0,1,0,0,235,23.5,0,4,3,3,7.2,17845,15371,1537.1,1175,635,0
4715,3711,2294,1844.4,18444,18580,7.0,10,10,12,220,22.0,1,1,1,0,0,234,23.4,0,2,2,2,6.4,16286,14733,1473.3,-2294,-3711,1
4716,2387,1690,1708.9,17089,18072,7.2,6,6,6,232,23.2,1,1,1,0,0,191,19.1,0,3,4,4,6.6,16382,14702,1470.2,-1690,-2387,1
4717,4060,3619,2003.6,20036,19646,7.2,15,15,16,178,17.8,0,0,1,0,0,192,19.2,0,8,7,7,6.4,16027,15976,1597.6,-3619,-4060,1
4718,4910,2573,1897.6,18976,19176,7.2,8,8,11,259,25.9,1,0,1,0,1,224,22.4,1,0,1,1,6.6,16603,14066,1406.6,-2573,-4910,1
4719,-686,-634,1525.7,15257,16719,6.6,3,3,4,237,23.7,1,1,1,0,0,208,20.8,0,8,5,5,6.8,17353,15943,1594.3,634,686,1
4720,1066,528,1651.0,16510,17844,7.0,5,5,4,239,23.9,0,0,1,0,0,231,23.1,0,3,4,4,7.0,17316,15444,1544.4,-528,-1066,0
4721,3880,2784,1775.4,17754,18653,7.0,8,8,10,239,23.9,0,0,1,0,0,204,20.4,0,1,2,2,6.4,15869,13874,1387.4,-2784,-3880,1
4722,297,1283,1633.9,16339,17799,7.0,6,6,7,205,20.5,0,0,0,1,0,225,22.5,0,7,6,6,6.4,16516,16042,1604.2,-1283,-297,1
4723,334,-302,1730.9,17309,17384,6.8,7,7,7,231,23.1,0,0,0,1,1,191,19.1,1,12,9,9,7.0,17686,16975,1697.5,302,-334,1
4724,267,745,1571.2,15712,17676,6.8,6,6,3,216,21.6,1,1,1,0,0,203,20.3,0,7,5,5,6.8,16931,15445,1544.5,-745,-267,1
4725,178,1499,1600.8,16008,18460,7.2,7,7,10,210,21.0,1,0,0,1,0,227,22.7,0,5,4,4,6.6,16961,15830,1583.0,-1499,-178,0
4726,-845,-571,1377.2,13772,16974,6.6,1,1,2,231,23.1,0,0,0,1,1,197,19.7,1,4,2,2,7.0,17545,14617,1461.7,571,845,1
4727,-2482,-1576,1430.1,14301,17009,6.6,3,3,3,173,17.3,0,0,0,1,1,230,23.0,1,6,8,8,7.0,18585,16783,1678.3,1576,2482,0
4728,-1370,-1269,1668.2,16682,18002,7.0,7,7,9,180,18.0,1,0,1,0,1,221,22.1,1,14,9,9,7.4,19271,18052,1805.2,1269,1370,0
4729,-3736,-2032,1484.9,14849,17502,6.8,3,3,3,221,22.1,1,1,1,0,0,232,23.2,1,6,7,7,7.6,19534,18585,1858.5,2032,3736,1
4730,1233,336,1780.7,17807,19554,7.4,9,9,8,229,22.9,0,0,0,1,1,197,19.7,2,5,6,6,7.4,19218,16574,1657.4,-336,-1233,0
4731,3650,3906,1886.6,18866,20876,7.6,11,11,11,214,21.4,2,1,1,0,0,219,21.9,0,4,3,3,6.8,16970,15216,1521.6,-3906,-3650,1
4732,1767,709,1782.8,17828,17917,6.8,9,9,6,218,21.8,1,1,1,0,0,202,20.2,0,7,6,6,6.8,17208,16061,1606.1,-709,-1767,0
4733,632,-1247,1647.0,16470,17655,7.0,7,7,7,216,21.6,1,1,1,0,0,230,23.0,0,2,5,5,7.0,18902,15838,1583.8,1247,-632,1
4734,147,1133,1686.5,16865,19606,7.4,8,8,4,212,21.2,0,0,0,1,1,209,20.9,1,3,7,7,7.0,18473,16718,1671.8,-1133,-147,0
4735,-2332,-2671,1535.3,15353,17812,7.0,5,5,4,189,18.9,0,0,1,0,0,217,21.7,0,5,8,8,7.6,20483,17685,1768.5,2671,2332,0
4736,-1179,-557,1424.7,14247,16785,6.8,2,2,1,216,21.6,0,0,0,1,0,194,19.4,0,3,6,6,6.8,17342,15426,1542.6,557,1179,0
4737,2352,707,1827.8,18278,17024,6.8,12,12,13,191,19.1,0,0,1,0,0,189,18.9,0,9,7,7,6.6,16317,15926,1592.6,-707,-2352,1
4738,-932,-517,1606.8,16068,18240,7.2,6,6,8,209,20.9,0,0,0,1,1,240,24.0,2,4,7,7,7.2,18757,17000,1700.0,517,932,0
4739,1361,1064,1596.6,15966,17893,6.8,4,4,3,231,23.1,1,1,1,0,0,208,20.8,0,1,2,2,6.6,16829,14605,1460.5,-1064,-1361,1
4740,-268,407,1786.0,17860,17673,7.0,10,10,12,182,18.2,0,0,0,1,0,199,19.9,0,16,10,10,6.8,17266,18128,1812.8,-407,268,1
4741,124,-1526,1751.7,17517,18612,7.2,9,9,14,228,22.8,0,0,0,1,1,235,23.5,2,7,6,6,7.4,20138,17393,1739.3,1526,-124,0
4742,-721,-1118,1581.5,15815,17429,6.8,5,5,4,224,22.4,0,0,1,0,1,241,24.1,1,7,6,6,7.0,18547,16536,1653.6,1118,721,0
4743,-1464,331,1651.9,16519,18850,7.0,7,7,4,203,20.3,1,1,0,1,0,240,24.0,0,4,6,6,7.0,18519,17983,1798.3,-331,1464,0
4744,1753,847,1697.7,16977,17852,7.0,7,7,11,201,20.1,1,0,1,0,1,186,18.6,1,9,5,5,6.6,17005,15224,1522.4,-847,-1753,1
4745,-4374,-2570,1476.9,14769,16504,6.4,3,3,2,205,20.5,0,0,0,1,0,209,20.9,0,13,12,12,7.0,19074,19143,1914.3,2570,4374,0
4746,194,1206,1722.1,17221,18291,6.8,7,7,5,229,22.9,0,0,1,0,1,213,21.3,1,8,9,9,6.8,17085,17027,1702.7,-1206,-194,0
4747,-973,-2396,1815.2,18152,18364,7.0,10,10,12,196,19.6,0,0,1,0,0,238,23.8,0,10,10,10,7.4,20760,19125,1912.5,2396,973,1
4748,1550,3286,1711.8,17118,19705,7.2,9,9,10,224,22.4,0,0,0,1,1,182,18.2,1,8,6,6,6.8,16419,15568,1556.8,-3286,-1550,1
4749,2504,2824,1692.3,16923,18443,6.8,8,8,9,195,19.5,1,1,0,1,0,199,19.9,0,3,4,4,6.4,15619,14419,1441.9,-2824,-2504,1
4750,-373,-1526,1769.8,17698,18605,7.2,8,8,8,218,21.8,0,0,1,0,1,233,23.3,1,5,8,8,7.4,20131,18071,1807.1,1526,373,0
4751,-4479,-2696,1388.9,13889,16133,6.4,2,2,2,200,20.0,0,0,0,1,0,239,23.9,0,12,9,9,7.0,18829,18368,1836.8,2696,4479,0
4752,-2789,-1511,1521.8,15218,17342,6.8,2,2,1,227,22.7,0,0,0,1,1,248,24.8,1,7,9,9,7.0,18853,18007,1800.7,1511,2789,0
4753,525,294,1587.6,15876,18504,7.0,4,4,3,228,22.8,1,1,1,0,0,227,22.7,0,2,3,3,6.8,18210,15351,1535.1,-294,-525,0
4754,-4094,-3320,1447.6,14476,16263,6.6,2,2,1,201,20.1,1,1,0,1,0,252,25.2,0,8,8,8,7.2,19583,18570,1857.0,3320,4094,0
4755,5229,5136,1873.0,18730,20389,7.4,10,10,5,232,23.2,1,0,1,0,1,181,18.1,1,0,3,3,6.4,15253,13501,1350.1,-5136,-5229,1
4756,-516,-113,1478.8,14788,17212,6.6,4,4,4,212,21.2,0,0,1,0,1,212,21.2,1,5,4,4,6.6,17325,15304,1530.4,113,516,0
4757,-429,-698,1725.7,17257,17553,6.8,7,7,10,189,18.9,1,0,1,0,1,223,22.3,1,9,8,8,7.0,18251,17686,1768.6,698,429,1
4758,695,1686,1675.5,16755,18760,6.8,4,4,1,263,26.3,1,1,0,1,0,225,22.5,0,4,5,5,6.6,17074,16060,1606.0,-1686,-695,0
4759,750,1304,1716.0,17160,18631,7.4,6,6,5,240,24.0,0,0,0,1,0,230,23.0,0,9,5,5,6.8,17327,16410,1641.0,-1304,-750,0
4760,1076,-845,1794.9,17949,17918,6.6,9,9,11,234,23.4,1,0,0,1,0,214,21.4,0,6,7,7,7.2,18763,16873,1687.3,845,-1076,1
4761,-3559,-1319,1558.5,15585,17639,6.8,4,4,2,224,22.4,0,0,0,1,0,216,21.6,0,11,12,12,7.2,18958,19144,1914.4,1319,3559,0
4762,3332,2911,1805.5,18055,17444,6.8,9,9,12,212,21.2,1,1,0,1,0,186,18.6,0,8,4,4,6.2,14533,14723,1472.3,-2911,-3332,1
4763,1104,183,1740.6,17406,18922,7.0,7,7,7,240,24.0,0,0,1,0,1,207,20.7,1,8,5,5,7.2,18739,16302,1630.2,-183,-1104,0
4764,-1428,-433,1863.3,18633,18367,6.8,9,9,16,246,24.6,0,0,0,1,1,223,22.3,2,10,12,12,7.2,18800,20061,2006.1,433,1428,0
4765,1156,916,1756.4,17564,18892,7.2,8,8,8,232,23.2,0,0,0,1,0,211,21.1,0,5,6,6,7.0,17976,16408,1640.8,-916,-1156,1
4766,1319,41,1794.4,17944,18559,7.2,9,9,8,255,25.5,0,0,1,0,1,234,23.4,1,4,7,7,7.0,18518,16625,1662.5,-41,-1319,0
4767,-1157,-51,1588.8,15888,18305,7.0,5,5,6,239,23.9,0,0,0,1,0,216,21.6,1,7,7,7,7.0,18356,17045,1704.5,51,1157,0
4768,-1968,-469,1665.0,16650,18077,7.0,8,8,9,199,19.9,1,1,0,1,0,224,22.4,0,11,10,10,7.2,18546,18618,1861.8,469,1968,0
4769,479,52,1789.2,17892,18021,7.0,10,10,15,190,19.0,0,0,1,0,0,221,22.1,0,19,9,9,7.0,17969,17413,1741.3,-52,-479,0
4770,-564,-1862,1570.8,15708,17721,6.8,3,3,3,226,22.6,0,0,1,0,1,243,24.3,1,5,5,5,7.2,19583,16272,1627.2,1862,564,1
4771,3110,1541,1932.4,19324,19019,7.0,13,13,14,226,22.6,0,0,1,0,1,206,20.6,1,8,6,6,7.0,17478,16214,1621.4,-1541,-3110,1
4772,-964,-1439,1642.5,16425,16635,6.8,7,7,10,207,20.7,0,0,1,0,0,189,18.9,0,7,10,10,7.0,18074,17389,1738.9,1439,964,0
4773,1140,-531,1699.3,16993,18944,7.0,5,5,3,241,24.1,1,0,1,0,1,231,23.1,1,5,5,5,7.0,19475,15853,1585.3,531,-1140,0
4774,-2181,-1293,1475.2,14752,17935,6.8,2,2,3,228,22.8,0,0,0,1,1,252,25.2,1,8,6,6,7.2,19228,16933,1693.3,1293,2181,0
4775,-3911,-2728,1467.5,14675,17184,6.8,2,2,1,207,20.7,0,0,0,1,1,254,25.4,2,10,10,10,7.4,19912,18586,1858.6,2728,3911,0
4776,1697,125,1690.7,16907,18072,6.8,6,6,10,165,16.5,0,0,1,0,1,242,24.2,1,1,3,3,6.8,17947,15210,1521.0,-125,-1697,1
4777,-6124,-4043,1438.4,14384,17020,7.0,2,2,3,237,23.7,0,0,0,1,1,252,25.2,1,8,11,11,7.6,21063,20508,2050.8,4043,6124,0
4778,-1603,-1134,1606.0,16060,17844,7.2,3,3,3,213,21.3,0,0,0,1,1,227,22.7,1,11,8,8,7.2,18978,17663,1766.3,1134,1603,0
4779,-930,185,1548.4,15484,18326,7.0,3,3,3,232,23.2,0,0,1,0,1,249,24.9,1,3,4,4,7.0,18141,16414,1641.4,-185,930,0
4780,-5181,-5072,1506.4,15064,14203,6.2,4,4,10,141,14.1,0,0,0,1,1,240,24.0,2,9,10,10,7.4,19275,20245,2024.5,5072,5181,0
4781,2666,400,1877.5,18775,18390,7.0,8,8,8,230,23.0,0,0,1,0,0,215,21.5,1,4,5,5,6.8,17990,16109,1610.9,-400,-2666,1
4782,4520,5730,1766.5,17665,19907,7.4,5,5,5,258,25.8,2,1,1,0,0,210,21.0,0,0,2,2,5.6,14177,13145,1314.5,-5730,-4520,1
4783,1524,2071,1737.9,17379,20465,7.6,7,7,10,265,26.5,0,0,1,0,1,268,26.8,1,7,3,3,7.0,18394,15855,1585.5,-2071,-1524,1
4784,-622,-1278,1626.6,16266,17958,6.6,4,4,2,224,22.4,1,0,1,0,1,231,23.1,1,13,8,8,7.2,19236,16888,1688.8,1278,622,0
4785,-2025,-1774,1626.0,16260,17081,6.8,6,6,8,197,19.7,0,0,0,1,0,193,19.3,1,11,7,7,7.0,18855,18285,1828.5,1774,2025,0
4786,-2276,-2192,1431.3,14313,16259,6.4,2,2,3,212,21.2,0,0,0,1,1,217,21.7,1,7,7,7,6.8,18451,16589,1658.9,2192,2276,0
4787,908,-79,1539.7,15397,17958,6.8,2,2,3,247,24.7,0,0,0,1,1,221,22.1,2,1,2,2,6.8,18037,14489,1448.9,79,-908,1
4788,1606,615,1627.5,16275,17390,6.8,7,7,9,224,22.4,0,0,1,0,0,208,20.8,0,4,4,4,6.4,16775,14669,1466.9,-615,-1606,1
4789,726,-455,1802.6,18026,17839,7.0,8,8,9,198,19.8,0,0,1,0,0,186,18.6,0,12,9,9,7.0,18294,17300,1730.0,455,-726,0
4790,-5048,-4231,1341.5,13415,16177,6.4,1,1,0,215,21.5,0,0,1,0,1,264,26.4,1,8,8,8,7.6,20408,18463,1846.3,4231,5048,0
4791,544,758,1663.5,16635,17795,7.0,7,7,7,215,21.5,1,1,0,1,0,194,19.4,0,10,7,7,6.6,17037,16091,1609.1,-758,-544,0
4792,-1313,-6,1411.4,14114,17618,6.8,1,1,2,229,22.9,0,0,0,1,1,250,25.0,2,5,3,3,6.8,17624,15427,1542.7,6,1313,0
4793,-33,-559,1597.5,15975,17545,6.6,5,5,2,222,22.2,2,1,0,1,0,214,21.4,0,7,6,6,7.0,18104,16008,1600.8,559,33,0
4794,-4405,-3304,1460.6,14606,16104,6.4,4,4,5,173,17.3,0,0,0,1,1,193,19.3,1,16,11,11,7.2,19408,19011,1901.1,3304,4405,0
4795,3440,2199,1913.4,19134,20399,7.6,10,10,13,227,22.7,1,1,0,1,0,209,20.9,0,4,5,5,6.8,18200,15694,1569.4,-2199,-3440,1
4796,-325,9,1520.9,15209,17965,7.0,3,3,3,201,20.1,0,0,1,0,0,246,24.6,0,6,3,3,7.0,17956,15534,1553.4,-9,325,0
4797,-1314,-1027,1651.2,16512,18547,7.4,6,6,9,207,20.7,1,0,1,0,1,246,24.6,1,10,7,7,7.2,19574,17826,1782.6,1027,1314,1
4798,-1724,-1515,1570.7,15707,16687,6.6,4,4,6,225,22.5,1,0,0,1,1,202,20.2,1,12,9,9,7.0,18202,17431,1743.1,1515,1724,0
4799,3854,2986,1788.6,17886,19530,7.4,10,10,9,224,22.4,1,1,0,1,0,193,19.3,0,2,3,3,6.6,16544,14032,1403.2,-2986,-3854,1
4800,234,-318,1562.0,15620,17974,7.0,4,4,3,225,22.5,1,1,1,0,0,227,22.7,0,4,4,4,7.0,18292,15386,1538.6,318,-234,1
4801,-4202,-3846,1627.5,16275,17526,7.0,5,5,5,199,19.9,1,1,1,0,0,248,24.8,0,9,15,15,7.8,21372,20477,2047.7,3846,4202,0
4802,832,-504,1730.8,17308,16585,6.8,9,9,10,209,20.9,1,0,0,1,1,183,18.3,1,6,9,9,6.6,17089,16476,1647.6,504,-832,1
4803,-1207,-1542,1387.5,13875,16214,6.4,2,2,1,212,21.2,0,0,0,1,0,227,22.7,0,3,3,3,7.0,17756,15082,1508.2,1542,1207,0
4804,4453,1296,2072.1,20721,18605,7.0,12,12,19,247,24.7,1,1,0,1,0,206,20.6,0,13,7,7,7.0,17309,16268,1626.8,-1296,-4453,1
4805,1306,1039,1695.5,16955,17434,6.8,8,8,9,191,19.1,1,1,1,0,0,200,20.0,0,2,4,4,6.6,16395,15649,1564.9,-1039,-1306,1
4806,-1063,-1027,1609.9,16099,17169,6.8,6,6,8,200,20.0,0,0,1,0,1,215,21.5,1,7,9,9,7.2,18196,17162,1716.2,1027,1063,0
4807,5148,2308,1956.9,19569,19298,7.2,13,13,13,203,20.3,1,0,1,0,1,179,17.9,1,2,4,4,6.8,16990,14421,1442.1,-2308,-5148,1
4808,4217,1384,2093.2,20932,19304,7.2,15,15,17,233,23.3,1,1,1,0,0,188,18.8,0,8,7,7,7.0,17920,16715,1671.5,-1384,-4217,1
4809,5372,4626,2098.3,20983,19590,7.2,17,17,17,220,22.0,2,1,1,0,0,156,15.6,0,8,7,7,6.4,14964,15611,1561.1,-4626,-5372,1
4810,-752,-1764,1587.1,15871,17242,6.8,4,4,6,224,22.4,0,0,1,0,1,228,22.8,2,4,6,6,7.0,19006,16623,1662.3,1764,752,0
4811,2161,1731,1793.8,17938,17865,6.8,10,10,11,219,21.9,0,0,1,0,1,195,19.5,1,6,7,7,6.2,16134,15777,1577.7,-1731,-2161,1
4812,7761,5818,2068.5,20685,21642,8.0,8,8,7,279,27.9,2,1,1,0,0,201,20.1,0,0,0,0,6.4,15824,12924,1292.4,-5818,-7761,1
4813,2647,3204,1804.5,18045,20275,7.4,11,11,8,227,22.7,1,0,1,0,0,203,20.3,0,10,6,6,6.6,17071,15398,1539.8,-3204,-2647,1
4814,986,1194,1698.5,16985,19175,7.0,7,7,7,241,24.1,2,1,0,1,0,267,26.7,0,5,4,4,7.0,17981,15999,1599.9,-1194,-986,1
4815,-2393,-1004,1410.6,14106,15716,6.2,3,3,2,200,20.0,1,0,0,1,1,186,18.6,1,6,6,6,6.4,16720,16499,1649.9,1004,2393,1
4816,-347,-1134,1547.4,15474,17407,6.8,3,3,3,203,20.3,1,1,1,0,0,224,22.4,0,5,3,3,7.2,18541,15821,1582.1,1134,347,0
4817,-435,574,1643.4,16434,18330,7.0,6,6,6,235,23.5,1,0,0,1,1,270,27.0,1,8,4,4,6.8,17756,16869,1686.9,-574,435,1
4818,-4790,-2126,1488.5,14885,17810,6.8,4,4,3,192,19.2,2,1,0,1,0,232,23.2,0,5,8,8,7.4,19936,19675,1967.5,2126,4790,0
4819,5525,3467,1952.7,19527,20653,7.6,11,11,9,237,23.7,1,1,1,0,0,211,21.1,0,1,2,2,6.8,17186,14002,1400.2,-3467,-5525,1
4820,17,-1180,1668.5,16685,17126,6.6,6,6,6,223,22.3,0,0,0,1,1,175,17.5,1,4,7,7,7.0,18306,16668,1666.8,1180,-17,0
4821,2782,4548,1986.8,19868,19587,7.0,14,14,16,201,20.1,1,0,0,1,1,157,15.7,1,18,11,11,6.4,15039,17086,1708.6,-4548,-2782,0
4822,-58,13,1601.7,16017,17022,6.8,9,9,10,182,18.2,0,0,0,1,1,228,22.8,1,3,7,7,6.8,17009,16075,1607.5,-13,58,0
4823,-2637,-1878,1355.7,13557,16944,6.6,0,0,0,213,21.3,0,0,0,1,1,248,24.8,1,8,5,5,6.8,18822,16194,1619.4,1878,2637,0
4824,3206,2261,1777.9,17779,20127,7.6,6,6,8,268,26.8,1,0,1,0,0,225,22.5,0,2,2,2,7.0,17866,14573,1457.3,-2261,-3206,1
4825,4531,2978,1913.3,19133,19406,7.2,14,14,19,200,20.0,1,1,0,1,0,211,21.1,0,3,2,2,6.6,16428,14602,1460.2,-2978,-4531,1
4826,-2083,-2549,1430.4,14304,15110,6.0,3,3,3,199,19.9,1,1,1,0,0,236,23.6,0,5,3,3,6.8,17659,16387,1638.7,2549,2083,0
4827,-1327,-825,1433.9,14339,17922,6.8,1,1,0,234,23.4,0,0,0,1,1,241,24.1,1,5,3,3,7.2,18747,15666,1566.6,825,1327,1
4828,359,-1714,1710.1,17101,16986,6.8,9,9,12,194,19.4,1,1,1,0,0,197,19.7,0,7,9,9,7.0,18700,16742,1674.2,1714,-359,1
4829,-2272,-2782,1473.1,14731,16242,6.6,3,3,4,223,22.3,1,0,1,0,1,220,22.0,1,7,5,5,7.2,19024,17003,1700.3,2782,2272,1
4830,-680,-703,1776.6,17766,18700,7.2,8,8,10,229,22.9,1,1,1,0,0,243,24.3,0,12,10,10,7.0,19403,18446,1844.6,703,680,1
4831,482,-670,1674.7,16747,18330,7.0,7,7,7,202,20.2,1,1,1,0,0,225,22.5,0,2,5,5,7.2,19000,16265,1626.5,670,-482,0
4832,-3268,-4457,1607.4,16074,16408,6.8,7,7,5,185,18.5,2,1,1,0,0,206,20.6,0,10,12,12,7.6,20865,19342,1934.2,4457,3268,0
4833,1902,967,1748.8,17488,18635,7.2,7,7,7,220,22.0,1,1,1,0,0,193,19.3,0,6,5,5,7.0,17668,15586,1558.6,-967,-1902,1
4834,-3784,-4019,1269.8,12698,15550,6.2,0,0,0,195,19.5,0,0,0,1,1,222,22.2,1,11,6,6,7.4,19569,16482,1648.2,4019,3784,0
4835,2474,2494,1726.4,17264,19660,7.4,10,10,10,230,23.0,0,0,0,1,0,230,23.0,0,2,3,3,6.8,17166,14790,1479.0,-2494,-2474,1
4836,-3678,-3234,1451.6,14516,17011,6.6,2,2,5,218,21.8,0,0,1,0,1,246,24.6,1,12,11,11,7.6,20245,18194,1819.4,3234,3678,0
4837,2537,1833,1766.6,17666,19438,7.4,8,8,11,241,24.1,0,0,1,0,1,234,23.4,1,2,2,2,7.0,17605,15129,1512.9,-1833,-2537,0
4838,1490,1461,1652.1,16521,17693,7.0,6,6,8,203,20.3,1,1,1,0,0,216,21.6,0,6,4,4,6.4,16232,15031,1503.1,-1461,-1490,1
4839,-3840,-2835,1588.0,15880,17975,6.8,5,5,5,199,19.9,1,1,0,1,0,239,23.9,1,11,9,9,7.6,20810,19720,1972.0,2835,3840,0
4840,1377,-673,1702.0,17020,17178,6.8,9,9,12,185,18.5,1,1,1,0,0,232,23.2,0,2,3,3,7.0,17851,15643,1564.3,673,-1377,1
4841,4957,4440,1802.1,18021,19353,7.2,7,7,9,246,24.6,1,1,1,0,0,182,18.2,0,2,2,2,6.4,14913,13064,1306.4,-4440,-4957,1
4842,-1337,-1106,1633.4,16334,18034,7.0,5,5,8,245,24.5,0,0,0,1,1,245,24.5,2,9,7,7,7.2,19140,17671,1767.1,1106,1337,0
4843,-2871,-2427,1397.9,13979,16912,6.6,2,2,1,203,20.3,0,0,0,1,1,243,24.3,1,4,6,6,7.4,19339,16850,1685.0,2427,2871,1
4844,-1271,-366,1500.6,15006,18694,7.0,3,3,3,230,23.0,0,0,0,1,0,264,26.4,0,3,3,3,7.2,19060,16277,1627.7,366,1271,0
4845,-1163,-19,1569.6,15696,18895,7.2,2,2,5,243,24.3,0,0,0,1,0,246,24.6,1,7,5,5,7.2,18914,16859,1685.9,19,1163,1
4846,-833,-932,1594.6,15946,16836,6.8,7,7,7,170,17.0,0,0,1,0,0,230,23.0,1,10,9,9,7.0,17768,16779,1677.9,932,833,0
4847,-2686,-2037,1554.8,15548,17564,6.8,3,3,3,215,21.5,0,0,0,1,1,212,21.2,1,15,10,10,7.4,19601,18234,1823.4,2037,2686,0
4848,486,865,1594.2,15942,19003,7.2,4,4,5,232,23.2,1,1,1,0,0,242,24.2,0,2,1,1,7.0,18138,15456,1545.6,-865,-486,1
4849,1441,473,1572.7,15727,18760,7.4,4,4,1,264,26.4,0,0,1,0,0,211,21.1,0,0,2,2,7.0,18287,14286,1428.6,-473,-1441,1
4850,192,-1496,1677.2,16772,16548,6.4,7,7,10,228,22.8,0,0,0,1,1,234,23.4,2,5,5,5,6.8,18044,16580,1658.0,1496,-192,0
4851,3462,2960,1782.0,17820,20320,7.6,7,7,6,234,23.4,1,0,0,1,1,205,20.5,1,1,1,1,6.8,17360,14358,1435.8,-2960,-3462,0
4852,-892,-255,1644.0,16440,17567,6.8,5,5,6,238,23.8,0,0,1,0,1,206,20.6,1,14,8,8,7.0,17822,17332,1733.2,255,892,0
4853,3290,1398,1989.0,19890,18304,6.8,10,10,15,214,21.4,2,1,1,0,0,214,21.4,0,7,6,6,6.6,16906,16600,1660.0,-1398,-3290,1
4854,254,140,1593.6,15936,18595,7.0,5,5,4,234,23.4,0,0,0,1,1,205,20.5,1,2,4,4,7.0,18455,15682,1568.2,-140,-254,1
4855,-1823,-2149,1606.5,16065,17606,7.0,6,6,8,193,19.3,0,0,0,1,1,234,23.4,1,7,8,8,7.4,19755,17888,1788.8,2149,1823,0
4856,962,-1646,1638.5,16385,17307,6.6,3,3,3,215,21.5,1,0,1,0,1,261,26.1,1,3,2,2,7.0,18953,15423,1542.3,1646,-962,1
4857,-2478,-2136,1531.5,15315,17144,6.8,3,3,4,210,21.0,1,1,1,0,0,231,23.1,0,7,7,7,7.2,19280,17793,1779.3,2136,2478,0
4858,-99,727,1561.0,15610,19049,7.2,3,3,3,246,24.6,0,0,0,1,0,234,23.4,0,7,5,5,6.8,18322,15709,1570.9,-727,99,1
4859,-2003,-1611,1465.0,14650,16684,6.8,3,3,3,192,19.2,0,0,1,0,0,195,19.5,0,11,8,8,7.0,18295,16653,1665.3,1611,2003,1
4860,316,-597,1620.9,16209,18146,7.0,4,4,4,254,25.4,1,0,1,0,1,237,23.7,1,4,4,4,7.0,18743,15893,1589.3,597,-316,0
4861,-908,-1806,1625.4,16254,17374,6.8,7,7,6,200,20.0,0,0,1,0,0,227,22.7,0,8,6,6,7.2,19180,17162,1716.2,1806,908,0
4862,-1943,-1582,1588.1,15881,17927,6.8,5,5,7,214,21.4,0,0,0,1,1,216,21.6,1,7,11,11,7.2,19509,17824,1782.4,1582,1943,0
4863,-1548,-1988,1755.4,17554,16706,6.6,8,8,11,227,22.7,0,0,0,1,1,225,22.5,2,13,11,11,7.0,18694,19102,1910.2,1988,1548,1
4864,-1966,-3591,1432.9,14329,16330,6.6,2,2,2,211,21.1,0,0,0,1,1,217,21.7,1,1,7,7,7.2,19921,16295,1629.5,3591,1966,0
4865,-169,282,1571.2,15712,17969,6.8,5,5,4,221,22.1,1,1,0,1,0,235,23.5,0,4,4,4,6.8,17687,15881,1588.1,-282,169,1
4866,-1587,-1578,1612.1,16121,16956,6.6,4,4,9,169,16.9,0,0,0,1,1,221,22.1,1,12,11,11,6.8,18534,17708,1770.8,1578,1587,0
4867,-355,-400,1447.1,14471,17810,6.8,1,1,1,241,24.1,1,1,0,1,0,232,23.2,0,2,2,2,7.2,18210,14826,1482.6,400,355,0
4868,-1576,-1720,1479.7,14797,16703,6.6,5,5,5,195,19.5,0,0,1,0,1,259,25.9,1,2,4,4,6.8,18423,16373,1637.3,1720,1576,1
4869,482,-2053,1569.2,15692,16690,6.4,5,5,9,206,20.6,0,0,1,0,0,235,23.5,1,2,3,3,7.2,18743,15210,1521.0,2053,-482,0
4870,938,181,1827.1,18271,19689,7.4,8,8,7,223,22.3,1,1,1,0,0,204,20.4,1,6,7,7,7.2,19508,17333,1733.3,-181,-938,1
4871,-360,331,1492.8,14928,18640,7.0,1,1,0,229,22.9,0,0,0,1,1,213,21.3,1,2,4,4,7.0,18309,15288,1528.8,-331,360,0
4872,-1973,-1497,1583.5,15835,17352,6.8,6,6,13,217,21.7,0,0,1,0,0,236,23.6,0,8,8,8,7.2,18849,17808,1780.8,1497,1973,1
4873,4864,1938,1959.8,19598,18704,7.0,10,10,10,242,24.2,1,0,1,0,0,204,20.4,0,5,4,4,6.8,16766,14734,1473.4,-1938,-4864,1
4874,2543,965,1666.4,16664,18875,7.2,7,7,9,244,24.4,1,1,0,1,0,204,20.4,0,0,2,2,7.0,17910,14121,1412.1,-965,-2543,1
4875,-2296,-1677,1582.6,15826,17062,7.0,6,6,6,196,19.6,1,0,1,0,1,243,24.3,1,9,10,10,6.8,18739,18122,1812.2,1677,2296,1
4876,954,570,1651.7,16517,18263,7.0,6,6,7,216,21.6,0,0,1,0,1,216,21.6,1,5,4,4,6.6,17693,15563,1556.3,-570,-954,0
4877,1063,-391,1688.8,16888,18334,7.2,5,5,5,225,22.5,1,0,0,1,1,231,23.1,1,2,4,4,7.0,18725,15825,1582.5,391,-1063,0
4878,7404,5156,2187.2,21872,19671,7.2,13,13,19,225,22.5,1,1,1,0,0,169,16.9,0,3,3,3,6.2,14515,14468,1446.8,-5156,-7404,1
4879,3642,3850,1782.8,17828,19155,7.2,8,8,7,242,24.2,1,1,1,0,0,179,17.9,0,3,3,3,6.2,15305,14186,1418.6,-3850,-3642,1
4880,-847,11,1653.5,16535,17913,6.8,6,6,11,199,19.9,0,0,1,0,1,227,22.7,1,10,7,7,6.8,17902,17382,1738.2,-11,847,1
4881,376,-194,1619.4,16194,17871,6.8,4,4,4,238,23.8,0,0,0,1,1,215,21.5,2,10,5,5,7.0,18065,15818,1581.8,194,-376,1
4882,-1469,116,1530.4,15304,17175,6.6,5,5,2,195,19.5,2,1,1,0,0,238,23.8,0,8,6,6,6.8,17059,16773,1677.3,-116,1469,0
4883,1295,-80,1493.1,14931,17257,6.6,2,2,4,215,21.5,1,0,1,0,1,230,23.0,1,0,0,0,7.0,17337,13636,1363.6,80,-1295,0
4884,-1243,-1229,1517.5,15175,16256,6.4,5,5,7,170,17.0,0,0,0,1,1,219,21.9,1,6,7,7,6.8,17485,16418,1641.8,1229,1243,0
4885,-3426,-2754,1508.9,15089,17882,7.2,4,4,4,219,21.9,1,1,0,1,0,227,22.7,0,15,11,11,7.6,20636,18515,1851.5,2754,3426,1
4886,2455,1940,1905.7,19057,19088,7.0,11,11,12,236,23.6,0,0,1,0,0,226,22.6,0,10,5,5,6.8,17148,16602,1660.2,-1940,-2455,1
4887,1926,2119,1719.8,17198,19868,7.4,7,7,10,233,23.3,0,0,0,1,0,219,21.9,0,2,2,2,6.8,17749,15272,1527.2,-2119,-1926,1
4888,-2865,-1866,1420.6,14206,17591,7.0,2,2,4,210,21.0,1,1,0,1,0,248,24.8,0,7,7,7,7.2,19457,17071,1707.1,1866,2865,0
4889,-1154,-1629,1530.3,15303,16803,6.6,6,6,9,209,20.9,1,1,1,0,0,207,20.7,0,8,7,7,7.0,18432,16457,1645.7,1629,1154,0
4890,-1860,-720,1525.7,15257,16021,6.4,7,7,6,191,19.1,0,0,0,1,1,211,21.1,1,9,8,8,6.6,16741,17117,1711.7,720,1860,1
4891,2331,25,1764.3,17643,17308,6.6,8,8,9,226,22.6,1,1,1,0,0,193,19.3,0,4,5,5,6.8,17283,15312,1531.2,-25,-2331,1
4892,-444,-877,1464.9,14649,17790,7.0,1,1,2,229,22.9,0,0,0,1,0,247,24.7,1,1,1,1,7.0,18667,15093,1509.3,877,444,1
4893,-3014,-357,1510.1,15101,16888,6.4,5,5,3,187,18.7,1,1,0,1,0,252,25.2,0,13,9,9,6.6,17245,18115,1811.5,357,3014,0
4894,4377,1719,1828.8,18288,18800,7.2,8,8,8,223,22.3,0,0,1,0,0,220,22.0,0,0,2,2,6.8,17081,13911,1391.1,-1719,-4377,1
4895,2030,1411,1735.7,17357,20069,7.4,6,6,9,236,23.6,0,0,1,0,0,252,25.2,0,2,1,1,7.0,18658,15327,1532.7,-1411,-2030,1
4896,884,1028,1610.1,16101,19176,7.4,4,4,3,266,26.6,0,0,0,1,1,236,23.6,1,3,3,3,7.0,18148,15217,1521.7,-1028,-884,1
4897,-1406,-1006,1686.4,16864,18758,7.0,6,6,5,219,21.9,0,0,0,1,0,195,19.5,0,12,11,11,7.2,19764,18270,1827.0,1006,1406,0
4898,-4259,-4262,1447.0,14470,15760,6.6,5,5,3,175,17.5,0,0,0,1,1,246,24.6,1,9,9,9,7.4,20022,18729,1872.9,4262,4259,0
4899,3909,1938,1802.7,18027,19090,7.2,6,6,8,252,25.2,1,1,1,0,0,219,21.9,0,1,2,2,6.6,17152,14118,1411.8,-1938,-3909,1
4900,2339,625,1892.0,18920,19580,7.4,9,9,12,238,23.8,1,1,1,0,0,220,22.0,0,5,7,7,7.0,18955,16581,1658.1,-625,-2339,1
4901,-1187,-714,1552.1,15521,16916,6.6,3,3,5,202,20.2,1,0,0,1,1,219,21.9,1,6,6,6,7.0,17630,16708,1670.8,714,1187,0
4902,-1314,-566,1557.9,15579,16638,6.8,6,6,10,198,19.8,0,0,1,0,1,215,21.5,1,8,8,8,6.8,17204,16893,1689.3,566,1314,1
4903,123,1313,1860.2,18602,20068,7.4,10,10,8,200,20.0,0,0,1,0,0,226,22.6,1,6,8,8,7.2,18755,18479,1847.9,-1313,-123,1
4904,-2964,-2587,1532.5,15325,16317,6.6,6,6,9,192,19.2,0,0,0,1,1,208,20.8,2,12,10,10,7.2,18904,18289,1828.9,2587,2964,0
4905,-7089,-2815,1516.1,15161,16945,6.6,4,4,3,196,19.6,0,0,0,1,0,237,23.7,0,13,13,13,7.2,19760,22250,2225.0,2815,7089,0
4906,2534,1730,1781.8,17818,19558,7.2,8,8,10,238,23.8,0,0,1,0,0,223,22.3,0,2,3,3,7.0,17828,15284,1528.4,-1730,-2534,0
4907,-6966,-4723,1406.6,14066,16007,6.4,3,3,2,178,17.8,0,0,0,1,0,246,24.6,1,12,13,13,7.6,20730,21032,2103.2,4723,6966,0
4908,-3283,-582,1614.3,16143,17759,6.6,5,5,3,212,21.2,0,0,0,1,0,194,19.4,0,8,12,12,6.8,18341,19426,1942.6,582,3283,0
4909,-3460,-2389,1543.1,15431,17705,7.0,4,4,3,214,21.4,0,0,1,0,1,233,23.3,1,10,11,11,7.6,20094,18891,1889.1,2389,3460,0
4910,10,223,1681.5,16815,18326,7.0,8,8,5,207,20.7,1,0,1,0,0,241,24.1,0,8,7,7,6.8,18103,16805,1680.5,-223,-10,0
4911,2207,2836,1706.0,17060,19600,7.2,7,7,5,242,24.2,1,0,0,1,1,219,21.9,1,3,3,3,6.6,16764,14853,1485.3,-2836,-2207,1
4912,-2310,-1604,1534.1,15341,17802,6.8,4,4,3,204,20.4,0,0,0,1,1,220,22.0,1,11,10,10,7.2,19406,17651,1765.1,1604,2310,0
4913,1456,1433,1701.2,17012,19316,7.2,7,7,9,230,23.0,2,1,1,0,0,220,22.0,0,4,4,4,7.0,17883,15556,1555.6,-1433,-1456,0
4914,1446,-1351,1780.5,17805,17597,7.0,6,6,4,218,21.8,1,0,1,0,1,212,21.2,1,9,7,7,7.0,18948,16359,1635.9,1351,-1446,1
4915,-4561,-1835,1642.5,16425,17934,6.8,6,6,2,205,20.5,0,0,0,1,1,271,27.1,1,16,12,12,7.6,19769,20986,2098.6,1835,4561,0
4916,-612,-1019,1780.4,17804,16151,6.6,12,12,12,168,16.8,1,1,1,0,0,171,17.1,0,13,10,10,6.6,17170,18416,1841.6,1019,612,0
4917,-1979,-338,1444.9,14449,16336,6.4,2,2,1,220,22.0,0,0,0,1,1,186,18.6,1,8,5,5,6.8,16674,16428,1642.8,338,1979,0
4918,1484,-24,1768.7,17687,18169,7.0,10,10,15,203,20.3,0,0,1,0,0,216,21.6,0,8,6,6,7.2,18193,16203,1620.3,24,-1484,1
4919,3252,2304,1847.1,18471,19497,7.4,9,9,8,225,22.5,0,0,1,0,1,201,20.1,1,3,4,4,6.8,17193,15219,1521.9,-2304,-3252,0
4920,-1051,753,1624.5,16245,17547,7.0,5,5,5,206,20.6,1,1,0,1,0,206,20.6,0,11,8,8,6.8,16794,17296,1729.6,-753,1051,1
4921,-2018,-1345,1505.4,15054,16819,6.4,6,6,2,209,20.9,1,1,0,1,0,169,16.9,0,14,9,9,7.2,18164,17072,1707.2,1345,2018,1
4922,1462,1290,1721.6,17216,17264,6.6,9,9,10,207,20.7,0,0,1,0,0,165,16.5,0,9,8,8,6.4,15974,15754,1575.4,-1290,-1462,1
4923,-3401,-2179,1499.7,14997,17191,6.8,4,4,2,218,21.8,0,0,0,1,1,219,21.9,2,15,12,12,7.4,19370,18398,1839.8,2179,3401,1
4924,-1645,-1076,1480.4,14804,17613,7.0,2,2,1,239,23.9,0,0,0,1,1,245,24.5,1,7,6,6,6.8,18689,16449,1644.9,1076,1645,1
4925,929,1095,1564.5,15645,18594,7.2,4,4,3,227,22.7,1,0,1,0,1,205,20.5,1,2,3,3,6.6,17499,14716,1471.6,-1095,-929,0
4926,-2450,-1150,1536.5,15365,17435,6.8,3,3,3,221,22.1,0,0,0,1,0,233,23.3,0,12,9,9,7.2,18585,17815,1781.5,1150,2450,0
4927,-293,-1855,1752.4,17524,16577,6.8,8,8,11,209,20.9,0,0,1,0,1,211,21.1,1,11,10,10,7.2,18432,17817,1781.7,1855,293,0
4928,4545,3714,1832.4,18324,19267,7.4,10,10,9,199,19.9,0,0,1,0,0,195,19.5,0,1,1,1,6.2,15553,13779,1377.9,-3714,-4545,1
4929,597,875,1714.0,17140,18226,6.8,7,7,9,221,22.1,2,1,1,0,0,226,22.6,0,7,6,6,6.8,17351,16543,1654.3,-875,-597,1
4930,1975,969,1775.6,17756,18384,7.0,9,9,9,211,21.1,0,0,1,0,0,210,21.0,0,4,7,7,6.6,17415,15781,1578.1,-969,-1975,1
4931,1693,1287,1909.4,19094,19076,7.2,14,14,12,196,19.6,1,1,0,1,0,214,21.4,0,6,8,8,6.8,17789,17401,1740.1,-1287,-1693,0
4932,-985,-93,1596.3,15963,18713,7.2,5,5,5,218,21.8,1,0,0,1,1,262,26.2,1,5,5,5,7.2,18806,16948,1694.8,93,985,0
4933,7427,6558,2126.6,21266,19884,7.4,14,14,10,231,23.1,2,1,1,0,0,129,12.9,0,3,5,5,5.6,13326,13839,1383.9,-6558,-7427,1
4934,1018,1319,1769.2,17692,18587,7.2,10,10,10,203,20.3,0,0,1,0,1,201,20.1,1,10,8,8,6.8,17268,16674,1667.4,-1319,-1018,1
4935,-1857,-1976,1456.2,14562,15997,6.2,4,4,4,206,20.6,1,1,0,1,0,214,21.4,0,6,7,7,7.0,17973,16419,1641.9,1976,1857,0
4936,-3438,-2574,1588.1,15881,16662,6.6,5,5,5,215,21.5,0,0,0,1,1,222,22.2,1,9,13,13,7.2,19236,19319,1931.9,2574,3438,0
4937,1579,578,1764.9,17649,17906,7.0,9,9,9,207,20.7,0,0,1,0,0,209,20.9,0,8,8,8,6.8,17328,16070,1607.0,-578,-1579,0
4938,-3071,-2267,1435.8,14358,16468,6.6,1,1,1,203,20.3,1,1,0,1,0,242,24.2,1,2,5,5,7.0,18735,17429,1742.9,2267,3071,0
4939,1042,-31,1782.8,17828,18836,7.0,8,8,10,229,22.9,0,0,1,0,0,231,23.1,0,3,6,6,7.0,18867,16786,1678.6,31,-1042,0
4940,1871,2897,1749.5,17495,19387,7.4,9,9,10,178,17.8,0,0,1,0,0,227,22.7,0,3,4,4,6.6,16490,15624,1562.4,-2897,-1871,1
4941,-546,1078,1551.9,15519,18382,7.0,3,3,2,256,25.6,0,0,0,1,1,227,22.7,1,6,4,4,6.8,17304,16065,1606.5,-1078,546,0
4942,-528,-1130,1536.5,15365,17502,6.8,3,3,3,250,25.0,0,0,1,0,1,259,25.9,1,4,3,3,7.0,18632,15893,1589.3,1130,528,0
4943,-1780,-1378,1558.2,15582,16182,6.6,6,6,9,190,19.0,0,0,0,1,0,229,22.9,1,7,8,8,7.0,17560,17362,1736.2,1378,1780,0
4944,-387,-725,1505.4,15054,16861,6.6,4,4,5,223,22.3,1,1,1,0,0,210,21.0,0,5,3,3,6.6,17586,15441,1544.1,725,387,0
4945,-2077,-2457,1505.2,15052,16956,6.6,3,3,5,204,20.4,0,0,0,1,1,242,24.2,1,5,7,7,7.2,19413,17129,1712.9,2457,2077,0
4946,-1690,-2943,1560.8,15608,16536,6.6,4,4,4,197,19.7,0,0,0,1,0,220,22.0,0,8,9,9,7.2,19479,17298,1729.8,2943,1690,0
4947,-987,-741,1657.8,16578,18186,6.8,7,7,7,220,22.0,2,1,1,0,0,206,20.6,0,9,9,9,7.4,18927,17565,1756.5,741,987,1
4948,-2902,-1196,1636.1,16361,17937,6.8,4,4,3,225,22.5,0,0,0,1,1,231,23.1,1,16,12,12,7.2,19133,19263,1926.3,1196,2902,1
4949,-2923,-1079,1470.9,14709,16206,6.4,4,4,3,209,20.9,0,0,0,1,1,232,23.2,2,12,10,10,6.8,17285,17632,1763.2,1079,2923,1
4950,1495,-413,1745.7,17457,18205,7.0,5,5,4,225,22.5,1,1,1,0,0,248,24.8,0,3,4,4,6.8,18618,15962,1596.2,413,-1495,0
4951,-4927,-3950,1417.9,14179,16052,6.4,3,3,3,205,20.5,0,0,0,1,1,230,23.0,1,11,11,11,7.6,20002,19106,1910.6,3950,4927,0
4952,-18,252,1629.4,16294,18342,6.8,7,7,8,214,21.4,0,0,0,1,0,229,22.9,0,4,5,5,7.0,18090,16312,1631.2,-252,18,1
4953,-1045,406,1539.2,15392,18126,7.0,2,2,2,238,23.8,0,0,0,1,1,205,20.5,2,7,6,6,6.8,17720,16437,1643.7,-406,1045,0
4954,-2212,-1548,1553.4,15534,16209,6.6,5,5,4,204,20.4,1,1,1,0,0,215,21.5,0,8,9,9,6.8,17757,17746,1774.6,1548,2212,0
4955,1323,1994,1746.2,17462,18011,7.0,7,7,6,210,21.0,0,0,1,0,0,215,21.5,0,8,6,6,6.4,16017,16139,1613.9,-1994,-1323,1
4956,-220,1427,1734.6,17346,19356,7.4,9,9,6,197,19.7,0,0,0,1,0,186,18.6,0,9,10,10,7.2,17929,17566,1756.6,-1427,220,0
4957,2086,1397,1624.8,16248,18185,7.0,3,3,3,239,23.9,0,0,1,0,1,241,24.1,1,0,0,0,6.6,16788,14162,1416.2,-1397,-2086,1
4958,-828,421,1521.8,15218,16539,6.4,5,5,4,211,21.1,0,0,1,0,0,206,20.6,0,10,6,6,6.6,16118,16046,1604.6,-421,828,1
4959,4227,3892,2032.9,20329,20692,7.6,13,13,13,264,26.4,0,0,1,0,0,174,17.4,0,7,6,6,6.6,16800,16102,1610.2,-3892,-4227,1
4960,1177,-691,1723.5,17235,17249,6.8,9,9,13,196,19.6,1,1,0,1,0,232,23.2,0,7,6,6,6.8,17940,16058,1605.8,691,-1177,0
4961,263,342,1743.3,17433,17931,6.8,6,6,4,221,22.1,2,1,0,1,0,206,20.6,0,9,7,7,7.0,17589,17170,1717.0,-342,-263,0
4962,-816,-27,1548.0,15480,19018,7.0,3,3,5,243,24.3,0,0,0,1,1,278,27.8,1,3,3,3,7.0,19045,16296,1629.6,27,816,0
4963,1097,1914,1785.0,17850,19943,7.2,8,8,6,238,23.8,1,1,1,0,0,224,22.4,0,6,7,7,7.0,18029,16753,1675.3,-1914,-1097,1
4964,1057,1295,1659.0,16590,19121,7.0,7,7,7,210,21.0,0,0,1,0,1,227,22.7,1,5,5,5,7.0,17826,15533,1553.3,-1295,-1057,1
4965,145,-1102,1770.6,17706,18096,7.0,10,10,12,214,21.4,2,1,1,0,0,221,22.1,0,8,6,6,7.0,19198,17561,1756.1,1102,-145,1
4966,3559,2227,1897.2,18972,19388,7.2,10,10,11,231,23.1,1,0,0,1,0,189,18.9,0,4,5,5,6.6,17161,15413,1541.3,-2227,-3559,1
4967,-1726,-267,1653.0,16530,18808,7.0,6,6,8,205,20.5,0,0,0,1,1,238,23.8,1,12,10,10,7.0,19075,18256,1825.6,267,1726,0
4968,-626,895,1491.1,14911,18362,6.8,1,1,1,238,23.8,1,1,0,1,0,230,23.0,0,4,4,4,6.8,17467,15537,1553.7,-895,626,1
4969,6529,4484,2054.3,20543,20964,7.6,11,11,7,233,23.3,1,1,1,0,0,161,16.1,0,2,4,4,6.8,16480,14014,1401.4,-4484,-6529,1
4970,7370,5454,2143.7,21437,20067,7.2,12,12,16,229,22.9,2,1,1,0,0,133,13.3,0,11,6,6,5.8,14613,14067,1406.7,-5454,-7370,1
4971,-419,-428,1518.5,15185,18437,6.8,2,2,2,231,23.1,1,1,1,0,0,241,24.1,1,2,3,3,7.0,18865,15604,1560.4,428,419,1
4972,-701,346,1527.5,15275,17812,6.8,3,3,3,217,21.7,0,0,0,1,1,214,21.4,1,5,3,3,6.8,17466,15976,1597.6,-346,701,0
4973,4279,1907,1858.1,18581,17855,6.8,9,9,12,229,22.9,1,1,1,0,0,239,23.9,0,3,2,2,6.4,15948,14302,1430.2,-1907,-4279,1
4974,-164,851,1707.2,17072,18825,7.2,8,8,11,205,20.5,1,1,1,0,0,244,24.4,1,8,6,6,7.0,17974,17236,1723.6,-851,164,1
4975,-882,-1760,1575.8,15758,16364,6.4,5,5,10,190,19.0,1,1,1,0,0,253,25.3,0,5,6,6,7.0,18124,16640,1664.0,1760,882,0
4976,-2283,-1969,1514.4,15144,17285,6.8,3,3,5,224,22.4,0,0,0,1,1,259,25.9,1,9,7,7,7.2,19254,17427,1742.7,1969,2283,0
4977,-896,-1292,1574.2,15742,18562,7.2,4,4,4,244,24.4,1,1,0,1,0,252,25.2,0,4,4,4,7.4,19854,16638,1663.8,1292,896,1
4978,-3312,-3119,1516.1,15161,16711,6.6,6,6,6,187,18.7,0,0,1,0,0,223,22.3,1,11,10,10,7.4,19830,18473,1847.3,3119,3312,0
4979,-505,-580,1655.4,16554,18076,6.8,5,5,3,216,21.6,0,0,0,1,0,193,19.3,1,13,8,8,7.0,18656,17059,1705.9,580,505,0
4980,-3388,-3025,1438.4,14384,15955,6.2,3,3,4,199,19.9,1,1,0,1,0,256,25.6,0,9,7,7,7.2,18980,17772,1777.2,3025,3388,0
4981,1100,170,1718.3,17183,17906,7.0,10,10,8,208,20.8,0,0,1,0,1,166,16.6,1,5,7,7,7.0,17736,16083,1608.3,-170,-1100,1
4982,-1995,-1194,1516.5,15165,17462,6.8,3,3,3,218,21.8,0,0,1,0,0,251,25.1,0,13,6,6,7.2,18656,17160,1716.0,1194,1995,0
4983,-1391,-16,1674.7,16747,18099,6.8,6,6,5,214,21.4,0,0,0,1,1,189,18.9,1,12,10,10,6.8,18115,18138,1813.8,16,1391,1
4984,-810,-730,1662.5,16625,18202,7.2,6,6,5,226,22.6,0,0,1,0,0,234,23.4,0,9,8,8,7.4,18932,17435,1743.5,730,810,0
4985,-1769,-1859,1573.8,15738,16964,6.8,5,5,5,215,21.5,0,0,0,1,1,185,18.5,1,15,8,8,7.2,18823,17507,1750.7,1859,1769,0
4986,1165,744,1632.6,16326,18447,7.0,6,6,7,232,23.2,2,1,0,1,0,231,23.1,0,3,3,3,7.0,17703,15161,1516.1,-744,-1165,0
4987,-2564,-35,1533.4,15334,18085,7.0,5,5,2,204,20.4,0,0,0,1,0,227,22.7,0,12,8,8,7.0,18120,17898,1789.8,35,2564,0
4988,479,-658,1849.0,18490,16745,6.8,9,9,7,215,21.5,1,0,1,0,1,230,23.0,1,15,8,8,6.8,17403,18011,1801.1,658,-479,0
4989,-2118,-2048,1554.2,15542,16959,6.6,5,5,5,188,18.8,0,0,1,0,1,238,23.8,1,8,8,8,7.2,19007,17660,1766.0,2048,2118,0
4990,-729,-900,1540.9,15409,17883,6.8,3,3,2,240,24.0,0,0,1,0,0,250,25.0,0,4,4,4,7.0,18783,16138,1613.8,900,729,0
4991,-3719,-3695,1620.5,16205,15951,6.4,6,6,9,171,17.1,0,0,1,0,1,216,21.6,1,14,15,15,7.4,19646,19924,1992.4,3695,3719,0
4992,-52,-301,1683.6,16836,17998,6.8,8,8,8,228,22.8,1,0,0,1,0,186,18.6,0,12,8,8,7.0,18299,16888,1688.8,301,52,1
4993,9,-172,1486.2,14862,18359,7.0,1,1,1,237,23.7,1,1,0,1,0,199,19.9,1,2,2,2,7.2,18531,14853,1485.3,172,-9,1
4994,523,-69,1797.1,17971,19666,7.0,8,8,11,209,20.9,1,1,1,0,0,237,23.7,0,9,7,7,7.2,19735,17448,1744.8,69,-523,1
4995,673,1681,1568.9,15689,18377,7.0,4,4,8,211,21.1,1,1,0,1,0,210,21.0,0,5,4,4,6.6,16696,15016,1501.6,-1681,-673,1
4996,926,328,1575.1,15751,17685,6.8,3,3,2,252,25.2,0,0,0,1,0,215,21.5,0,3,3,3,6.8,17357,14825,1482.5,-328,-926,1
4997,-400,-1684,1753.5,17535,17282,6.8,11,11,11,200,20.0,0,0,1,0,1,211,21.1,1,9,10,10,7.2,18966,17935,1793.5,1684,400,0
4998,1783,1420,1641.9,16419,19867,7.0,3,3,5,276,27.6,0,0,1,0,1,257,25.7,1,0,0,0,6.8,18447,14636,1463.6,-1420,-1783,1
4999,-1752,-1746,1375.7,13757,16461,6.4,2,2,4,220,22.0,0,0,0,1,0,238,23.8,0,6,3,3,7.2,18207,15509,1550.9,1746,1752,1
5000,3517,2881,1849.1,18491,19416,7.2,10,10,12,237,23.7,1,1,0,1,0,211,21.1,0,4,4,4,6.8,16535,14974,1497.4,-2881,-3517,1
5001,-680,410,1553.6,15536,17282,6.6,4,4,7,190,19.0,0,0,0,1,1,215,21.5,1,8,4,4,6.6,16872,16216,1621.6,-410,680,1
5002,3021,2386,1681.7,16817,19506,7.2,7,7,3,237,23.7,2,1,1,0,0,214,21.4,0,0,1,1,6.8,17120,13796,1379.6,-2386,-3021,1
5003,-73,333,1668.3,16683,18169,7.0,6,6,5,213,21.3,2,1,1,0,0,213,21.3,0,11,7,7,6.8,17836,16756,1675.6,-333,73,1
5004,1577,-50,1716.1,17161,18145,7.2,8,8,10,206,20.6,1,1,1,0,0,214,21.4,0,2,4,4,7.0,18195,15584,1558.4,50,-1577,0
5005,-2116,-2156,1481.5,14815,17728,7.0,2,2,1,226,22.6,0,0,0,1,0,237,23.7,1,6,5,5,7.2,19884,16931,1693.1,2156,2116,0
5006,2575,1454,1818.0,18180,18464,7.0,11,11,11,190,19.0,0,0,1,0,1,203,20.3,1,6,5,5,6.6,17010,15605,1560.5,-1454,-2575,1
5007,1886,1688,1699.3,16993,19908,7.4,6,6,6,230,23.0,0,0,1,0,0,230,23.0,0,4,3,3,7.0,18220,15107,1510.7,-1688,-1886,0
5008,-4659,-3268,1402.3,14023,15096,6.4,2,2,4,187,18.7,0,0,0,1,1,225,22.5,1,18,11,11,7.2,18364,18682,1868.2,3268,4659,0
5009,-862,-406,1625.6,16256,17771,6.8,5,5,2,247,24.7,0,0,0,1,1,200,20.0,1,10,7,7,7.0,18177,17118,1711.8,406,862,1
5010,-360,-1748,1446.2,14462,15785,6.6,3,3,4,197,19.7,0,0,0,1,0,209,20.9,1,2,3,3,6.8,17533,14822,1482.2,1748,360,0
5011,460,-1107,1582.5,15825,17561,6.8,4,4,5,225,22.5,2,1,1,0,0,218,21.8,0,3,5,5,7.0,18668,15365,1536.5,1107,-460,1
5012,1790,1220,1761.6,17616,18517,7.0,8,8,16,235,23.5,1,1,1,0,0,231,23.1,0,7,5,5,6.8,17297,15826,1582.6,-1220,-1790,1
5013,-1970,-1177,1432.2,14322,17759,6.8,1,1,1,236,23.6,1,1,0,1,0,222,22.2,1,5,4,4,7.0,18936,16292,1629.2,1177,1970,1
5014,1073,103,1603.3,16033,17303,6.8,5,5,6,211,21.1,1,0,0,1,1,225,22.5,1,2,4,4,6.8,17200,14960,1496.0,-103,-1073,1
5015,-1725,-2004,1488.7,14887,16190,6.6,3,3,7,214,21.4,0,0,1,0,1,242,24.2,1,6,7,7,6.8,18194,16612,1661.2,2004,1725,1
5016,2936,1143,1868.8,18688,18316,7.0,12,12,12,199,19.9,0,0,1,0,1,207,20.7,2,7,6,6,6.8,17173,15752,1575.2,-1143,-2936,1
5017,-2054,-731,1507.4,15074,17596,6.8,4,4,6,214,21.4,0,0,0,1,1,211,21.1,2,10,7,7,7.0,18327,17128,1712.8,731,2054,1
5018,-2084,-851,1464.7,14647,17841,7.2,3,3,3,185,18.5,0,0,0,1,1,251,25.1,2,6,6,6,7.0,18692,16731,1673.1,851,2084,0
5019,-394,1166,1567.8,15678,18321,7.0,5,5,3,221,22.1,0,0,0,1,0,230,23.0,0,6,4,4,6.6,17155,16072,1607.2,-1166,394,1
5020,-3366,-1822,1362.7,13627,15650,6.4,1,1,1,206,20.6,0,0,0,1,1,205,20.5,1,9,9,9,6.8,17472,16993,1699.3,1822,3366,0
5021,4237,2338,1889.0,18890,19533,7.2,9,9,12,236,23.6,2,1,1,0,0,226,22.6,0,4,2,2,6.6,17195,14653,1465.3,-2338,-4237,1
5022,-3455,-2405,1363.6,13636,16872,6.6,2,2,0,190,19.0,0,0,0,1,0,217,21.7,0,8,8,8,7.0,19277,17091,1709.1,2405,3455,1
5023,5578,3447,1933.9,19339,18982,7.4,14,14,16,197,19.7,0,0,1,0,0,179,17.9,0,2,2,2,6.2,15535,13761,1376.1,-3447,-5578,1
5024,-130,-423,1547.3,15473,17268,6.8,5,5,8,219,21.9,0,0,1,0,0,221,22.1,0,7,5,5,7.0,17691,15603,1560.3,423,130,0
5025,-2491,-1771,1453.5,14535,16967,6.6,3,3,4,182,18.2,0,0,0,1,1,241,24.1,1,5,5,5,7.2,18738,17026,1702.6,1771,2491,0
5026,-2406,-2686,1475.2,14752,17234,6.8,2,2,1,239,23.9,1,0,1,0,1,218,21.8,1,8,7,7,7.2,19920,17158,1715.8,2686,2406,0
5027,-2546,-2542,1432.3,14323,16834,6.6,3,3,4,184,18.4,1,1,1,0,0,243,24.3,1,5,5,5,7.6,19376,16869,1686.9,2542,2546,1
5028,237,-1307,1589.0,15890,15995,6.4,6,6,8,178,17.8,0,0,1,0,1,202,20.2,1,5,5,5,7.0,17302,15653,1565.3,1307,-237,0
5029,411,1075,1802.8,18028,16592,6.8,12,12,11,179,17.9,0,0,0,1,1,176,17.6,2,11,7,7,6.2,15517,17617,1761.7,-1075,-411,1
5030,-1702,-1490,1535.2,15352,15672,6.4,4,4,8,193,19.3,0,0,1,0,1,191,19.1,1,13,8,8,6.6,17162,17054,1705.4,1490,1702,1
5031,2170,1383,1730.6,17306,18073,6.8,8,8,12,237,23.7,1,1,0,1,0,218,21.8,0,5,4,4,6.4,16690,15136,1513.6,-1383,-2170,1
5032,-2064,-2639,1538.0,15380,17373,7.0,6,6,8,193,19.3,0,0,1,0,0,242,24.2,0,5,6,6,7.6,20012,17444,1744.4,2639,2064,0
5033,-733,-784,1537.6,15376,16496,6.6,4,4,7,225,22.5,1,1,0,1,0,201,20.1,0,6,5,5,6.6,17280,16109,1610.9,784,733,0
5034,683,-208,1681.5,16815,17824,7.2,6,6,9,235,23.5,1,1,1,0,0,179,17.9,1,12,7,7,6.8,18032,16132,1613.2,208,-683,1
5035,-946,630,1536.4,15364,18063,7.0,4,4,5,210,21.0,0,0,0,1,1,229,22.9,1,8,6,6,6.8,17433,16310,1631.0,-630,946,1
5036,512,858,1619.9,16199,18624,7.0,5,5,3,205,20.5,0,0,1,0,0,218,21.8,0,4,4,4,6.8,17766,15687,1568.7,-858,-512,0
5037,686,765,1753.9,17539,20178,7.6,12,12,7,189,18.9,0,0,0,1,0,208,20.8,0,7,7,7,7.0,19413,16853,1685.3,-765,-686,1
5038,-1611,-1624,1678.1,16781,17736,6.8,8,8,5,180,18.0,1,0,0,1,1,188,18.8,1,13,10,10,7.4,19360,18392,1839.2,1624,1611,0
5039,811,376,1781.9,17819,18112,7.0,11,11,10,232,23.2,0,0,0,1,0,222,22.2,0,14,8,8,7.0,17736,17008,1700.8,-376,-811,1
5040,5263,3213,2192.7,21927,20604,7.4,14,14,14,250,25.0,2,1,1,0,0,174,17.4,0,11,8,8,7.0,17391,16664,1666.4,-3213,-5263,1
5041,-249,1420,1662.1,16621,19161,7.0,6,6,3,231,23.1,0,0,0,1,1,203,20.3,1,6,7,7,6.8,17741,16870,1687.0,-1420,249,0
5042,2819,1294,1986.5,19865,18655,7.2,13,13,16,225,22.5,1,1,0,1,0,210,21.0,0,8,8,8,6.8,17361,17046,1704.6,-1294,-2819,1
5043,87,435,1720.8,17208,18748,7.2,8,8,7,197,19.7,0,0,1,0,0,222,22.2,0,5,8,8,7.0,18313,17121,1712.1,-435,-87,1
5044,-3839,-3318,1363.1,13631,16334,6.6,1,1,0,220,22.0,1,1,0,1,0,233,23.3,1,7,8,8,7.4,19652,17470,1747.0,3318,3839,0
5045,2824,1346,1858.8,18588,18890,7.2,10,10,10,229,22.9,0,0,1,0,0,214,21.4,0,3,5,5,6.8,17544,15764,1576.4,-1346,-2824,1
5046,-2159,-1280,1517.3,15173,17549,6.6,5,5,8,186,18.6,1,1,0,1,0,227,22.7,0,9,7,7,7.2,18829,17332,1733.2,1280,2159,0
5047,326,1163,1718.8,17188,19429,7.4,6,6,5,250,25.0,0,0,0,1,0,219,21.9,0,6,6,6,7.2,18266,16862,1686.2,-1163,-326,1
5048,-4775,-4080,1551.1,15511,15296,6.4,6,6,8,171,17.1,0,0,0,1,1,237,23.7,1,12,12,12,7.4,19376,20286,2028.6,4080,4775,0
5049,-3811,-3107,1564.2,15642,15825,6.4,5,5,8,214,21.4,0,0,0,1,1,210,21.0,1,12,13,13,7.2,18932,19453,1945.3,3107,3811,0
5050,896,1396,1562.0,15620,18429,7.2,5,5,1,187,18.7,1,1,1,0,0,227,22.7,0,2,3,3,6.6,17033,14724,1472.4,-1396,-896,0
5051,-1218,-1528,1557.7,15577,16572,6.6,5,5,8,197,19.7,0,0,0,1,1,239,23.9,2,11,6,6,7.0,18100,16795,1679.5,1528,1218,1
5052,-3089,-2151,1468.9,14689,16533,6.6,3,3,1,195,19.5,0,0,0,1,1,219,21.9,1,16,10,10,7.0,18684,17778,1777.8,2151,3089,0
5053,-1277,-1357,1475.8,14758,17522,6.8,1,1,1,245,24.5,0,0,0,1,1,223,22.3,2,9,5,5,7.2,18879,16035,1603.5,1357,1277,0
5054,5885,4694,2002.8,20028,20153,7.4,14,14,20,229,22.9,1,1,1,0,0,160,16.0,0,3,3,3,6.2,15459,14143,1414.3,-4694,-5885,1
5055,8977,5411,2221.2,22212,19473,7.4,13,13,18,257,25.7,1,0,1,0,0,161,16.1,0,3,2,2,6.0,14062,13235,1323.5,-5411,-8977,1
5056,-1050,522,1585.8,15858,17780,7.0,4,4,9,215,21.5,0,0,0,1,0,213,21.3,0,10,6,6,6.8,17258,16908,1690.8,-522,1050,1
5057,-1599,332,1610.9,16109,19122,7.2,5,5,1,237,23.7,0,0,1,0,1,248,24.8,2,3,5,5,7.2,18790,17708,1770.8,-332,1599,0
5058,-758,313,1538.1,15381,18597,7.2,4,4,4,222,22.2,0,0,0,1,0,194,19.4,0,5,7,7,7.2,18284,16139,1613.9,-313,758,1
5059,-1413,-729,1468.0,14680,17305,7.0,2,2,5,222,22.2,0,0,0,1,0,234,23.4,1,7,4,4,7.2,18034,16093,1609.3,729,1413,0
5060,1011,480,1850.4,18504,19524,7.4,11,11,9,226,22.6,2,1,1,0,0,187,18.7,0,12,10,10,7.2,19044,17493,1749.3,-480,-1011,1
5061,428,1015,1591.1,15911,17640,7.0,7,7,2,219,21.9,0,0,1,0,1,234,23.4,1,5,4,4,6.6,16625,15483,1548.3,-1015,-428,0
5062,3206,1437,1834.0,18340,18170,7.2,8,8,12,250,25.0,0,0,1,0,0,180,18.0,0,7,4,4,6.6,16733,15134,1513.4,-1437,-3206,1
5063,2135,1653,1700.8,17008,18943,7.2,8,8,11,197,19.7,1,1,1,0,0,205,20.5,0,3,4,4,6.8,17290,14873,1487.3,-1653,-2135,1
5064,-1302,73,1676.0,16760,18264,7.2,8,8,6,217,21.7,0,0,0,1,1,199,19.9,1,8,12,12,7.0,18191,18062,1806.2,-73,1302,0
5065,565,275,1666.9,16669,19026,7.4,4,4,3,266,26.6,0,0,0,1,1,238,23.8,1,5,4,4,7.2,18751,16104,1610.4,-275,-565,1
5066,1958,3140,1777.1,17771,20856,7.8,7,7,7,217,21.7,0,0,1,0,1,239,23.9,1,6,4,4,6.8,17716,15813,1581.3,-3140,-1958,1
5067,4257,2902,1777.3,17773,18937,7.2,9,9,5,236,23.6,0,0,1,0,0,204,20.4,0,1,1,1,6.4,16035,13516,1351.6,-2902,-4257,0
5068,1674,-648,1821.7,18217,16663,6.6,10,10,13,190,19.0,1,1,1,0,0,192,19.2,0,7,9,9,7.0,17311,16543,1654.3,648,-1674,1
5069,-928,-1753,1540.8,15408,17993,7.0,5,5,6,209,20.9,1,1,0,1,0,237,23.7,0,3,7,7,7.4,19746,16336,1633.6,1753,928,1
5070,-75,144,1636.0,16360,16497,6.4,7,7,10,218,21.8,0,0,1,0,0,207,20.7,0,8,6,6,6.8,16353,16435,1643.5,-144,75,0
5071,-4046,-2777,1314.1,13141,16162,6.6,1,1,1,202,20.2,0,0,0,1,0,214,21.4,1,5,8,8,7.2,18939,17187,1718.7,2777,4046,0
5072,-4138,-3792,1386.0,13860,16225,6.8,2,2,3,195,19.5,0,0,0,1,0,229,22.9,1,7,9,9,7.4,20017,17998,1799.8,3792,4138,0
5073,-3535,-1199,1599.5,15995,17109,6.8,8,8,6,172,17.2,0,0,0,1,1,220,22.0,1,13,10,10,7.2,18308,19530,1953.0,1199,3535,0
5074,-4719,-2129,1444.2,14442,16650,6.6,2,2,1,202,20.2,0,0,0,1,1,225,22.5,1,10,9,9,7.0,18779,19161,1916.1,2129,4719,0
5075,5900,5188,2012.5,20125,20117,7.4,13,13,16,226,22.6,2,1,0,1,0,179,17.9,0,8,3,3,6.2,14929,14225,1422.5,-5188,-5900,1
5076,1818,1992,1654.2,16542,19007,7.0,6,6,5,227,22.7,1,1,1,0,0,234,23.4,0,0,2,2,6.6,17015,14724,1472.4,-1992,-1818,0
5077,-3461,-1353,1394.3,13943,17306,6.4,1,1,1,229,22.9,0,0,0,1,1,244,24.4,2,6,4,4,7.0,18659,17404,1740.4,1353,3461,1
5078,-1521,-2096,1683.6,16836,16495,6.6,8,8,6,215,21.5,1,1,1,0,0,215,21.5,0,12,11,11,7.0,18591,18357,1835.7,2096,1521,1
5079,1328,1043,1763.1,17631,17645,7.0,9,9,14,199,19.9,1,1,1,0,0,188,18.8,0,7,7,7,6.6,16602,16303,1630.3,-1043,-1328,1
5080,911,-276,1676.5,16765,16518,6.6,9,9,12,181,18.1,0,0,0,1,1,182,18.2,1,4,6,6,6.8,16794,15854,1585.4,276,-911,1
5081,2111,1390,1800.1,18001,19477,7.2,8,8,9,233,23.3,1,0,1,0,1,228,22.8,1,5,4,4,6.8,18087,15890,1589.0,-1390,-2111,1
5082,935,2197,1958.0,19580,18977,7.0,13,13,14,201,20.1,0,0,0,1,0,179,17.9,0,14,13,13,6.6,16780,18645,1864.5,-2197,-935,1
5083,-3032,-2816,1477.4,14774,16999,6.6,4,4,2,214,21.4,0,0,0,1,1,215,21.5,2,11,10,10,7.2,19815,17806,1780.6,2816,3032,0
5084,-425,-1057,1752.5,17525,17738,7.0,8,8,11,202,20.2,1,1,1,0,0,264,26.4,0,6,7,7,7.0,18795,17950,1795.0,1057,425,1
5085,2365,2052,1928.0,19280,19831,7.2,10,10,7,240,24.0,0,0,0,1,0,211,21.1,0,8,8,8,7.0,17779,16915,1691.5,-2052,-2365,1
5086,3140,3364,1792.9,17929,20365,7.4,7,7,5,233,23.3,1,1,0,1,0,201,20.1,1,4,4,4,6.6,17001,14789,1478.9,-3364,-3140,1
5087,-779,-1837,1598.8,15988,17843,6.8,5,5,6,215,21.5,0,0,0,1,0,235,23.5,0,3,5,5,7.4,19680,16767,1676.7,1837,779,1
5088,1690,1316,1721.4,17214,18566,7.2,10,10,5,200,20.0,1,1,1,0,0,162,16.2,0,9,7,7,6.8,17250,15524,1552.4,-1316,-1690,1
5089,1433,522,1589.7,15897,18168,6.8,6,6,6,188,18.8,2,1,0,1,0,215,21.5,0,1,2,2,6.8,17646,14464,1446.4,-522,-1433,1
5090,3466,1525,1853.9,18539,18188,7.0,7,7,16,253,25.3,1,1,0,1,0,222,22.2,1,2,4,4,6.6,16663,15073,1507.3,-1525,-3466,1
5091,1947,136,1813.2,18132,17869,6.8,10,10,14,212,21.2,2,1,1,0,0,219,21.9,0,3,4,4,6.6,17733,16185,1618.5,-136,-1947,1
5092,6624,4865,2138.2,21382,20346,7.2,13,13,11,246,24.6,2,1,1,0,0,185,18.5,0,4,2,2,6.2,15481,14758,1475.8,-4865,-6624,1
5093,2659,2757,1701.1,17011,17776,7.2,8,8,7,194,19.4,1,1,1,0,0,201,20.1,0,2,2,2,6.0,15019,14352,1435.2,-2757,-2659,1
5094,6275,4789,2020.6,20206,19702,7.4,11,11,12,221,22.1,1,1,1,0,0,187,18.7,0,2,3,3,6.2,14913,13931,1393.1,-4789,-6275,1
5095,1369,2756,1767.3,17673,19727,7.2,9,9,6,208,20.8,2,1,1,0,0,216,21.6,0,7,6,6,6.6,16971,16304,1630.4,-2756,-1369,1
5096,422,-308,1698.3,16983,17424,6.8,9,9,10,183,18.3,1,0,1,0,1,200,20.0,1,6,7,7,7.0,17732,16561,1656.1,308,-422,1
5097,-2281,-42,1513.9,15139,18041,7.0,4,4,4,216,21.6,0,0,0,1,1,244,24.4,1,8,7,7,7.0,18083,17420,1742.0,42,2281,0
5098,1722,1514,1813.2,18132,19522,7.6,10,10,11,232,23.2,2,1,1,0,0,211,21.1,0,8,6,6,7.2,18008,16410,1641.0,-1514,-1722,1
5099,-1595,-1648,1586.7,15867,17723,6.6,4,4,6,186,18.6,1,1,0,1,0,253,25.3,0,4,4,4,7.2,19371,17462,1746.2,1648,1595,0
5100,-730,-251,1593.1,15931,17539,6.8,4,4,6,222,22.2,1,1,0,1,0,213,21.3,0,7,6,6,7.0,17790,16661,1666.1,251,730,1
5101,-1168,-674,1761.0,17610,17779,6.8,8,8,9,212,21.2,1,0,1,0,1,229,22.9,1,17,9,9,7.2,18453,18778,1877.8,674,1168,1
5102,2546,1928,1749.5,17495,18537,7.0,9,9,14,208,20.8,0,0,1,0,0,211,21.1,0,2,4,4,6.6,16609,14949,1494.9,-1928,-2546,1
5103,-839,-833,1623.0,16230,19157,7.4,5,5,6,228,22.8,0,0,0,1,1,239,23.9,2,3,6,6,7.4,19990,17069,1706.9,833,839,0
5104,-2317,-1330,1449.6,14496,16623,6.8,3,3,1,230,23.0,0,0,0,1,1,223,22.3,2,11,8,8,7.0,17953,16813,1681.3,1330,2317,0
5105,-904,-178,1600.8,16008,17798,6.8,6,6,7,216,21.6,1,0,1,0,0,257,25.7,0,4,5,5,7.0,17976,16912,1691.2,178,904,0
5106,-673,568,1692.3,16923,17782,6.8,7,7,9,224,22.4,0,0,0,1,1,199,19.9,1,13,10,10,7.0,17214,17596,1759.6,-568,673,0
5107,4444,2813,1946.2,19462,19955,7.6,9,9,9,239,23.9,1,1,1,0,0,209,20.9,0,3,4,4,6.6,17142,15018,1501.8,-2813,-4444,1
5108,-1243,-604,1648.2,16482,17266,7.0,7,7,6,229,22.9,0,0,0,1,0,194,19.4,0,15,6,6,7.0,17870,17725,1772.5,604,1243,0
5109,-2078,-1506,1559.2,15592,17700,7.0,5,5,5,218,21.8,1,0,1,0,0,205,20.5,0,6,9,9,7.6,19206,17670,1767.0,1506,2078,1
5110,-952,-1337,1726.8,17268,15979,6.6,8,8,12,194,19.4,1,1,1,0,0,214,21.4,1,7,9,9,6.6,17316,18220,1822.0,1337,952,0
5111,-2132,-1088,1516.7,15167,16733,6.6,5,5,4,195,19.5,0,0,0,1,0,215,21.5,0,7,9,9,7.0,17821,17299,1729.9,1088,2132,0
5112,-1015,-1395,1584.7,15847,17480,6.8,5,5,10,203,20.3,1,1,0,1,0,256,25.6,1,9,5,5,7.2,18875,16862,1686.2,1395,1015,0
5113,517,585,1633.3,16333,18737,7.2,7,7,8,204,20.4,1,0,1,0,1,234,23.4,1,4,4,4,6.8,18152,15816,1581.6,-585,-517,0
5114,-2222,-1252,1603.2,16032,17171,6.8,5,5,6,220,22.0,0,0,0,1,1,225,22.5,1,10,9,9,7.0,18423,18254,1825.4,1252,2222,1
5115,-208,-353,1576.2,15762,18318,7.0,5,5,3,216,21.6,1,1,0,1,0,221,22.1,0,5,6,6,7.0,18671,15970,1597.0,353,208,1
5116,-2513,-3419,1474.9,14749,17146,6.8,3,3,4,200,20.0,0,0,0,1,0,246,24.6,0,5,6,6,7.4,20565,17262,1726.2,3419,2513,0
5117,-601,-1965,1540.5,15405,17336,6.8,4,4,9,215,21.5,1,0,1,0,1,249,24.9,1,5,4,4,7.2,19301,16006,1600.6,1965,601,1
5118,1753,2303,1677.5,16775,18235,7.0,7,7,4,221,22.1,1,1,0,1,0,213,21.3,0,7,4,4,6.4,15932,15022,1502.2,-2303,-1753,1
5119,-751,-1229,1466.7,14667,18007,6.8,2,2,1,202,20.2,1,1,1,0,0,239,23.9,0,5,3,3,7.2,19236,15418,1541.8,1229,751,0
5120,1430,107,1740.9,17409,18063,6.8,7,7,6,241,24.1,1,0,1,0,1,173,17.3,1,7,6,6,7.0,17956,15979,1597.9,-107,-1430,1
5121,-469,-1237,1570.6,15706,17219,6.6,5,5,5,228,22.8,1,1,1,0,0,229,22.9,0,4,6,6,7.0,18456,16175,1617.5,1237,469,1
5122,-1099,-1318,1646.6,16466,16716,6.6,9,9,7,188,18.8,1,1,1,0,0,232,23.2,0,7,7,7,7.0,18034,17565,1756.5,1318,1099,1
5123,5553,3915,2019.0,20190,19713,7.2,12,12,12,200,20.0,0,0,0,1,1,149,14.9,1,4,5,5,6.4,15798,14637,1463.7,-3915,-5553,1
5124,2091,1359,1740.8,17408,19121,7.2,9,9,13,204,20.4,0,0,1,0,0,227,22.7,0,2,4,4,6.8,17762,15317,1531.7,-1359,-2091,1
5125,-1951,-1575,1559.1,15591,17848,7.0,4,4,5,228,22.8,1,1,0,1,0,236,23.6,0,6,8,8,7.4,19423,17542,1754.2,1575,1951,0
5126,96,-24,1641.0,16410,18288,7.2,6,6,7,211,21.1,1,1,1,0,0,203,20.3,0,5,6,6,7.0,18312,16314,1631.4,24,-96,1
5127,1762,2377,1785.4,17854,18784,7.2,9,9,9,219,21.9,0,0,0,1,0,202,20.2,1,7,6,6,6.6,16407,16092,1609.2,-2377,-1762,0
5128,3082,1360,1724.3,17243,19173,7.2,8,8,9,233,23.3,1,0,1,0,0,222,22.2,0,0,2,2,6.6,17813,14161,1416.1,-1360,-3082,1
5129,2608,3387,1698.7,16987,18514,7.2,9,9,17,189,18.9,1,1,1,0,0,172,17.2,0,5,3,3,6.4,15127,14379,1437.9,-3387,-2608,1
5130,-1460,-2414,1481.8,14818,16417,6.4,5,5,3,204,20.4,0,0,1,0,0,231,23.1,0,3,3,3,7.4,18831,16278,1627.8,2414,1460,0
5131,3784,2577,1863.3,18633,19659,7.4,11,11,11,232,23.2,1,1,1,0,0,209,20.9,0,3,3,3,6.8,17082,14849,1484.9,-2577,-3784,1
5132,-2053,-1784,1756.6,17566,17314,6.8,10,10,8,202,20.2,0,0,1,0,1,214,21.4,2,12,12,12,7.0,19098,19619,1961.9,1784,2053,0
5133,-2020,-2716,1495.6,14956,16196,6.6,4,4,4,198,19.8,0,0,0,1,0,246,24.6,0,2,7,7,7.2,18912,16976,1697.6,2716,2020,0
5134,1137,-92,1820.6,18206,19094,7.2,8,8,9,224,22.4,1,1,0,1,0,220,22.0,0,6,6,6,7.4,19186,17069,1706.9,92,-1137,0
5135,-1561,-1578,1575.8,15758,16369,7.0,6,6,11,204,20.4,0,0,1,0,0,213,21.3,0,9,8,8,7.0,17947,17319,1731.9,1578,1561,0
5136,-598,-1285,1563.2,15632,18155,7.2,1,1,1,268,26.8,0,0,0,1,1,238,23.8,2,6,4,4,7.2,19440,16230,1623.0,1285,598,0
5137,-1829,-1668,1627.8,16278,16530,6.6,7,7,8,181,18.1,0,0,0,1,1,212,21.2,1,10,9,9,7.0,18198,18107,1810.7,1668,1829,0
5138,2036,1891,1713.1,17131,18732,7.2,11,11,10,215,21.5,1,1,1,0,0,188,18.8,0,3,4,4,6.8,16841,15095,1509.5,-1891,-2036,1
5139,-1381,-907,1679.5,16795,18177,6.8,8,8,9,203,20.3,1,1,1,0,0,221,22.1,0,9,10,10,7.2,19084,18176,1817.6,907,1381,1
5140,2247,1367,1907.0,19070,17872,7.0,12,12,20,210,21.0,1,1,1,0,0,205,20.5,0,9,7,7,6.6,16505,16823,1682.3,-1367,-2247,1
5141,-800,72,1599.3,15993,18392,7.0,5,5,5,227,22.7,1,1,1,0,0,243,24.3,0,6,5,5,7.2,18320,16793,1679.3,-72,800,1
5142,-826,-979,1571.5,15715,16563,6.6,6,6,6,188,18.8,0,0,1,0,0,237,23.7,1,7,6,6,7.0,17542,16541,1654.1,979,826,0
5143,4280,2681,1858.3,18583,18852,7.2,11,11,9,204,20.4,1,1,1,0,0,202,20.2,0,2,3,3,6.4,16171,14303,1430.3,-2681,-4280,1
5144,-973,-2691,1684.8,16848,16664,6.6,9,9,11,200,20.0,1,1,1,0,0,214,21.4,0,12,9,9,7.0,19355,17821,1782.1,2691,973,0
5145,1970,1999,1790.3,17903,19715,7.2,8,8,11,206,20.6,1,1,1,0,0,234,23.4,0,4,4,4,7.0,17716,15933,1593.3,-1999,-1970,1
5146,-1858,-1476,1472.4,14724,16522,6.6,3,3,5,195,19.5,1,0,0,1,1,225,22.5,1,7,6,6,7.0,17998,16582,1658.2,1476,1858,1
5147,-1867,-2002,1637.1,16371,16354,6.6,8,8,9,201,20.1,0,0,0,1,1,190,19.0,1,11,11,11,7.2,18356,18238,1823.8,2002,1867,0
5148,-684,-2401,1657.1,16571,14758,6.2,7,7,14,192,19.2,2,1,1,0,0,187,18.7,0,16,9,9,6.8,17159,17255,1725.5,2401,684,1
5149,-3056,-2938,1544.5,15445,17126,6.8,4,4,6,225,22.5,0,0,1,0,1,221,22.1,1,8,9,9,7.4,20064,18501,1850.1,2938,3056,1
5150,-4330,-4347,1398.0,13980,15464,6.2,4,4,2,181,18.1,0,0,1,0,0,228,22.8,0,12,10,10,7.4,19811,18310,1831.0,4347,4330,0
5151,-1348,105,1798.4,17984,18165,7.0,11,11,6,178,17.8,0,0,0,1,1,210,21.0,1,10,13,13,6.8,18060,19332,1933.2,-105,1348,1
5152,1800,713,1758.8,17588,18523,7.2,8,8,11,238,23.8,0,0,0,1,1,192,19.2,1,9,6,6,6.8,17810,15788,1578.8,-713,-1800,1
5153,509,595,1632.6,16326,18838,7.2,6,6,8,222,22.2,0,0,1,0,1,231,23.1,1,1,5,5,6.8,18243,15817,1581.7,-595,-509,0
5154,1883,973,1761.0,17610,17644,6.8,7,7,9,233,23.3,0,0,0,1,0,212,21.2,0,4,4,4,6.6,16671,15727,1572.7,-973,-1883,0
5155,894,-3,1723.8,17238,17944,6.8,8,8,9,209,20.9,0,0,1,0,0,187,18.7,0,10,8,8,7.0,17947,16344,1634.4,3,-894,0
5156,-3060,-2937,1560.2,15602,16415,6.4,6,6,3,206,20.6,1,1,0,1,0,238,23.8,0,7,10,10,7.4,19352,18662,1866.2,2937,3060,0
5157,-3370,-2779,1561.5,15615,17025,6.8,7,7,8,188,18.8,0,0,0,1,0,250,25.0,1,7,9,9,7.2,19804,18985,1898.5,2779,3370,0
5158,-452,-1060,1513.8,15138,16193,6.6,6,6,7,191,19.1,1,1,1,0,0,206,20.6,0,5,5,5,7.0,17253,15590,1559.0,1060,452,0
5159,1790,1764,1802.1,18021,19358,7.2,8,8,8,253,25.3,1,1,1,0,0,237,23.7,0,4,5,5,7.0,17594,16231,1623.1,-1764,-1790,1
5160,790,-1155,1506.3,15063,17160,6.6,2,2,5,227,22.7,1,0,1,0,1,217,21.7,1,0,1,1,7.0,18315,14273,1427.3,1155,-790,0
5161,545,411,1756.1,17561,17813,6.6,7,7,8,215,21.5,1,1,1,0,0,218,21.8,1,1,5,5,6.6,17402,17016,1701.6,-411,-545,1
5162,3518,2503,1769.6,17696,19541,7.2,7,7,10,257,25.7,1,0,0,1,1,239,23.9,1,1,1,1,6.6,17038,14178,1417.8,-2503,-3518,1
5163,780,523,1654.8,16548,18505,6.8,5,5,5,226,22.6,2,1,1,0,0,226,22.6,0,5,4,4,7.0,17982,15768,1576.8,-523,-780,1
5164,-758,-1310,1461.0,14610,17048,6.6,3,3,2,206,20.6,1,1,1,0,0,249,24.9,0,2,2,2,7.0,18358,15368,1536.8,1310,758,0
5165,4565,2632,2060.4,20604,18469,6.8,17,17,26,194,19.4,0,0,1,0,1,202,20.2,1,6,6,6,6.4,15837,16039,1603.9,-2632,-4565,1
5166,726,1104,1769.8,17698,19290,7.2,9,9,8,206,20.6,1,1,1,0,0,229,22.9,0,5,6,6,6.8,18186,16972,1697.2,-1104,-726,0
5167,-1254,-956,1502.1,15021,16981,6.8,4,4,3,207,20.7,0,0,1,0,1,249,24.9,2,5,4,4,7.0,17937,16275,1627.5,956,1254,0
5168,-1207,-218,1522.6,15226,17102,6.8,3,3,2,210,21.0,0,0,0,1,0,215,21.5,0,7,7,7,6.6,17320,16433,1643.3,218,1207,0
5169,1167,-1436,1706.4,17064,18451,7.0,3,3,4,263,26.3,1,0,1,0,1,214,21.4,1,5,4,4,7.2,19887,15897,1589.7,1436,-1167,0
5170,-179,-463,1522.1,15221,17418,6.8,1,1,1,266,26.6,0,0,1,0,1,240,24.0,1,4,3,3,6.6,17881,15400,1540.0,463,179,0
5171,2363,1314,1797.2,17972,19155,7.2,10,10,9,206,20.6,1,0,1,0,0,226,22.6,0,3,4,4,6.8,17841,15609,1560.9,-1314,-2363,0
5172,847,1606,1815.1,18151,19393,7.2,9,9,9,227,22.7,0,0,0,1,0,226,22.6,0,9,7,7,7.0,17787,17304,1730.4,-1606,-847,1
5173,5622,3964,1977.3,19773,20507,7.6,13,13,16,240,24.0,1,1,1,0,0,203,20.3,0,4,2,2,6.6,16543,14151,1415.1,-3964,-5622,1
5174,467,850,1626.2,16262,18089,7.0,5,5,5,235,23.5,0,0,1,0,0,228,22.8,0,4,4,4,6.8,17239,15795,1579.5,-850,-467,1
5175,-115,141,1704.4,17044,17819,7.0,7,7,8,200,20.0,1,1,1,0,0,209,20.9,0,7,7,7,7.0,17678,17159,1715.9,-141,115,0
5176,3512,2161,1756.2,17562,19532,7.2,7,7,9,213,21.3,0,0,1,0,1,215,21.5,1,2,1,1,6.8,17371,14050,1405.0,-2161,-3512,1
5177,-2845,-1461,1436.4,14364,16898,6.8,3,3,4,204,20.4,0,0,0,1,1,208,20.8,1,5,6,6,7.0,18359,17209,1720.9,1461,2845,0
5178,4076,2996,1785.5,17855,18853,7.2,9,9,10,211,21.1,0,0,1,0,1,211,21.1,1,1,2,2,6.6,15857,13779,1377.9,-2996,-4076,1
5179,-1806,-2407,1587.4,15874,16649,6.4,6,6,6,195,19.5,2,1,1,0,0,228,22.8,0,11,9,9,7.2,19056,17680,1768.0,2407,1806,1
5180,-216,301,1688.1,16881,18851,7.0,6,6,6,228,22.8,0,0,0,1,0,233,23.3,0,6,7,7,7.0,18550,17097,1709.7,-301,216,1
5181,1635,416,1806.0,18060,18502,7.2,11,11,8,192,19.2,1,0,1,0,0,204,20.4,0,3,5,5,6.6,18086,16425,1642.5,-416,-1635,0
5182,-3081,-1236,1510.6,15106,16691,6.8,4,4,2,201,20.1,0,0,0,1,0,192,19.2,0,14,10,10,6.8,17927,18187,1818.7,1236,3081,0
5183,2711,2693,1645.4,16454,19703,7.6,4,4,3,241,24.1,0,0,1,0,0,211,21.1,0,1,1,1,6.6,17010,13743,1374.3,-2693,-2711,1
5184,5354,4695,1807.8,18078,18559,6.8,8,8,13,247,24.7,1,1,1,0,0,166,16.6,0,0,1,1,6.0,13864,12724,1272.4,-4695,-5354,1
5185,-188,-535,1530.0,15300,17024,6.6,4,4,4,212,21.2,0,0,0,1,0,232,23.2,0,5,5,5,6.8,17559,15488,1548.8,535,188,0
5186,3983,3375,1891.9,18919,20248,7.6,7,7,1,252,25.2,2,1,1,0,0,230,23.0,0,5,3,3,6.8,16873,14936,1493.6,-3375,-3983,1
5187,-1185,-2402,1556.5,15565,17312,6.4,2,2,4,251,25.1,1,0,1,0,1,267,26.7,1,8,4,4,7.4,19714,16750,1675.0,2402,1185,1
5188,4260,1422,1855.3,18553,18514,7.0,11,11,17,204,20.4,1,1,1,0,0,210,21.0,0,1,2,2,6.8,17092,14293,1429.3,-1422,-4260,1
5189,835,1506,1663.9,16639,19375,7.2,3,3,2,269,26.9,0,0,0,1,1,216,21.6,1,4,3,3,7.0,17869,15804,1580.4,-1506,-835,1
5190,2879,2522,1827.3,18273,18951,7.0,8,8,7,211,21.1,0,0,1,0,0,195,19.5,0,7,6,6,6.4,16429,15394,1539.4,-2522,-2879,1
5191,-407,-1257,1656.0,16560,18074,7.0,6,6,5,203,20.3,0,0,1,0,1,223,22.3,1,7,8,8,7.4,19331,16967,1696.7,1257,407,1
5192,-5705,-5364,1374.2,13742,12556,5.6,5,5,7,123,12.3,0,0,0,1,1,218,21.8,1,11,10,10,6.8,17920,19447,1944.7,5364,5705,0
5193,1270,365,1752.5,17525,19083,7.0,9,9,12,221,22.1,1,1,0,1,0,218,21.8,0,2,5,5,7.4,18718,16255,1625.5,-365,-1270,0
5194,-3204,-779,1512.3,15123,17144,6.8,4,4,5,210,21.0,1,1,1,0,0,216,21.6,1,16,9,9,7.0,17923,18327,1832.7,779,3204,0
5195,-3927,-3207,1468.6,14686,15538,6.4,4,4,4,184,18.4,0,0,0,1,0,262,26.2,1,4,7,7,7.0,18745,18613,1861.3,3207,3927,0
5196,78,658,1695.7,16957,17656,6.6,8,8,12,215,21.5,1,1,0,1,0,207,20.7,0,11,7,7,6.8,16998,16879,1687.9,-658,-78,1
5197,1789,2100,1679.6,16796,19731,7.2,4,4,3,276,27.6,0,0,0,1,0,232,23.2,0,4,2,2,6.8,17631,15007,1500.7,-2100,-1789,1
5198,1577,678,1859.2,18592,19027,7.2,10,10,12,212,21.2,0,0,1,0,1,233,23.3,2,4,7,7,7.0,18349,17015,1701.5,-678,-1577,0
5199,590,1002,1641.1,16411,17513,6.6,8,8,10,176,17.6,0,0,0,1,0,208,20.8,0,4,4,4,6.6,16511,15821,1582.1,-1002,-590,0
5200,-384,-1408,1573.0,15730,16849,6.6,5,5,4,223,22.3,0,0,1,0,1,220,22.0,1,3,4,4,7.0,18257,16114,1611.4,1408,384,0
5201,315,667,1630.2,16302,18728,7.2,4,4,2,256,25.6,1,1,0,1,0,224,22.4,1,3,5,5,6.8,18061,15987,1598.7,-667,-315,1
5202,580,-1033,1544.7,15447,16928,6.6,4,4,2,217,21.7,1,0,1,0,1,228,22.8,1,2,2,2,6.8,17961,14867,1486.7,1033,-580,0
5203,1870,-729,1729.9,17299,17431,6.6,6,6,7,223,22.3,1,0,1,0,1,226,22.6,1,4,3,3,7.0,18160,15429,1542.9,729,-1870,1
5204,3308,2114,1750.0,17500,18340,6.8,8,8,8,229,22.9,2,1,0,1,0,215,21.5,0,3,3,3,6.6,16226,14192,1419.2,-2114,-3308,1
5205,-2542,1134,1565.9,15659,19051,7.2,4,4,5,210,21.0,1,1,0,1,0,233,23.3,1,15,7,7,7.0,17917,18201,1820.1,-1134,2542,0
5206,369,561,1628.6,16286,17910,7.0,7,7,8,223,22.3,0,0,0,1,0,196,19.6,0,8,6,6,7.0,17349,15917,1591.7,-561,-369,0
5207,187,-954,1533.5,15335,17847,6.8,3,3,6,239,23.9,1,1,1,0,0,248,24.8,0,1,2,2,6.8,18801,15148,1514.8,954,-187,0
5208,1109,735,1774.4,17744,19502,7.2,8,8,6,237,23.7,2,1,0,1,0,231,23.1,0,3,5,5,7.2,18767,16635,1663.5,-735,-1109,0
5209,1572,2134,1759.2,17592,19457,7.4,9,9,10,213,21.3,1,1,1,0,0,211,21.1,1,9,6,6,6.8,17323,16020,1602.0,-2134,-1572,1
5210,-2080,-202,1573.2,15732,17644,7.0,3,3,4,201,20.1,1,1,0,1,0,202,20.2,1,12,9,9,7.2,17846,17812,1781.2,202,2080,0
5211,-2929,-1731,1654.4,16544,17851,7.0,5,5,6,222,22.2,0,0,1,0,1,227,22.7,1,17,11,11,7.2,19582,19473,1947.3,1731,2929,0
5212,1441,922,1891.3,18913,18431,7.0,11,11,14,215,21.5,0,0,0,1,1,200,20.0,1,11,11,11,7.0,17509,17472,1747.2,-922,-1441,1
5213,873,2194,1675.7,16757,18596,7.2,6,6,5,225,22.5,0,0,0,1,0,205,20.5,0,7,5,5,6.6,16402,15884,1588.4,-2194,-873,1
5214,-633,-502,1615.2,16152,18347,7.0,4,4,2,212,21.2,0,0,1,0,1,196,19.6,1,14,8,8,7.0,18849,16785,1678.5,502,633,1
5215,-838,-593,1450.5,14505,18312,7.0,2,2,2,224,22.4,1,0,1,0,1,253,25.3,1,1,2,2,7.2,18905,15343,1534.3,593,838,0
5216,-1098,271,1557.5,15575,17478,6.8,4,4,6,236,23.6,0,0,1,0,0,245,24.5,0,10,6,6,6.8,17207,16673,1667.3,-271,1098,1
5217,1909,1010,1818.7,18187,19397,7.2,6,6,12,257,25.7,1,0,1,0,1,248,24.8,1,4,5,5,7.0,18387,16278,1627.8,-1010,-1909,0
5218,-1577,-716,1667.4,16674,18357,6.8,8,8,3,223,22.3,1,0,1,0,0,209,20.9,0,11,10,10,7.0,19073,18251,1825.1,716,1577,1
5219,-728,-608,1602.8,16028,16233,6.6,8,8,8,187,18.7,1,1,0,1,0,184,18.4,0,7,8,8,6.8,16841,16756,1675.6,608,728,0
5220,142,1215,1615.7,16157,17878,7.0,5,5,6,221,22.1,0,0,1,0,1,199,19.9,1,6,6,6,6.8,16663,16015,1601.5,-1215,-142,0
5221,-2069,-22,1577.3,15773,18578,7.0,6,6,5,228,22.8,0,0,0,1,1,222,22.2,1,11,9,9,7.0,18600,17842,1784.2,22,2069,0
5222,1673,1200,1726.2,17262,18608,7.0,4,4,5,248,24.8,0,0,1,0,1,197,19.7,2,2,3,3,6.8,17408,15589,1558.9,-1200,-1673,1
5223,-5085,-3236,1436.7,14367,15957,6.4,3,3,3,192,19.2,1,1,0,1,0,249,24.9,0,13,10,10,7.4,19193,19452,1945.2,3236,5085,0
5224,337,1346,1538.7,15387,17708,7.0,5,5,10,174,17.4,1,1,0,1,0,213,21.3,0,4,4,4,6.8,16362,15050,1505.0,-1346,-337,1
5225,-233,1969,1532.6,15326,18992,7.2,3,3,1,226,22.6,1,1,0,1,0,222,22.2,0,5,4,4,6.6,17023,15559,1555.9,-1969,233,1
5226,920,1488,1686.7,16867,18904,7.2,7,7,11,219,21.9,0,0,1,0,1,210,21.0,1,6,4,4,7.0,17416,15947,1594.7,-1488,-920,1
5227,-1078,692,1416.2,14162,17402,6.8,3,3,0,201,20.1,1,1,1,0,0,240,24.0,0,4,3,3,6.8,16710,15240,1524.0,-692,1078,1
5228,-17,-1171,1625.3,16253,18163,6.8,5,5,6,212,21.2,1,1,0,1,0,243,24.3,0,2,5,5,7.2,19334,16270,1627.0,1171,17,0
5229,-4377,-4323,1404.1,14041,16529,6.6,1,1,2,229,22.9,1,1,0,1,0,234,23.4,0,5,9,9,7.4,20852,18418,1841.8,4323,4377,0
5230,2563,2910,1805.1,18051,19471,7.2,8,8,9,247,24.7,0,0,1,0,0,233,23.3,0,4,4,4,6.6,16561,15488,1548.8,-2910,-2563,1
5231,1254,400,1644.1,16441,18447,7.0,4,4,5,244,24.4,0,0,1,0,0,218,21.8,0,4,3,3,6.8,18047,15187,1518.7,-400,-1254,1
5232,-521,97,1615.7,16157,18679,6.8,4,4,7,239,23.9,1,1,0,1,0,255,25.5,0,3,4,4,7.0,18582,16678,1667.8,-97,521,0
5233,3387,1454,1979.3,19793,19966,7.4,10,10,9,243,24.3,1,0,1,0,1,239,23.9,1,9,6,6,7.0,18512,16406,1640.6,-1454,-3387,0
5234,-496,604,1628.4,16284,19396,7.4,7,7,8,197,19.7,1,1,0,1,0,209,20.9,0,7,8,8,7.0,18792,16780,1678.0,-604,496,1
5235,-3516,-2677,1561.7,15617,17334,6.6,5,5,4,202,20.2,0,0,0,1,0,237,23.7,1,6,11,11,7.4,20011,19133,1913.3,2677,3516,0
5236,1579,1615,1726.1,17261,18583,7.0,6,6,4,206,20.6,1,1,1,0,0,184,18.4,0,9,7,7,6.6,16968,15682,1568.2,-1615,-1579,1
5237,-747,-782,1738.5,17385,18439,7.2,8,8,9,185,18.5,1,1,1,0,0,214,21.4,0,12,9,9,7.4,19221,18132,1813.2,782,747,0
5238,2445,1767,2013.4,20134,19414,7.4,15,15,14,183,18.3,0,0,0,1,0,221,22.1,0,7,9,9,7.0,17647,17689,1768.9,-1767,-2445,1
5239,-178,738,1486.7,14867,17875,7.0,3,3,4,205,20.5,1,1,0,1,0,245,24.5,0,2,2,2,6.8,17137,15045,1504.5,-738,178,1
5240,-1844,-2222,1531.2,15312,16387,6.6,4,4,5,203,20.3,0,0,1,0,0,227,22.7,0,10,7,7,7.2,18609,17156,1715.6,2222,1844,0
5241,-980,-1488,1481.5,14815,18140,6.8,2,2,2,246,24.6,2,1,0,1,0,259,25.9,0,0,3,3,7.4,19628,15795,1579.5,1488,980,1
5242,2795,2702,1751.1,17511,20020,7.4,5,5,6,253,25.3,1,0,1,0,1,244,24.4,1,2,2,2,7.0,17318,14716,1471.6,-2702,-2795,0
5243,-2095,-2096,1715.7,17157,17475,6.6,8,8,10,200,20.0,0,0,0,1,0,206,20.6,0,15,14,14,7.4,19571,19252,1925.2,2096,2095,0
5244,801,262,1871.4,18714,18333,6.8,12,12,16,199,19.9,0,0,1,0,0,182,18.2,0,12,12,12,6.8,18071,17913,1791.3,-262,-801,0
5245,-506,-700,1713.6,17136,18329,6.8,8,8,5,224,22.4,1,1,1,0,0,218,21.8,0,7,10,10,7.2,19029,17642,1764.2,700,506,1
5246,705,2576,1696.6,16966,19266,7.4,8,8,7,228,22.8,0,0,0,1,1,198,19.8,1,5,7,7,6.6,16690,16261,1626.1,-2576,-705,1
5247,707,1131,1694.8,16948,18437,7.0,7,7,7,222,22.2,0,0,0,1,0,221,22.1,0,6,6,6,6.8,17306,16241,1624.1,-1131,-707,1
5248,2098,2184,1755.2,17552,19684,7.4,7,7,8,233,23.3,0,0,1,0,1,236,23.6,2,3,3,3,6.8,17500,15454,1545.4,-2184,-2098,1
5249,1680,1254,1794.1,17941,17529,6.8,10,10,13,206,20.6,0,0,1,0,0,215,21.5,0,5,5,5,6.4,16275,16261,1626.1,-1254,-1680,1
5250,-300,-1937,1633.4,16334,15901,6.4,4,4,2,218,21.8,0,0,1,0,1,224,22.4,1,7,8,8,7.0,17838,16634,1663.4,1937,300,0
5251,-6540,-4772,1334.2,13342,15464,6.4,1,1,2,177,17.7,0,0,0,1,1,234,23.4,2,13,10,10,7.4,20236,19882,1988.2,4772,6540,0
5252,1388,973,1801.4,18014,19778,7.2,8,8,9,238,23.8,1,1,1,0,0,225,22.5,0,5,5,5,7.2,18805,16626,1662.6,-973,-1388,1
5253,-1158,-1281,1511.4,15114,17597,6.8,2,2,2,219,21.9,0,0,0,1,1,231,23.1,2,6,7,7,7.2,18878,16272,1627.2,1281,1158,0
5254,1619,-575,1823.4,18234,17526,6.6,6,6,8,205,20.5,1,0,0,1,0,209,20.9,0,5,8,8,7.0,18101,16615,1661.5,575,-1619,0
5255,-299,454,1606.1,16061,18335,7.2,4,4,3,228,22.8,1,1,1,0,0,225,22.5,0,5,6,6,6.6,17881,16360,1636.0,-454,299,0
5256,1176,763,1582.8,15828,17834,6.8,6,6,4,218,21.8,0,0,0,1,1,218,21.8,1,2,2,2,6.8,17071,14652,1465.2,-763,-1176,0
5257,-943,140,1576.7,15767,18720,7.2,3,3,3,233,23.3,0,0,0,1,1,249,24.9,1,5,5,5,7.2,18580,16710,1671.0,-140,943,0
5258,-1449,-777,1646.0,16460,18464,7.0,7,7,5,202,20.2,1,1,0,1,0,236,23.6,1,4,8,8,7.4,19241,17909,1790.9,777,1449,0
5259,-1531,-2275,1613.8,16138,17604,7.0,4,4,3,217,21.7,0,0,0,1,0,228,22.8,0,7,8,8,7.4,19879,17669,1766.9,2275,1531,0
5260,-672,-335,1648.2,16482,17043,6.6,7,7,6,229,22.9,1,1,0,1,0,190,19.0,1,13,8,8,6.8,17378,17154,1715.4,335,672,0
5261,-384,-2030,1565.6,15656,16766,6.6,5,5,8,230,23.0,0,0,1,0,1,233,23.3,1,2,5,5,7.0,18796,16040,1604.0,2030,384,0
5262,2485,2934,1728.1,17281,20413,7.4,8,8,7,219,21.9,1,0,1,0,1,207,20.7,1,4,2,2,6.8,17479,14796,1479.6,-2934,-2485,0
5263,4197,3107,1819.5,18195,20319,7.4,7,7,6,252,25.2,1,1,1,0,0,187,18.7,1,1,3,3,6.8,17212,13998,1399.8,-3107,-4197,1
5264,-1744,-1555,1405.4,14054,17175,6.6,1,1,2,205,20.5,0,0,0,1,1,232,23.2,1,3,3,3,7.0,18730,15798,1579.8,1555,1744,0
5265,654,478,1719.1,17191,17401,6.8,8,8,13,188,18.8,0,0,1,0,1,191,19.1,1,9,8,8,6.6,16923,16537,1653.7,-478,-654,0
5266,4389,5412,1922.6,19226,20579,7.4,12,12,12,228,22.8,1,1,0,1,0,217,21.7,0,5,3,3,6.4,15167,14837,1483.7,-5412,-4389,1
5267,3692,4028,1870.5,18705,19808,7.4,12,12,13,210,21.0,1,1,1,0,0,219,21.9,0,5,4,4,6.4,15780,15013,1501.3,-4028,-3692,1
5268,172,-278,1605.7,16057,17977,7.0,6,6,7,231,23.1,1,1,0,1,0,242,24.2,1,7,4,4,7.0,18255,15885,1588.5,278,-172,1
5269,-488,-98,1572.2,15722,17153,6.8,5,5,3,224,22.4,0,0,0,1,1,192,19.2,1,7,6,6,6.8,17251,16210,1621.0,98,488,0
5270,-1791,507,1551.3,15513,17308,6.6,5,5,7,203,20.3,0,0,0,1,1,225,22.5,2,14,8,8,6.8,16801,17304,1730.4,-507,1791,0
5271,-3225,-1705,1496.4,14964,17465,6.6,5,5,3,196,19.6,0,0,0,1,1,249,24.9,2,6,9,9,7.4,19170,18189,1818.9,1705,3225,0
5272,2367,-249,1667.8,16678,16861,6.6,8,8,6,196,19.6,1,1,1,0,0,219,21.9,0,3,4,4,6.4,17110,14311,1431.1,249,-2367,1
5273,1797,-723,1823.8,18238,16827,6.8,12,12,18,189,18.9,0,0,1,0,1,190,19.0,1,5,8,8,6.8,17550,16441,1644.1,723,-1797,0
5274,-1356,-1064,1675.8,16758,17743,7.0,6,6,9,243,24.3,0,0,1,0,0,207,20.7,0,15,10,10,7.2,18807,18114,1811.4,1064,1356,0
5275,-207,-251,1654.5,16545,19148,7.2,5,5,4,235,23.5,0,0,0,1,1,235,23.5,1,6,5,5,7.2,19399,16752,1675.2,251,207,1
5276,-2691,-1778,1484.3,14843,16207,6.4,4,4,2,176,17.6,1,1,0,1,0,199,19.9,1,12,10,10,7.2,17985,17534,1753.4,1778,2691,0
5277,3734,2743,1745.9,17459,18810,7.0,6,6,3,226,22.6,2,1,0,1,0,198,19.8,0,1,1,1,6.4,16067,13725,1372.5,-2743,-3734,1
5278,567,-789,1587.8,15878,16090,6.6,7,7,10,187,18.7,0,0,0,1,0,220,22.0,0,7,6,6,6.6,16879,15311,1531.1,789,-567,0
5279,-892,-818,1446.2,14462,17760,7.0,2,2,2,213,21.3,1,1,0,1,0,240,24.0,0,3,3,3,7.0,18578,15354,1535.4,818,892,0
5280,-3231,-3010,1478.8,14788,15674,6.4,3,3,3,194,19.4,0,0,0,1,1,220,22.0,1,14,10,10,7.4,18684,18019,1801.9,3010,3231,0
5281,1591,1901,1787.1,17871,18848,7.4,8,8,5,243,24.3,0,0,0,1,1,197,19.7,1,11,8,8,6.6,16947,16280,1628.0,-1901,-1591,1
5282,1998,572,1808.0,18080,18120,7.0,10,10,16,219,21.9,0,0,0,1,0,225,22.5,0,8,6,6,6.6,17548,16082,1608.2,-572,-1998,0
5283,-7839,-3333,1326.8,13268,15564,6.2,2,2,1,170,17.0,0,0,0,1,1,253,25.3,2,12,10,10,7.2,18897,21107,2110.7,3333,7839,0
5284,3222,1012,1829.1,18291,18572,7.0,8,8,13,235,23.5,1,1,1,0,0,232,23.2,0,2,3,3,7.2,17560,15069,1506.9,-1012,-3222,1
5285,1715,1548,1679.5,16795,19215,7.2,7,7,13,238,23.8,1,1,0,1,0,254,25.4,1,1,1,1,7.0,17667,15080,1508.0,-1548,-1715,1
5286,-5088,-2609,1360.2,13602,15564,6.4,3,3,1,170,17.0,0,0,0,1,1,231,23.1,1,16,11,11,7.2,18173,18690,1869.0,2609,5088,0
5287,1082,14,1916.2,19162,17841,7.0,9,9,8,196,19.6,1,0,0,1,1,203,20.3,1,16,10,10,6.8,17827,18080,1808.0,-14,-1082,1
5288,1887,519,1725.3,17253,18869,7.2,8,8,12,218,21.8,0,0,1,0,1,233,23.3,1,3,2,2,7.0,18350,15366,1536.6,-519,-1887,1
5289,2795,999,1971.3,19713,18607,7.0,13,13,14,217,21.7,0,0,1,0,0,177,17.7,0,8,7,7,6.8,17608,16918,1691.8,-999,-2795,1
5290,549,224,1567.5,15675,16501,6.4,5,5,8,218,21.8,0,0,0,1,1,170,17.0,1,7,5,5,6.6,16277,15126,1512.6,-224,-549,0
5291,96,466,1569.1,15691,18589,7.2,4,4,4,237,23.7,0,0,0,1,0,221,22.1,0,2,6,6,6.8,18123,15595,1559.5,-466,-96,1
5292,-1015,-1751,1500.8,15008,16888,6.6,4,4,3,214,21.4,0,0,0,1,1,208,20.8,1,4,6,6,6.8,18639,16023,1602.3,1751,1015,0
5293,2474,1015,1686.7,16867,18156,7.2,7,7,10,232,23.2,1,1,1,0,0,230,23.0,0,2,2,2,6.6,17141,14393,1439.3,-1015,-2474,1
5294,-111,1062,1710.4,17104,18350,7.0,8,8,7,223,22.3,1,1,0,1,0,201,20.1,1,8,6,6,6.8,17288,17215,1721.5,-1062,111,1
5295,1375,109,1773.1,17731,18132,6.8,8,8,13,232,23.2,1,1,1,0,0,206,20.6,0,4,6,6,6.8,18023,16356,1635.6,-109,-1375,0
5296,-2507,-1567,1375.1,13751,17182,6.8,1,1,0,199,19.9,0,0,0,1,1,269,26.9,1,3,3,3,7.2,18749,16258,1625.8,1567,2507,0
5297,201,-979,1554.4,15544,17440,6.6,4,4,6,217,21.7,1,1,1,0,0,214,21.4,0,3,4,4,7.0,18419,15343,1534.3,979,-201,0
5298,3152,2104,1805.7,18057,18682,7.0,8,8,8,231,23.1,1,0,0,1,0,211,21.1,0,4,4,4,6.4,16578,14905,1490.5,-2104,-3152,0
5299,120,-497,1632.1,16321,19044,7.4,5,5,8,227,22.7,0,0,1,0,1,216,21.6,1,4,5,5,7.4,19541,16201,1620.1,497,-120,0
5300,1377,-221,1739.4,17394,17390,6.8,8,8,7,199,19.9,0,0,1,0,1,218,21.8,2,5,6,6,6.8,17611,16017,1601.7,221,-1377,1
5301,3071,2643,1762.2,17622,19582,7.2,7,7,7,230,23.0,1,0,1,0,0,220,22.0,0,4,3,3,6.6,16939,14551,1455.1,-2643,-3071,1
5302,6148,3541,2012.7,20127,19673,7.2,10,10,8,251,25.1,1,1,1,0,0,196,19.6,0,1,2,2,6.4,16132,13979,1397.9,-3541,-6148,1
5303,295,791,1580.0,15800,17445,6.8,4,4,5,209,20.9,1,1,1,0,0,206,20.6,1,3,2,2,6.8,16654,15505,1550.5,-791,-295,1
5304,451,1157,1572.3,15723,17400,6.8,5,5,3,242,24.2,0,0,1,0,0,234,23.4,0,5,5,5,6.8,16243,15272,1527.2,-1157,-451,1
5305,732,280,1654.4,16544,17758,6.8,7,7,11,196,19.6,0,0,0,1,1,199,19.9,1,5,5,5,6.8,17478,15812,1581.2,-280,-732,1
5306,920,-386,1775.8,17758,17663,6.8,8,8,14,233,23.3,0,0,0,1,1,214,21.4,1,5,7,7,6.8,18049,16838,1683.8,386,-920,0
5307,-2039,-2297,1589.0,15890,15649,6.6,6,6,8,199,19.9,0,0,0,1,1,223,22.3,1,11,9,9,6.8,17946,17929,1792.9,2297,2039,0
5308,-5036,-2248,1464.6,14646,16931,6.6,2,2,2,219,21.9,0,0,0,1,1,262,26.2,2,12,9,9,7.4,19179,19682,1968.2,2248,5036,0
5309,-540,1330,1689.8,16898,17791,7.0,9,9,6,211,21.1,1,1,0,1,0,190,19.0,0,14,10,10,6.6,16461,17438,1743.8,-1330,540,0
5310,-1319,-840,1752.4,17524,18124,7.2,9,9,12,203,20.3,1,0,0,1,1,223,22.3,1,13,10,10,7.4,18964,18843,1884.3,840,1319,0
5311,2555,2123,1654.1,16541,17099,6.4,7,7,11,231,23.1,0,0,1,0,0,146,14.6,0,6,5,5,6.2,14976,13986,1398.6,-2123,-2555,1
5312,-2663,-2578,1456.6,14566,13119,5.8,5,5,7,164,16.4,1,1,1,0,0,209,20.9,0,14,8,8,6.6,15697,17229,1722.9,2578,2663,0
5313,17,44,1592.9,15929,18680,7.2,3,3,2,250,25.0,1,0,1,0,1,203,20.3,1,3,5,5,7.0,18636,15912,1591.2,-44,-17,1
5314,-859,-1186,1586.6,15866,17209,6.6,6,6,6,207,20.7,0,0,1,0,0,245,24.5,0,10,6,6,7.2,18395,16725,1672.5,1186,859,0
5315,61,1120,1612.6,16126,18201,7.0,5,5,6,217,21.7,0,0,1,0,1,203,20.3,1,7,6,6,6.8,17081,16065,1606.5,-1120,-61,0
5316,-1761,-385,1562.0,15620,18558,7.2,4,4,0,239,23.9,1,0,1,0,1,243,24.3,1,8,4,4,7.4,18943,17381,1738.1,385,1761,1
5317,1076,1282,1752.4,17524,18949,7.2,9,9,12,185,18.5,1,1,0,1,0,209,20.9,0,6,7,7,6.6,17667,16448,1644.8,-1282,-1076,1
5318,2198,1355,1874.6,18746,19066,7.2,11,11,9,225,22.5,0,0,1,0,1,204,20.4,1,4,8,8,6.8,17711,16548,1654.8,-1355,-2198,1
5319,626,98,1718.7,17187,18178,7.0,9,9,7,213,21.3,0,0,1,0,0,231,23.1,0,4,6,6,7.0,18080,16561,1656.1,-98,-626,0
5320,911,449,1518.1,15181,17084,7.0,4,4,4,216,21.6,1,1,0,1,0,223,22.3,0,4,3,3,6.8,16635,14270,1427.0,-449,-911,1
5321,4666,4288,1956.3,19563,19145,7.2,11,11,16,220,22.0,0,0,1,0,0,155,15.5,0,12,6,6,6.2,14857,14897,1489.7,-4288,-4666,1
5322,1167,-431,1919.7,19197,18709,7.2,10,10,12,222,22.2,2,1,0,1,0,219,21.9,0,6,10,10,7.2,19140,18030,1803.0,431,-1167,1
5323,-2454,-1437,1480.3,14803,17434,6.8,5,5,5,177,17.7,0,0,0,1,1,219,21.9,1,6,8,8,7.0,18871,17257,1725.7,1437,2454,0
5324,-3580,-2967,1350.8,13508,15002,6.2,2,2,1,160,16.0,1,0,0,1,1,193,19.3,1,6,7,7,6.6,17969,17088,1708.8,2967,3580,0
5325,4185,3377,1897.8,18978,21014,7.6,10,10,13,262,26.2,0,0,1,0,0,205,20.5,0,3,4,4,6.8,17637,14793,1479.3,-3377,-4185,0
5326,1899,308,1662.7,16627,18254,7.0,6,6,9,247,24.7,0,0,0,1,1,231,23.1,1,0,2,2,6.8,17946,14728,1472.8,-308,-1899,1
5327,-435,-427,1556.2,15562,17869,6.8,4,4,3,225,22.5,0,0,0,1,1,196,19.6,1,8,7,7,7.0,18296,15997,1599.7,427,435,1
5328,-3025,-1823,1471.7,14717,16410,6.4,4,4,5,205,20.5,1,1,0,1,0,211,21.1,1,5,7,7,7.0,18233,17742,1774.2,1823,3025,0
5329,-3035,188,1621.3,16213,18890,7.2,4,4,3,208,20.8,0,0,0,1,1,217,21.7,2,5,7,7,7.0,18702,19248,1924.8,-188,3035,0
5330,118,-532,1692.2,16922,17511,7.0,8,8,11,191,19.1,0,0,1,0,1,193,19.3,1,12,8,8,7.0,18043,16804,1680.4,532,-118,0
5331,1004,1446,1709.4,17094,18539,7.0,7,7,9,220,22.0,0,0,0,1,1,211,21.1,1,3,5,5,6.6,17093,16090,1609.0,-1446,-1004,0
5332,725,626,1723.2,17232,17777,7.0,9,9,5,212,21.2,1,1,0,1,0,191,19.1,0,7,8,8,7.0,17151,16507,1650.7,-626,-725,1
5333,3316,2032,1952.9,19529,19979,7.6,12,12,10,242,24.2,1,1,1,0,0,197,19.7,0,6,6,6,6.8,17947,16213,1621.3,-2032,-3316,1
5334,-1400,-644,1568.4,15684,17100,6.6,7,7,2,203,20.3,0,0,1,0,1,208,20.8,1,10,8,8,7.0,17744,17084,1708.4,644,1400,0
5335,1824,1204,1635.2,16352,19028,7.2,5,5,5,250,25.0,1,1,0,1,0,239,23.9,0,2,1,1,7.0,17824,14528,1452.8,-1204,-1824,1
5336,817,350,1678.2,16782,19622,7.0,6,6,6,238,23.8,1,0,1,0,1,235,23.5,1,5,5,5,7.2,19272,15965,1596.5,-350,-817,0
5337,3170,1984,1751.4,17514,17672,7.0,9,9,9,236,23.6,0,0,1,0,0,175,17.5,0,6,4,4,6.6,15688,14344,1434.4,-1984,-3170,1
5338,-6,1004,1733.2,17332,18724,7.0,7,7,7,226,22.6,0,0,0,1,1,188,18.8,2,9,7,7,6.8,17720,17338,1733.8,-1004,6,0
5339,2896,1330,1895.1,18951,17892,7.0,10,10,12,204,20.4,0,0,1,0,0,196,19.6,0,7,6,6,6.8,16562,16055,1605.5,-1330,-2896,1
5340,4991,3364,1803.9,18039,18984,7.2,7,7,6,236,23.6,1,1,1,0,0,193,19.3,0,0,0,0,6.2,15620,13048,1304.8,-3364,-4991,1
5341,-2639,-953,1448.7,14487,17499,7.0,2,2,3,229,22.9,1,0,0,1,1,227,22.7,1,5,7,7,7.0,18452,17126,1712.6,953,2639,0
5342,2087,650,1839.8,18398,19201,7.0,8,8,13,234,23.4,2,1,0,1,0,226,22.6,0,3,5,5,7.0,18551,16311,1631.1,-650,-2087,1
5343,-1933,15,1500.7,15007,17592,6.8,1,1,1,251,25.1,1,0,0,1,1,215,21.5,1,10,5,5,7.0,17577,16940,1694.0,-15,1933,1
5344,2975,3977,1611.7,16117,19109,7.2,5,5,0,221,22.1,1,1,1,0,0,182,18.2,0,1,1,1,6.2,15132,13142,1314.2,-3977,-2975,0
5345,2783,1603,1745.7,17457,18210,7.0,6,6,8,251,25.1,0,0,1,0,1,190,19.0,2,8,5,5,6.6,16607,14674,1467.4,-1603,-2783,0
5346,-1555,-1025,1571.6,15716,17691,6.8,4,4,5,235,23.5,1,1,1,0,0,237,23.7,1,4,4,4,7.0,18716,17271,1727.1,1025,1555,0
5347,-2565,-1593,1598.0,15980,17313,7.0,6,6,8,207,20.7,1,1,0,1,0,235,23.5,1,9,8,8,7.0,18906,18545,1854.5,1593,2565,1
5348,-673,-48,1536.4,15364,18462,7.0,1,1,1,233,23.3,1,1,0,1,0,206,20.6,0,6,5,5,7.0,18510,16037,1603.7,48,673,0
5349,4012,3080,1908.2,19082,20858,7.6,11,11,13,244,24.4,1,0,1,0,0,230,23.0,0,2,2,2,6.8,17778,15070,1507.0,-3080,-4012,1
5350,-981,-994,1567.1,15671,17411,6.8,5,5,6,205,20.5,1,1,1,0,0,219,21.9,0,8,7,7,6.8,18405,16652,1665.2,994,981,1
5351,-4557,-3571,1432.1,14321,16982,6.8,2,2,0,208,20.8,0,0,0,1,0,260,26.0,0,8,9,9,7.2,20553,18878,1887.8,3571,4557,0
5352,811,241,1590.3,15903,17896,6.8,5,5,7,206,20.6,0,0,0,1,0,199,19.9,0,2,5,5,7.0,17655,15092,1509.2,-241,-811,0
5353,6375,3949,2082.8,20828,19032,7.2,15,15,17,250,25.0,0,0,1,0,0,164,16.4,0,5,4,4,6.2,15083,14453,1445.3,-3949,-6375,1
5354,557,1853,1744.2,17442,18411,7.0,9,9,7,219,21.9,1,1,0,1,0,190,19.0,0,8,9,9,6.6,16558,16885,1688.5,-1853,-557,1
5355,3183,1321,2061.7,20617,19936,7.4,13,13,19,240,24.0,1,0,0,1,1,235,23.5,1,7,6,6,7.0,18615,17434,1743.4,-1321,-3183,1
5356,-1148,-818,1369.1,13691,16957,6.8,0,0,0,229,22.9,0,0,0,1,0,221,22.1,0,2,3,3,6.8,17775,14839,1483.9,818,1148,1
5357,-447,676,1490.9,14909,17001,6.8,3,3,2,208,20.8,1,0,0,1,0,197,19.7,0,6,4,4,6.6,16325,15356,1535.6,-676,447,0
5358,53,-48,1637.2,16372,16747,6.6,5,5,5,230,23.0,0,0,0,1,1,186,18.6,1,8,8,8,6.8,16795,16319,1631.9,48,-53,0
5359,-840,949,1713.4,17134,17579,6.8,8,8,15,171,17.1,1,1,0,1,0,214,21.4,0,11,10,10,6.8,16630,17974,1797.4,-949,840,0
5360,1187,285,1564.8,15648,17420,6.8,4,4,7,216,21.6,1,0,1,0,1,215,21.5,1,2,2,2,6.6,17135,14461,1446.1,-285,-1187,1
5361,-1753,-1095,1627.9,16279,18734,7.0,6,6,6,226,22.6,1,1,0,1,0,253,25.3,0,6,10,10,7.0,19829,18032,1803.2,1095,1753,1
5362,-172,1613,1725.1,17251,19522,7.0,7,7,9,225,22.5,0,0,0,1,0,224,22.4,0,9,7,7,6.8,17909,17423,1742.3,-1613,172,1
5363,777,1580,1733.0,17330,18821,7.2,6,6,6,226,22.6,1,1,1,0,0,195,19.5,0,13,7,7,6.8,17241,16553,1655.3,-1580,-777,1
5364,1906,1369,1765.5,17655,18905,7.2,11,11,13,208,20.8,1,1,1,0,0,221,22.1,0,3,3,3,7.0,17536,15749,1574.9,-1369,-1906,1
5365,2310,1946,1725.8,17258,17683,6.8,8,8,10,216,21.6,0,0,0,1,0,176,17.6,0,5,5,5,6.6,15737,14948,1494.8,-1946,-2310,1
5366,-1213,-276,1372.9,13729,14661,6.2,3,3,0,180,18.0,0,0,0,1,1,161,16.1,2,10,5,5,6.4,14937,14942,1494.2,276,1213,0
5367,2488,2722,1855.5,18555,20361,7.4,10,10,8,246,24.6,1,0,0,1,1,185,18.5,1,6,6,6,6.8,17639,16067,1606.7,-2722,-2488,1
5368,1399,2616,1702.5,17025,19492,7.4,9,9,5,214,21.4,1,0,0,1,0,181,18.1,0,5,6,6,6.6,16876,15626,1562.6,-2616,-1399,1
5369,1376,1018,1752.8,17528,18106,6.8,6,6,9,216,21.6,0,0,0,1,1,217,21.7,1,5,6,6,6.8,17088,16152,1615.2,-1018,-1376,1
5370,265,241,1582.9,15829,17888,7.2,6,6,5,205,20.5,1,1,1,0,0,204,20.4,1,1,3,3,6.8,17647,15564,1556.4,-241,-265,1
5371,-1782,-1311,1613.5,16135,18177,7.0,4,4,6,234,23.4,1,0,0,1,1,264,26.4,1,8,7,7,7.2,19488,17917,1791.7,1311,1782,0
5372,-535,-691,1578.1,15781,17957,6.8,5,5,5,221,22.1,1,1,1,0,0,240,24.0,0,7,5,5,7.0,18648,16316,1631.6,691,535,1
5373,-727,-675,1653.3,16533,17850,7.0,7,7,8,198,19.8,0,0,1,0,1,224,22.4,1,7,6,6,7.0,18525,17260,1726.0,675,727,0
5374,3805,3162,1827.0,18270,19486,7.4,10,10,9,238,23.8,1,1,1,0,0,199,19.9,0,4,4,4,6.6,16324,14465,1446.5,-3162,-3805,1
5375,5797,4456,1967.3,19673,21261,7.6,11,11,10,209,20.9,1,1,1,0,0,218,21.8,0,0,1,1,6.8,16805,13876,1387.6,-4456,-5797,1
5376,3539,2952,1762.8,17628,18793,7.2,8,8,8,231,23.1,0,0,1,0,0,195,19.5,0,4,3,3,6.4,15841,14089,1408.9,-2952,-3539,1
5377,-3183,-1884,1637.5,16375,17469,6.8,7,7,7,177,17.7,1,0,0,1,0,236,23.6,0,9,10,10,7.2,19353,19558,1955.8,1884,3183,1
5378,-4033,-1850,1453.3,14533,17818,6.8,3,3,2,198,19.8,0,0,0,1,1,220,22.0,1,9,8,8,7.2,19668,18566,1856.6,1850,4033,0
5379,-1176,-671,1606.7,16067,17256,6.8,6,6,8,190,19.0,0,0,1,0,1,220,22.0,2,7,7,7,7.2,17927,17243,1724.3,671,1176,0
5380,-1402,-2295,1474.0,14740,16655,6.6,3,3,2,201,20.1,2,1,1,0,0,233,23.3,0,9,6,6,7.0,18950,16142,1614.2,2295,1402,1
5381,761,830,1656.0,16560,18547,7.0,5,5,7,225,22.5,0,0,1,0,1,225,22.5,1,8,5,5,6.8,17717,15799,1579.9,-830,-761,0
5382,1038,454,1697.9,16979,17700,6.8,7,7,8,228,22.8,0,0,1,0,1,174,17.4,1,4,8,8,6.8,17246,15941,1594.1,-454,-1038,0
5383,-6402,-4189,1408.1,14081,15129,6.4,3,3,5,207,20.7,0,0,0,1,1,233,23.3,1,22,16,16,7.2,19318,20483,2048.3,4189,6402,0
5384,-5427,-4559,1351.1,13511,14048,5.8,3,3,7,164,16.4,0,0,0,1,1,239,23.9,1,14,11,11,7.2,18607,18938,1893.8,4559,5427,0
5385,-194,431,1795.1,17951,17922,6.8,8,8,11,226,22.6,0,0,1,0,0,227,22.7,0,12,9,9,6.8,17491,18145,1814.5,-431,194,0
5386,-2263,-1397,1420.2,14202,16773,6.8,3,3,1,212,21.2,0,0,0,1,1,240,24.0,1,4,4,4,6.8,18170,16465,1646.5,1397,2263,1
5387,1693,1979,1829.1,18291,17873,6.8,12,12,10,208,20.8,1,0,0,1,0,180,18.0,0,11,9,9,6.4,15894,16598,1659.8,-1979,-1693,0
5388,-2231,-857,1559.9,15599,16288,6.4,4,4,5,219,21.9,1,0,0,1,1,214,21.4,1,16,9,9,6.8,17145,17830,1783.0,857,2231,0
5389,3362,3874,1826.5,18265,20351,7.6,11,11,7,237,23.7,1,1,1,0,0,187,18.7,0,2,4,4,6.6,16477,14903,1490.3,-3874,-3362,1
5390,2840,1792,1888.8,18888,18915,7.0,11,11,10,204,20.4,1,0,0,1,1,205,20.5,1,8,5,5,6.8,17123,16048,1604.8,-1792,-2840,1
5391,-2606,-3164,1642.2,16422,17598,6.8,7,7,7,206,20.6,0,0,0,1,1,243,24.3,1,8,9,9,7.6,20762,19028,1902.8,3164,2606,0
5392,1884,1452,1809.0,18090,18642,7.2,9,9,11,216,21.6,0,0,0,1,0,190,19.0,0,8,7,7,7.0,17190,16206,1620.6,-1452,-1884,1
5393,2849,1925,1760.2,17602,19787,7.4,6,6,3,251,25.1,1,1,1,0,0,196,19.6,0,3,3,3,6.8,17862,14753,1475.3,-1925,-2849,1
5394,-3756,-3280,1399.1,13991,16073,6.4,3,3,4,203,20.3,0,0,0,1,0,256,25.6,0,4,7,7,7.2,19353,17747,1774.7,3280,3756,1
5395,2577,2588,1738.9,17389,18459,7.2,11,11,7,221,22.1,1,1,0,1,0,218,21.8,1,2,2,2,6.6,15871,14812,1481.2,-2588,-2577,1
5396,-1777,52,1558.6,15586,18599,7.0,4,4,3,229,22.9,1,1,0,1,0,244,24.4,0,7,7,7,7.2,18547,17363,1736.3,-52,1777,1
5397,-1526,-1082,1527.9,15279,18355,7.0,2,2,2,236,23.6,1,0,0,1,1,236,23.6,1,10,7,7,7.4,19437,16805,1680.5,1082,1526,0
5398,338,-232,1701.6,17016,18560,7.2,9,9,7,210,21.0,1,1,1,0,0,212,21.2,0,7,6,6,7.0,18792,16678,1667.8,232,-338,1
5399,-758,920,1617.1,16171,18471,7.0,4,4,5,240,24.0,0,0,0,1,0,208,20.8,0,8,7,7,6.8,17551,16929,1692.9,-920,758,1
5400,5062,1996,1912.7,19127,19350,7.2,9,9,12,253,25.3,1,1,1,0,0,215,21.5,1,1,1,1,6.6,17354,14065,1406.5,-1996,-5062,1
5401,3367,1963,1796.2,17962,17698,7.0,11,11,10,191,19.1,2,1,1,0,0,185,18.5,0,6,5,5,6.4,15735,14595,1459.5,-1963,-3367,0
5402,-4591,-1620,1458.0,14580,16446,6.6,3,3,4,203,20.3,1,1,0,1,0,241,24.1,0,6,8,8,6.8,18066,19171,1917.1,1620,4591,0
5403,121,264,1571.6,15716,19033,7.2,3,3,3,251,25.1,1,0,1,0,1,255,25.5,1,1,2,2,7.0,18769,15595,1559.5,-264,-121,0
5404,-1635,-1467,1396.2,13962,16214,6.8,2,2,1,215,21.5,0,0,0,1,0,193,19.3,1,3,6,6,7.0,17681,15597,1559.7,1467,1635,0
5405,4756,3562,1851.9,18519,18891,7.2,9,9,11,260,26.0,1,1,1,0,0,196,19.6,0,3,3,3,6.4,15329,13763,1376.3,-3562,-4756,1
5406,3848,2704,1855.7,18557,19603,7.2,10,10,12,235,23.5,2,1,1,0,0,200,20.0,0,3,3,3,6.6,16899,14709,1470.9,-2704,-3848,1
5407,463,275,1679.3,16793,19426,7.0,6,6,6,233,23.3,0,0,1,0,1,224,22.4,1,7,5,5,7.4,19151,16330,1633.0,-275,-463,1
5408,3305,2586,1916.9,19169,19642,7.4,10,10,8,235,23.5,1,0,0,1,1,215,21.5,1,6,5,5,7.0,17056,15864,1586.4,-2586,-3305,0
5409,2473,565,1993.3,19933,18730,7.2,12,12,15,219,21.9,1,1,1,0,0,200,20.0,0,8,7,7,7.0,18165,17460,1746.0,-565,-2473,1
5410,153,713,1639.1,16391,18597,7.2,4,4,5,233,23.3,1,1,0,1,0,236,23.6,0,8,5,5,7.0,17884,16238,1623.8,-713,-153,0
5411,3125,1784,1734.0,17340,19234,7.2,7,7,12,229,22.9,1,1,1,0,0,219,21.9,0,2,2,2,6.8,17450,14215,1421.5,-1784,-3125,1
5412,2352,133,1986.1,19861,18934,7.2,12,12,16,220,22.0,0,0,1,0,1,183,18.3,2,12,11,11,7.2,18801,17509,1750.9,-133,-2352,1
5413,-454,23,1627.3,16273,18638,7.2,4,4,3,246,24.6,2,1,0,1,0,204,20.4,0,6,9,9,7.2,18615,16727,1672.7,-23,454,0
5414,-1840,-2402,1559.5,15595,17384,6.8,5,5,6,206,20.6,1,0,0,1,1,242,24.2,1,11,7,7,7.4,19786,17435,1743.5,2402,1840,0
5415,900,-802,1742.9,17429,17332,7.0,8,8,10,209,20.9,2,1,1,0,0,217,21.7,0,6,7,7,7.0,18134,16529,1652.9,802,-900,0
5416,96,-21,1652.4,16524,18962,7.0,5,5,7,245,24.5,0,0,1,0,1,257,25.7,2,6,5,5,7.0,18983,16428,1642.8,21,-96,0
5417,-2004,-1407,1529.3,15293,16350,6.6,4,4,5,226,22.6,0,0,0,1,0,227,22.7,1,12,9,9,6.8,17757,17297,1729.7,1407,2004,0
5418,-2761,-2185,1398.8,13988,15917,6.2,3,3,3,174,17.4,0,0,0,1,1,242,24.2,1,11,5,5,7.0,18102,16749,1674.9,2185,2761,0
5419,-633,-1323,1555.7,15557,17180,6.8,4,4,2,234,23.4,1,1,1,0,0,206,20.6,0,6,5,5,7.0,18503,16190,1619.0,1323,633,1
5420,-1558,-1782,1522.7,15227,17701,7.0,3,3,4,231,23.1,0,0,0,1,1,244,24.4,2,6,6,6,7.0,19483,16785,1678.5,1782,1558,0
5421,393,-1055,1637.8,16378,16837,6.8,8,8,8,178,17.8,1,1,1,0,0,227,22.7,0,3,3,3,6.8,17892,15985,1598.5,1055,-393,0
5422,-873,308,1600.7,16007,17830,7.0,7,7,6,204,20.4,1,1,0,1,0,215,21.5,0,7,8,8,6.8,17522,16880,1688.0,-308,873,0
5423,1063,553,1793.7,17937,18340,7.0,8,8,11,227,22.7,2,1,1,0,0,226,22.6,0,7,7,7,7.2,17787,16874,1687.4,-553,-1063,1
5424,-3752,-3349,1353.7,13537,15367,6.2,0,0,0,208,20.8,0,0,0,1,1,242,24.2,1,10,8,8,7.4,18716,17289,1728.9,3349,3752,0
5425,1550,2512,1790.7,17907,19438,7.2,9,9,5,231,23.1,1,1,1,0,0,192,19.2,0,10,7,7,6.6,16926,16357,1635.7,-2512,-1550,0
5426,611,381,1605.3,16053,18228,6.8,6,6,7,216,21.6,0,0,1,0,1,208,20.8,1,5,5,5,6.8,17847,15442,1544.2,-381,-611,0
5427,-616,728,1661.6,16616,19302,7.4,5,5,4,240,24.0,0,0,0,1,1,234,23.4,1,9,8,8,7.2,18574,17232,1723.2,-728,616,1
5428,151,1281,1636.7,16367,16065,6.6,8,8,12,202,20.2,2,1,0,1,0,201,20.1,0,18,8,8,6.2,14784,16216,1621.6,-1281,-151,1
5429,1518,-5,1749.4,17494,18057,7.0,9,9,11,205,20.5,0,0,1,0,1,199,19.9,1,5,4,4,7.0,18062,15976,1597.6,5,-1518,1
5430,1241,2416,1770.4,17704,19789,7.2,9,9,10,200,20.0,2,1,1,0,0,230,23.0,0,6,5,5,6.8,17373,16463,1646.3,-2416,-1241,1
5431,780,74,1781.7,17817,17747,6.8,10,10,8,188,18.8,0,0,1,0,0,212,21.2,0,7,9,9,7.0,17673,17037,1703.7,-74,-780,1
5432,-2725,-3568,1794.0,17940,16927,6.8,12,12,15,162,16.2,0,0,1,0,1,252,25.2,1,15,13,13,7.6,20495,20665,2066.5,3568,2725,1
5433,37,-905,1698.8,16988,18153,6.8,6,6,8,223,22.3,1,0,1,0,1,216,21.6,1,5,6,6,7.4,19058,16951,1695.1,905,-37,0
5434,815,590,1766.1,17661,17077,6.6,9,9,8,233,23.3,1,1,0,1,0,191,19.1,0,10,7,7,6.8,16487,16846,1684.6,-590,-815,1
5435,951,2193,1575.5,15755,19845,7.2,4,4,4,225,22.5,0,0,0,1,1,197,19.7,2,2,3,3,7.0,17652,14804,1480.4,-2193,-951,1
5436,-4885,-3111,1539.2,15392,16156,6.4,6,6,6,175,17.5,0,0,0,1,0,233,23.3,1,17,15,15,7.4,19267,20277,2027.7,3111,4885,0
5437,-4527,-3126,1392.5,13925,16354,6.6,2,2,3,198,19.8,0,0,0,1,1,229,22.9,1,8,8,8,7.2,19480,18452,1845.2,3126,4527,0
5438,1239,-1051,1642.1,16421,18152,7.0,5,5,2,241,24.1,1,1,1,0,0,219,21.9,0,2,3,3,7.2,19203,15182,1518.2,1051,-1239,1
5439,-988,-1427,1453.5,14535,16699,6.4,2,2,2,234,23.4,1,1,1,0,0,241,24.1,1,4,3,3,7.0,18126,15523,1552.3,1427,988,1
5440,2216,1580,1708.2,17082,18373,7.0,7,7,6,221,22.1,1,0,1,0,1,208,20.8,1,3,2,2,6.6,16793,14866,1486.6,-1580,-2216,1
5441,-101,-1320,1571.1,15711,17255,6.6,4,4,4,208,20.8,2,1,1,0,0,210,21.0,0,6,5,5,7.2,18575,15812,1581.2,1320,101,0
5442,225,824,1608.7,16087,19195,7.2,4,4,3,224,22.4,1,0,1,0,1,208,20.8,1,5,4,4,7.0,18371,15862,1586.2,-824,-225,1
5443,-4737,-3600,1335.8,13358,15566,6.2,0,0,0,199,19.9,0,0,0,1,1,253,25.3,1,7,7,7,7.2,19166,18095,1809.5,3600,4737,0
5444,3742,3229,1843.8,18438,18924,7.2,11,11,9,212,21.2,1,1,1,0,0,184,18.4,0,6,4,4,6.2,15695,14696,1469.6,-3229,-3742,1
5445,-1866,-1885,1448.5,14485,17287,6.8,2,2,2,220,22.0,1,1,1,0,0,253,25.3,0,4,5,5,7.4,19172,16351,1635.1,1885,1866,0
5446,1997,1560,1622.2,16222,18746,7.0,5,5,3,241,24.1,1,1,1,0,0,234,23.4,0,0,1,1,7.0,17186,14225,1422.5,-1560,-1997,1
5447,-2794,-2624,1462.4,14624,17333,6.8,2,2,1,225,22.5,0,0,1,0,0,231,23.1,0,13,7,7,7.4,19957,17418,1741.8,2624,2794,0
5448,1236,1018,1756.8,17568,16755,6.6,11,11,18,206,20.6,1,1,1,0,0,183,18.3,0,9,8,8,6.4,15737,16332,1633.2,-1018,-1236,1
5449,-13,-1792,1519.8,15198,17316,6.8,2,2,2,235,23.5,1,1,1,0,0,207,20.7,1,3,4,4,7.0,19108,15211,1521.1,1792,13,0
5450,1128,498,1631.3,16313,17824,6.8,4,4,4,240,24.0,0,0,1,0,0,220,22.0,0,5,3,3,6.8,17326,15185,1518.5,-498,-1128,1
5451,-529,-54,1656.0,16560,19116,7.2,5,5,6,235,23.5,0,0,1,0,1,223,22.3,1,8,7,7,7.0,19170,17089,1708.9,54,529,0
5452,-486,-137,1569.3,15693,17777,6.8,5,5,6,210,21.0,0,0,0,1,1,216,21.6,1,5,6,6,7.0,17914,16179,1617.9,137,486,0
5453,-1445,-736,1640.3,16403,18111,7.0,8,8,7,218,21.8,0,0,1,0,0,210,21.0,1,9,10,10,7.0,18847,17848,1784.8,736,1445,1
5454,-2727,-4122,1372.0,13720,16815,6.6,0,0,0,230,23.0,0,0,0,1,1,263,26.3,1,1,4,4,7.6,20937,16447,1644.7,4122,2727,0
5455,1036,-663,1659.9,16599,16723,6.6,7,7,10,201,20.1,1,1,1,0,0,251,25.1,0,1,4,4,6.8,17386,15563,1556.3,663,-1036,0
5456,-799,-588,1536.4,15364,17090,6.8,5,5,5,198,19.8,0,0,0,1,0,242,24.2,0,6,5,5,6.8,17678,16163,1616.3,588,799,0
5457,-4413,-1993,1497.8,14978,16243,6.6,6,6,7,147,14.7,0,0,0,1,1,237,23.7,2,16,10,10,7.0,18236,19391,1939.1,1993,4413,0
5458,-153,79,1697.0,16970,17984,6.8,6,6,4,236,23.6,1,0,1,0,1,223,22.3,1,9,6,6,7.0,17905,17123,1712.3,-79,153,0
5459,-2286,-976,1685.1,16851,17931,6.8,6,6,7,201,20.1,0,0,0,1,0,199,19.9,0,15,12,12,7.0,18907,19137,1913.7,976,2286,0
5460,-1002,-378,1489.3,14893,17322,6.8,4,4,3,203,20.3,0,0,0,1,1,233,23.3,1,4,5,5,6.8,17700,15895,1589.5,378,1002,0
5461,7125,3657,2189.3,21893,21511,7.6,18,18,16,243,24.3,2,1,1,0,0,176,17.6,0,0,6,6,7.2,17854,14768,1476.8,-3657,-7125,1
5462,840,196,1557.4,15574,17788,6.8,5,5,8,230,23.0,1,1,0,1,0,203,20.3,0,1,3,3,7.0,17592,14734,1473.4,-196,-840,1
5463,468,558,1815.5,18155,19429,7.0,6,6,7,231,23.1,1,0,0,1,1,194,19.4,1,11,8,8,7.0,18871,17687,1768.7,-558,-468,1
5464,248,582,1646.9,16469,18105,7.0,8,8,8,192,19.2,1,1,0,1,0,225,22.5,0,10,5,5,6.6,17523,16221,1622.1,-582,-248,1
5465,-3832,-3324,1398.3,13983,15892,6.4,1,1,2,214,21.4,0,0,0,1,1,276,27.6,2,4,5,5,7.0,19216,17815,1781.5,3324,3832,0
5466,8284,4654,2247.2,22472,20870,7.6,14,14,19,251,25.1,1,1,1,0,0,202,20.2,0,5,3,3,6.6,16216,14188,1418.8,-4654,-8284,1
5467,1295,1167,1680.7,16807,19637,7.4,6,6,3,222,22.2,0,0,1,0,1,237,23.7,1,2,2,2,7.2,18470,15512,1551.2,-1167,-1295,1
5468,-3331,-3464,1499.6,14996,15901,6.4,5,5,4,188,18.8,1,1,0,1,0,218,21.8,1,11,9,9,7.2,19365,18327,1832.7,3464,3331,1
5469,1049,811,1747.7,17477,18070,6.8,7,7,8,186,18.6,2,1,0,1,0,228,22.8,0,4,5,5,6.6,17259,16428,1642.8,-811,-1049,1
5470,-1305,-2023,1581.0,15810,16837,6.6,7,7,5,193,19.3,1,1,1,0,0,189,18.9,0,5,8,8,7.2,18860,17115,1711.5,2023,1305,0
5471,-3739,-3541,1398.0,13980,15030,6.2,3,3,5,193,19.3,0,0,0,1,1,246,24.6,2,9,8,8,7.2,18571,17719,1771.9,3541,3739,0
5472,-252,77,1572.6,15726,17245,7.0,5,5,7,203,20.3,2,1,1,0,0,212,21.2,0,9,5,5,6.6,17168,15978,1597.8,-77,252,1
5473,-809,411,1515.3,15153,18629,7.2,5,5,3,191,19.1,0,0,0,1,1,216,21.6,1,5,5,5,7.0,18218,15962,1596.2,-411,809,0
5474,-2062,-1466,1469.5,14695,17431,6.8,2,2,2,228,22.8,0,0,1,0,1,246,24.6,1,6,5,5,7.0,18897,16757,1675.7,1466,2062,0
5475,-84,570,1610.6,16106,18323,7.0,7,7,8,207,20.7,1,1,0,1,0,207,20.7,0,4,7,7,7.0,17753,16190,1619.0,-570,84,0
5476,628,-243,1649.3,16493,18450,7.2,6,6,6,231,23.1,0,0,1,0,1,212,21.2,1,6,4,4,7.0,18693,15865,1586.5,243,-628,1
5477,1344,2079,1709.9,17099,19592,7.2,9,9,13,225,22.5,0,0,0,1,1,238,23.8,1,2,5,5,6.8,17513,15755,1575.5,-2079,-1344,1
5478,-3848,-2091,1521.1,15211,17951,6.8,4,4,3,225,22.5,1,1,0,1,0,238,23.8,1,14,9,9,7.2,20042,19059,1905.9,2091,3848,0
5479,1515,590,1664.3,16643,18300,7.0,6,6,7,215,21.5,1,1,1,0,0,207,20.7,0,4,4,4,6.8,17710,15128,1512.8,-590,-1515,0
5480,462,1726,1658.1,16581,18360,7.0,7,7,4,198,19.8,0,0,0,1,0,200,20.0,0,8,7,7,6.6,16634,16119,1611.9,-1726,-462,0
5481,1058,1196,1795.3,17953,18823,7.0,10,10,16,190,19.0,1,1,1,0,0,206,20.6,0,9,7,7,6.6,17627,16895,1689.5,-1196,-1058,1
5482,-554,-483,1611.2,16112,17371,6.8,6,6,4,197,19.7,0,0,1,0,1,206,20.6,1,10,8,8,7.0,17854,16666,1666.6,483,554,0
5483,-460,-842,1563.7,15637,16107,6.6,5,5,4,201,20.1,0,0,1,0,0,218,21.8,0,9,7,7,6.8,16949,16097,1609.7,842,460,1
5484,-1130,-347,1597.7,15977,18136,6.8,5,5,4,206,20.6,0,0,1,0,1,230,23.0,1,8,7,7,7.2,18483,17107,1710.7,347,1130,0
5485,-3919,-3135,1393.2,13932,14927,6.0,2,2,2,197,19.7,1,0,0,1,0,205,20.5,0,16,9,9,7.0,18062,17851,1785.1,3135,3919,0
5486,-677,-67,1620.6,16206,17669,6.8,6,6,10,221,22.1,0,0,0,1,1,245,24.5,1,10,6,6,6.8,17736,16883,1688.3,67,677,1
5487,-819,-1926,1616.3,16163,16772,6.8,5,5,7,190,19.0,0,0,1,0,0,225,22.5,0,8,9,9,7.0,18698,16982,1698.2,1926,819,0
5488,733,810,1529.6,15296,16908,6.8,5,5,3,187,18.7,1,1,0,1,0,204,20.4,0,1,4,4,6.2,16098,14563,1456.3,-810,-733,1
5489,-847,-267,1596.6,15966,18157,7.0,5,5,9,209,20.9,0,0,0,1,1,203,20.3,1,8,8,8,7.2,18424,16813,1681.3,267,847,1
5490,737,1094,1555.5,15555,19704,7.4,4,4,0,214,21.4,0,0,1,0,1,235,23.5,1,2,2,2,7.2,18610,14818,1481.8,-1094,-737,0
5491,1891,603,1604.1,16041,18214,7.0,4,4,5,233,23.3,1,1,0,1,0,214,21.4,0,1,1,1,7.0,17611,14150,1415.0,-603,-1891,1
5492,-3130,-2448,1523.9,15239,16561,6.6,5,5,7,194,19.4,0,0,0,1,1,236,23.6,1,13,9,9,7.2,19009,18369,1836.9,2448,3130,0
5493,147,-1425,1704.9,17049,17343,6.8,9,9,11,180,18.0,1,1,1,0,0,193,19.3,0,8,8,8,7.2,18768,16902,1690.2,1425,-147,1
5494,687,563,1749.2,17492,18028,6.8,9,9,9,219,21.9,1,1,1,0,0,224,22.4,0,7,5,5,7.0,17465,16805,1680.5,-563,-687,1
5495,-3180,-3196,1437.0,14370,16473,6.4,2,2,2,228,22.8,0,0,0,1,1,211,21.1,1,8,8,8,7.6,19669,17550,1755.0,3196,3180,0
5496,-144,-867,1754.3,17543,18967,7.2,7,7,9,246,24.6,0,0,0,1,1,225,22.5,2,10,8,8,7.4,19834,17687,1768.7,867,144,0
5497,-6374,-4421,1357.0,13570,15970,6.6,2,2,4,195,19.5,1,1,0,1,0,262,26.2,1,8,9,9,7.8,20391,19944,1994.4,4421,6374,0
5498,-947,-1040,1594.8,15948,17169,6.8,5,5,5,222,22.2,0,0,1,0,1,248,24.8,2,10,6,6,6.8,18209,16895,1689.5,1040,947,0
5499,-3074,-2611,1433.9,14339,15064,6.0,3,3,6,197,19.7,0,0,0,1,0,233,23.3,0,10,6,6,6.8,17675,17413,1741.3,2611,3074,1
5500,2098,1150,2008.4,20084,17621,6.8,16,16,12,175,17.5,1,1,1,0,0,182,18.2,0,10,10,10,6.8,16471,17986,1798.6,-1150,-2098,1
5501,-1270,-2363,1537.5,15375,17114,6.8,4,4,5,200,20.0,0,0,0,1,1,273,27.3,1,1,5,5,7.2,19477,16645,1664.5,2363,1270,1
5502,-2089,-2275,1431.3,14313,15407,6.2,3,3,5,194,19.4,0,0,0,1,1,243,24.3,1,7,5,5,6.8,17682,16402,1640.2,2275,2089,1
5503,3404,2513,1778.6,17786,19149,7.0,9,9,8,233,23.3,0,0,1,0,0,206,20.6,0,1,1,1,6.6,16636,14382,1438.2,-2513,-3404,1
5504,-206,-1476,1665.7,16657,18154,7.0,4,4,4,210,21.0,1,0,1,0,1,248,24.8,1,0,8,8,7.2,19630,16863,1686.3,1476,206,1
5505,1396,2369,1599.4,15994,18356,6.8,6,6,5,235,23.5,2,1,1,0,0,166,16.6,0,4,4,4,6.6,15987,14598,1459.8,-2369,-1396,1
5506,-2475,-3608,1435.2,14352,15070,6.4,5,5,5,153,15.3,0,0,1,0,1,227,22.7,1,8,7,7,7.0,18678,16827,1682.7,3608,2475,0
5507,-2111,-1385,1558.9,15589,17960,7.0,5,5,6,203,20.3,0,0,0,1,1,262,26.2,1,5,8,8,7.2,19345,17700,1770.0,1385,2111,1
5508,-375,-547,1754.4,17544,18246,7.2,8,8,10,213,21.3,0,0,0,1,1,230,23.0,1,9,8,8,7.0,18793,17919,1791.9,547,375,0
5509,-1942,-2662,1644.7,16447,16299,6.6,6,6,9,208,20.8,1,1,1,0,0,239,23.9,0,14,9,9,7.0,18961,18389,1838.9,2662,1942,0
5510,-426,-323,1588.3,15883,17317,6.8,4,4,4,235,23.5,1,1,0,1,0,238,23.8,0,6,6,6,7.0,17640,16309,1630.9,323,426,1
5511,-2794,-2688,1569.3,15693,16140,6.6,6,6,12,177,17.7,1,1,0,1,0,237,23.7,0,17,10,10,7.2,18828,18487,1848.7,2688,2794,0
5512,-7218,-5853,1373.7,13737,15314,6.2,3,3,1,174,17.4,0,0,1,0,1,250,25.0,1,12,13,13,7.6,21167,20955,2095.5,5853,7218,0
5513,1175,963,1701.9,17019,19372,7.2,7,7,5,236,23.6,0,0,1,0,1,231,23.1,2,3,3,3,6.8,18409,15844,1584.4,-963,-1175,0
5514,-1420,-1415,1502.9,15029,17571,7.0,3,3,3,230,23.0,0,0,1,0,1,222,22.2,1,5,5,5,7.0,18986,16449,1644.9,1415,1420,0
5515,-265,-872,1664.3,16643,18042,7.0,6,6,6,232,23.2,0,0,1,0,1,222,22.2,1,9,7,7,7.2,18914,16908,1690.8,872,265,0
5516,-797,-532,1519.8,15198,16245,6.4,4,4,4,226,22.6,0,0,1,0,1,180,18.0,1,10,9,9,6.6,16777,15995,1599.5,532,797,1
5517,3201,2000,1862.5,18625,18540,7.0,10,10,19,231,23.1,1,1,0,1,0,191,19.1,1,5,5,5,6.8,16540,15424,1542.4,-2000,-3201,1
5518,-632,675,1503.0,15030,16763,6.4,6,6,2,204,20.4,0,0,1,0,1,192,19.2,1,8,7,7,6.4,16088,15662,1566.2,-675,632,0
5519,2493,1826,1834.7,18347,19605,7.4,8,8,4,251,25.1,0,0,1,0,1,233,23.3,1,2,3,3,7.0,17779,15854,1585.4,-1826,-2493,1
5520,3158,2594,1845.8,18458,20320,7.4,9,9,4,270,27.0,1,0,0,1,1,202,20.2,1,6,4,4,6.8,17726,15300,1530.0,-2594,-3158,1
5521,-1127,-1496,1622.8,16228,16832,6.6,7,7,8,191,19.1,0,0,0,1,1,204,20.4,2,6,8,8,7.0,18328,17355,1735.5,1496,1127,0
5522,-296,872,1688.0,16880,17998,7.0,9,9,5,195,19.5,0,0,1,0,0,246,24.6,0,7,7,7,6.8,17126,17176,1717.6,-872,296,0
5523,-1473,-29,1414.4,14144,16975,6.6,0,0,0,228,22.8,0,0,0,1,1,228,22.8,1,6,4,4,6.6,17004,15617,1561.7,29,1473,1
5524,810,98,1605.6,16056,17480,7.0,6,6,3,198,19.8,0,0,1,0,1,192,19.2,1,3,5,5,6.8,17382,15246,1524.6,-98,-810,0
5525,-180,-102,1744.4,17444,18454,7.2,7,7,5,197,19.7,0,0,0,1,1,204,20.4,2,12,10,10,7.0,18556,17624,1762.4,102,180,1
5526,-839,63,1471.6,14716,17855,6.8,2,2,3,219,21.9,0,0,0,1,1,215,21.5,1,5,4,4,7.0,17792,15555,1555.5,-63,839,1
5527,1030,914,1644.3,16443,19348,7.4,6,6,4,261,26.1,1,0,0,1,1,235,23.5,1,5,3,3,7.0,18434,15413,1541.3,-914,-1030,1
5528,-885,180,1450.7,14507,17455,6.6,3,3,1,207,20.7,1,1,0,1,0,206,20.6,0,4,4,4,6.8,17275,15392,1539.2,-180,885,1
5529,186,-741,1797.4,17974,15423,6.2,12,12,18,182,18.2,1,1,1,0,0,188,18.8,1,9,10,10,6.4,16164,17788,1778.8,741,-186,0
5530,-3702,-1251,1527.9,15279,17220,6.8,3,3,4,206,20.6,0,0,0,1,1,237,23.7,2,14,9,9,7.0,18471,18981,1898.1,1251,3702,0
5531,3479,2657,1883.7,18837,20066,7.6,8,8,7,246,24.6,1,0,1,0,1,222,22.2,1,6,4,4,6.8,17409,15358,1535.8,-2657,-3479,1
5532,-4991,-3526,1429.1,14291,15475,6.4,3,3,3,212,21.2,0,0,1,0,1,216,21.6,2,13,9,9,7.2,19001,19282,1928.2,3526,4991,0
5533,-2543,-538,1529.0,15290,16843,6.8,6,6,2,195,19.5,1,1,1,0,0,215,21.5,0,8,9,9,6.6,17381,17833,1783.3,538,2543,0
5534,1729,2306,1768.7,17687,19488,7.2,10,10,9,197,19.7,0,0,1,0,0,194,19.4,0,5,6,6,6.8,17182,15958,1595.8,-2306,-1729,1
5535,-1964,-3104,1574.2,15742,17327,6.8,5,5,6,228,22.8,0,0,1,0,1,241,24.1,1,6,7,7,7.6,20431,17706,1770.6,3104,1964,0
5536,-1231,-908,1394.2,13942,17704,7.0,1,1,1,219,21.9,1,1,0,1,0,248,24.8,0,1,3,3,7.0,18612,15173,1517.3,908,1231,0
5537,-445,141,1645.2,16452,17916,7.0,5,5,5,220,22.0,0,0,0,1,0,212,21.2,0,5,6,6,7.0,17775,16897,1689.7,-141,445,0
5538,857,961,1612.3,16123,18987,7.0,5,5,3,235,23.5,1,1,0,1,0,202,20.2,0,5,4,4,7.0,18026,15266,1526.6,-961,-857,0
5539,-2959,-2726,1472.5,14725,16460,6.6,3,3,4,200,20.0,0,0,1,0,0,213,21.3,0,9,9,9,7.0,19186,17684,1768.4,2726,2959,0
5540,-1593,-1157,1715.1,17151,17562,6.8,10,10,10,149,14.9,0,0,1,0,0,212,21.2,0,9,11,11,7.2,18719,18744,1874.4,1157,1593,0
5541,-1441,55,1461.6,14616,18564,7.0,2,2,1,242,24.2,0,0,0,1,1,207,20.7,1,7,5,5,6.8,18509,16057,1605.7,-55,1441,0
5542,-292,-440,1586.2,15862,17599,6.8,5,5,5,220,22.0,1,1,1,0,0,224,22.4,0,7,4,4,7.0,18039,16154,1615.4,440,292,1
5543,814,82,1913.9,19139,17648,6.8,14,14,23,180,18.0,0,0,0,1,0,203,20.3,0,14,10,10,7.0,17566,18325,1832.5,-82,-814,0
5544,225,-216,1840.9,18409,18255,6.8,6,6,9,212,21.2,1,1,0,1,0,242,24.2,1,4,6,6,7.0,18471,18184,1818.4,216,-225,1
5545,2481,1470,1823.6,18236,17468,6.8,9,9,9,207,20.7,0,0,1,0,0,184,18.4,0,10,7,7,6.6,15998,15755,1575.5,-1470,-2481,1
5546,1116,1050,1699.1,16991,18186,6.8,6,6,9,242,24.2,0,0,1,0,0,248,24.8,0,5,3,3,6.8,17136,15875,1587.5,-1050,-1116,0
5547,-3519,-4275,1427.0,14270,15513,6.4,2,2,2,215,21.5,0,0,1,0,1,241,24.1,1,8,7,7,7.4,19788,17789,1778.9,4275,3519,0
5548,1124,1058,1780.2,17802,17107,7.0,11,11,9,183,18.3,0,0,1,0,1,190,19.0,1,10,8,8,6.8,16049,16678,1667.8,-1058,-1124,0
5549,2486,2148,1734.0,17340,18431,7.2,5,5,7,215,21.5,1,0,1,0,0,223,22.3,0,3,3,3,6.6,16283,14854,1485.4,-2148,-2486,1
5550,3373,1784,1895.9,18959,19473,7.2,10,10,15,244,24.4,2,1,1,0,0,221,22.1,0,2,4,4,6.8,17689,15586,1558.6,-1784,-3373,0
5551,-2595,-1917,1480.9,14809,17625,6.8,3,3,3,232,23.2,0,0,0,1,0,245,24.5,0,10,8,8,7.2,19542,17404,1740.4,1917,2595,0
5552,-590,527,1690.0,16900,17296,6.8,8,8,8,168,16.8,0,0,0,1,0,186,18.6,0,10,11,11,6.4,16769,17490,1749.0,-527,590,1
5553,3257,2138,1664.7,16647,18161,7.0,7,7,6,214,21.4,0,0,1,0,0,197,19.7,0,1,2,2,6.2,16023,13390,1339.0,-2138,-3257,1
5554,2610,1716,1714.9,17149,18751,7.0,6,6,2,257,25.7,1,0,1,0,1,203,20.3,1,2,3,3,6.6,17035,14539,1453.9,-1716,-2610,1
5555,-1297,-856,1685.5,16855,18568,7.2,7,7,5,221,22.1,0,0,0,1,1,229,22.9,1,8,9,9,7.2,19424,18152,1815.2,856,1297,0
5556,-482,668,1783.8,17838,18262,7.0,10,10,7,230,23.0,0,0,1,0,0,202,20.2,1,16,10,10,6.8,17594,18320,1832.0,-668,482,1
5557,-1237,753,1673.0,16730,17556,6.8,7,7,5,180,18.0,1,0,1,0,1,196,19.6,1,10,9,9,6.8,16803,17967,1796.7,-753,1237,1
5558,-5335,-1002,1694.8,16948,17462,6.6,8,8,7,181,18.1,1,0,0,1,1,253,25.3,1,13,14,14,7.0,18464,22283,2228.3,1002,5335,0
5559,-1896,-2216,1394.6,13946,16402,6.6,2,2,4,211,21.1,1,1,1,0,0,232,23.2,0,5,4,4,7.0,18618,15842,1584.2,2216,1896,1
5560,1594,477,1614.4,16144,18236,7.0,6,6,7,199,19.9,0,0,1,0,1,257,25.7,1,0,0,0,7.0,17759,14550,1455.0,-477,-1594,1
5561,1989,1106,1824.8,18248,19067,7.2,7,7,7,231,23.1,0,0,1,0,1,215,21.5,1,3,6,6,7.0,17961,16259,1625.9,-1106,-1989,1
5562,3467,3958,1871.0,18710,20305,7.6,9,9,12,210,21.0,1,0,0,1,0,193,19.3,0,3,4,4,6.4,16347,15243,1524.3,-3958,-3467,1
5563,-2267,-2546,1473.3,14733,17627,6.8,2,2,1,224,22.4,1,0,1,0,1,244,24.4,1,4,7,7,7.6,20173,17000,1700.0,2546,2267,0
5564,-1739,-826,1538.6,15386,16591,6.6,5,5,4,188,18.8,0,0,1,0,0,222,22.2,1,9,7,7,6.8,17417,17125,1712.5,826,1739,0
5565,-950,60,1581.2,15812,17291,7.0,5,5,7,227,22.7,0,0,0,1,1,233,23.3,1,7,7,7,6.8,17231,16762,1676.2,-60,950,0
5566,-1449,-349,1555.3,15553,18934,7.2,3,3,3,244,24.4,0,0,0,1,0,250,25.0,0,3,5,5,7.2,19283,17002,1700.2,349,1449,0
5567,611,1342,1654.9,16549,18284,7.2,7,7,6,205,20.5,0,0,0,1,1,203,20.3,1,9,5,5,6.8,16942,15938,1593.8,-1342,-611,0
5568,-720,-1208,1634.8,16348,17866,7.0,6,6,10,225,22.5,1,0,1,0,1,248,24.8,1,9,5,5,7.2,19074,17068,1706.8,1208,720,1
5569,516,2485,1611.5,16115,18971,7.2,5,5,5,237,23.7,1,0,0,1,0,213,21.3,0,8,5,5,6.6,16486,15599,1559.9,-2485,-516,0
5570,2154,25,1781.4,17814,18330,7.0,4,4,4,252,25.2,0,0,1,0,0,197,19.7,1,4,6,6,7.0,18305,15660,1566.0,-25,-2154,1
5571,-1474,-179,1688.4,16884,19682,7.4,7,7,5,220,22.0,0,0,1,0,1,228,22.8,1,8,9,9,7.6,19861,18358,1835.8,179,1474,0
5572,-3674,-3098,1603.8,16038,16019,6.4,6,6,8,209,20.9,0,0,0,1,1,205,20.5,2,16,12,12,7.6,19117,19712,1971.2,3098,3674,0
5573,1549,-554,1819.8,18198,17647,7.0,6,6,8,220,22.0,0,0,0,1,0,220,22.0,0,8,8,8,7.0,18201,16649,1664.9,554,-1549,1
5574,-2683,-2383,1582.7,15827,17607,7.0,3,3,1,245,24.5,0,0,0,1,1,234,23.4,1,12,10,10,7.2,19990,18510,1851.0,2383,2683,0
5575,267,-52,1642.1,16421,18708,7.0,6,6,7,224,22.4,0,0,0,1,1,241,24.1,1,7,4,4,7.2,18760,16154,1615.4,52,-267,1
5576,1417,492,1810.7,18107,18643,7.0,9,9,13,210,21.0,0,0,1,0,0,199,19.9,0,8,7,7,7.0,18151,16690,1669.0,-492,-1417,1
5577,4074,2842,1882.1,18821,19339,7.2,7,7,7,259,25.9,1,0,1,0,0,189,18.9,0,6,4,4,6.4,16497,14747,1474.7,-2842,-4074,1
5578,-1571,-1130,1606.3,16063,17688,6.8,7,7,6,192,19.2,1,1,0,1,0,260,26.0,0,6,7,7,7.2,18818,17634,1763.4,1130,1571,0
5579,2068,1158,1937.6,19376,19330,7.2,10,10,16,241,24.1,1,0,1,0,0,204,20.4,0,7,8,8,6.8,18172,17308,1730.8,-1158,-2068,1
5580,1959,899,1834.5,18345,18508,7.2,11,11,14,218,21.8,0,0,1,0,1,198,19.8,2,10,8,8,6.8,17609,16386,1638.6,-899,-1959,0
5581,36,1099,1623.9,16239,17856,6.8,8,8,7,200,20.0,0,0,0,1,0,215,21.5,0,6,5,5,6.6,16757,16203,1620.3,-1099,-36,1
5582,2031,1116,1759.6,17596,19125,7.4,10,10,8,211,21.1,0,0,1,0,0,230,23.0,1,4,4,4,7.2,18009,15565,1556.5,-1116,-2031,1
5583,1054,-67,1665.5,16655,17121,6.8,7,7,14,214,21.4,1,0,1,0,1,214,21.4,1,5,4,4,6.8,17188,15601,1560.1,67,-1054,1
5584,724,1268,1762.3,17623,19660,7.2,7,7,5,233,23.3,0,0,1,0,1,223,22.3,1,7,7,7,7.2,18392,16899,1689.9,-1268,-724,1
5585,54,-321,1732.6,17326,17581,6.8,9,9,10,188,18.8,1,1,0,1,0,193,19.3,0,8,9,9,6.8,17902,17272,1727.2,321,-54,0
5586,2050,687,1662.8,16628,17323,6.8,6,6,6,230,23.0,1,1,1,0,0,195,19.5,0,2,3,3,6.6,16636,14578,1457.8,-687,-2050,1
5587,46,881,1586.3,15863,17012,6.8,6,6,6,221,22.1,0,0,0,1,0,191,19.1,0,9,6,6,6.4,16131,15817,1581.7,-881,-46,1
5588,2078,2058,1869.8,18698,20094,7.4,8,8,7,259,25.9,1,0,1,0,1,207,20.7,1,7,7,7,7.0,18036,16620,1662.0,-2058,-2078,1
5589,5260,2633,2108.7,21087,20108,7.6,14,14,15,215,21.5,0,0,1,0,1,193,19.3,1,5,6,6,7.0,17475,15827,1582.7,-2633,-5260,1
5590,-2253,-1798,1568.9,15689,17576,6.8,3,3,3,236,23.6,1,1,0,1,0,238,23.8,0,8,7,7,7.2,19374,17942,1794.2,1798,2253,0
5591,204,-1452,1479.5,14795,16396,6.4,2,2,4,208,20.8,0,0,0,1,1,223,22.3,1,1,2,2,6.8,17848,14591,1459.1,1452,-204,1
5592,5742,3475,2174.7,21747,19828,7.4,16,16,20,244,24.4,2,1,1,0,0,190,19.0,0,6,6,6,6.6,16353,16005,1600.5,-3475,-5742,1
5593,2683,1740,1810.3,18103,19519,7.4,8,8,7,247,24.7,0,0,1,0,1,241,24.1,1,3,3,3,7.0,17779,15420,1542.0,-1740,-2683,0
5594,5040,2681,2082.2,20822,18683,6.8,15,15,15,237,23.7,2,1,1,0,0,187,18.7,0,8,7,7,6.4,16002,15782,1578.2,-2681,-5040,1
5595,76,98,1588.1,15881,17469,6.8,5,5,7,239,23.9,0,0,0,1,1,249,24.9,1,6,4,4,6.8,17371,15805,1580.5,-98,-76,0
5596,811,1501,1734.2,17342,19169,7.2,6,6,6,263,26.3,0,0,0,1,0,199,19.9,0,5,5,5,6.6,17668,16531,1653.1,-1501,-811,1
5597,2191,1140,1658.3,16583,18071,7.0,6,6,7,244,24.4,1,0,1,0,1,218,21.8,1,1,2,2,6.8,16931,14392,1439.2,-1140,-2191,0
5598,3046,1162,1854.4,18544,18246,7.0,11,11,11,213,21.3,2,1,1,0,0,198,19.8,0,5,5,5,6.6,17084,15498,1549.8,-1162,-3046,1
5599,671,804,1702.3,17023,19264,7.2,6,6,6,255,25.5,0,0,0,1,0,231,23.1,0,10,6,6,6.8,18460,16352,1635.2,-804,-671,1
5600,-158,-67,1619.0,16190,18041,6.8,6,6,2,234,23.4,0,0,1,0,1,217,21.7,1,13,7,7,7.0,18108,16348,1634.8,67,158,0
5601,2584,2273,1796.5,17965,18483,7.0,9,9,15,210,21.0,0,0,0,1,0,220,22.0,0,5,5,5,6.4,16210,15381,1538.1,-2273,-2584,1
5602,1059,919,1693.2,16932,17955,6.8,5,5,10,239,23.9,0,0,1,0,0,192,19.2,1,4,5,5,6.8,17036,15873,1587.3,-919,-1059,1
5603,-1761,37,1779.3,17793,18074,7.0,10,10,11,199,19.9,0,0,1,0,1,206,20.6,2,14,12,12,7.0,18037,19554,1955.4,-37,1761,0
5604,1827,972,1809.6,18096,17875,6.8,9,9,9,213,21.3,1,1,1,0,0,167,16.7,1,14,8,8,6.8,16903,16269,1626.9,-972,-1827,0
5605,-2448,-1976,1631.7,16317,16985,6.6,7,7,6,205,20.5,0,0,0,1,1,238,23.8,1,7,9,9,7.2,18961,18765,1876.5,1976,2448,0
5606,-2088,-870,1504.9,15049,17666,7.0,4,4,3,218,21.8,1,1,0,1,0,240,24.0,0,7,8,8,7.2,18536,17137,1713.7,870,2088,1
5607,1373,57,1899.7,18997,17998,7.2,11,11,21,237,23.7,1,1,1,0,0,227,22.7,0,7,7,7,6.8,17941,17624,1762.4,-57,-1373,0
5608,1733,862,1709.8,17098,18682,7.2,7,7,10,229,22.9,0,0,1,0,1,206,20.6,1,4,5,5,6.8,17820,15365,1536.5,-862,-1733,0
5609,-335,-213,1645.9,16459,17550,6.8,8,8,4,190,19.0,2,1,1,0,0,209,20.9,0,7,8,8,7.0,17763,16794,1679.4,213,335,1
5610,2915,3259,1812.9,18129,20257,7.4,10,10,9,250,25.0,0,0,0,1,1,193,19.3,1,4,4,4,6.8,16998,15214,1521.4,-3259,-2915,1
5611,-2499,-1870,1445.9,14459,16596,6.6,3,3,4,202,20.2,0,0,0,1,1,238,23.8,1,13,7,7,7.0,18466,16958,1695.8,1870,2499,0
5612,-1343,-1261,1637.3,16373,16941,6.8,5,5,6,237,23.7,0,0,0,1,1,195,19.5,1,17,10,10,6.8,18202,17716,1771.6,1261,1343,1
5613,-742,-750,1664.5,16645,18070,6.8,7,7,7,231,23.1,1,1,0,1,0,223,22.3,0,5,7,7,7.0,18820,17387,1738.7,750,742,0
5614,-3047,-612,1401.0,14010,16322,6.4,2,2,4,187,18.7,1,0,0,1,1,215,21.5,1,9,7,7,6.6,16934,17057,1705.7,612,3047,1
5615,-1828,-1146,1478.0,14780,17765,7.0,2,2,2,249,24.9,0,0,0,1,1,230,23.0,1,6,5,5,7.2,18911,16608,1660.8,1146,1828,0
5616,-1784,-889,1674.0,16740,18257,6.8,7,7,10,234,23.4,1,0,1,0,1,251,25.1,1,8,8,8,7.0,19146,18524,1852.4,889,1784,0
5617,-260,-369,1681.2,16812,17939,6.8,7,7,8,226,22.6,1,1,1,0,0,233,23.3,0,7,7,7,7.2,18308,17072,1707.2,369,260,0
5618,1465,201,1666.7,16667,18043,7.0,7,7,9,223,22.3,0,0,1,0,1,218,21.8,1,6,4,4,7.0,17842,15202,1520.2,-201,-1465,0
5619,2427,2365,1795.4,17954,19474,7.2,10,10,7,201,20.1,0,0,0,1,0,224,22.4,0,6,5,5,6.8,17109,15527,1552.7,-2365,-2427,1
5620,4230,3209,1927.8,19278,19529,7.4,11,11,14,226,22.6,1,1,1,0,0,186,18.6,0,3,3,3,6.4,16320,15048,1504.8,-3209,-4230,1
5621,-3584,-3674,1478.4,14784,15775,6.4,5,5,6,173,17.3,0,0,0,1,0,211,21.1,0,8,11,11,7.2,19449,18368,1836.8,3674,3584,0
5622,-3260,-1060,1429.0,14290,17459,6.8,3,3,1,204,20.4,0,0,0,1,1,221,22.1,1,8,8,8,7.2,18519,17550,1755.0,1060,3260,0
5623,988,581,1675.9,16759,17756,7.0,9,9,12,183,18.3,0,0,1,0,1,198,19.8,2,9,5,5,6.6,17175,15771,1577.1,-581,-988,1
5624,1398,1802,1692.9,16929,19477,7.2,5,5,3,232,23.2,0,0,0,1,0,239,23.9,0,3,2,2,7.0,17675,15531,1553.1,-1802,-1398,1
5625,-986,-1894,1483.9,14839,17590,6.8,3,3,3,205,20.5,1,0,1,0,1,250,25.0,1,3,4,4,7.4,19484,15825,1582.5,1894,986,0
5626,439,-524,1682.0,16820,17719,6.8,8,8,6,223,22.3,0,0,1,0,1,214,21.4,1,4,6,6,7.0,18243,16381,1638.1,524,-439,1
5627,2120,2095,1801.0,18010,20078,7.2,8,8,9,224,22.4,2,1,1,0,0,229,22.9,0,5,6,6,7.0,17983,15890,1589.0,-2095,-2120,0
5628,1642,-1085,1640.9,16409,16448,6.6,6,6,11,228,22.8,1,1,1,0,0,204,20.4,1,3,3,3,6.8,17533,14767,1476.7,1085,-1642,0
5629,1480,721,1745.6,17456,17732,7.0,7,7,9,261,26.1,1,1,1,0,0,209,20.9,0,7,5,5,6.6,17011,15976,1597.6,-721,-1480,0
5630,750,867,1723.5,17235,19413,7.4,7,7,7,251,25.1,0,0,0,1,0,230,23.0,0,8,5,5,7.2,18546,16485,1648.5,-867,-750,0
5631,1714,1369,1693.4,16934,19205,7.0,7,7,7,228,22.8,1,0,1,0,1,229,22.9,1,4,3,3,6.8,17836,15220,1522.0,-1369,-1714,1
5632,-1493,-382,1510.9,15109,18112,7.0,5,5,4,213,21.3,0,0,1,0,1,230,23.0,1,2,6,6,7.0,18494,16602,1660.2,382,1493,0
5633,599,267,1689.8,16898,17534,7.0,7,7,5,226,22.6,1,1,1,0,0,203,20.3,1,7,6,6,6.8,17267,16299,1629.9,-267,-599,1
5634,981,369,1923.7,19237,18874,7.2,12,12,12,209,20.9,0,0,1,0,0,233,23.3,0,11,11,11,7.0,18505,18256,1825.6,-369,-981,1
5635,67,-303,1652.5,16525,17494,6.8,7,7,8,191,19.1,0,0,0,1,0,228,22.8,0,5,5,5,7.0,17797,16458,1645.8,303,-67,1
5636,-1404,-2296,1445.2,14452,15418,6.4,3,3,2,186,18.6,0,0,1,0,1,228,22.8,1,3,5,5,6.8,17714,15856,1585.6,2296,1404,0
5637,2337,2150,1746.3,17463,18601,7.0,8,8,8,229,22.9,1,1,0,1,0,204,20.4,0,3,4,4,6.8,16451,15126,1512.6,-2150,-2337,1
5638,601,152,1869.5,18695,18459,7.2,10,10,13,225,22.5,0,0,0,1,0,199,19.9,0,9,9,9,7.0,18307,18094,1809.4,-152,-601,0
5639,-829,-1232,1536.0,15360,16644,6.6,4,4,2,220,22.0,1,0,0,1,1,232,23.2,1,4,6,6,6.8,17876,16189,1618.9,1232,829,0
5640,2511,3602,1762.6,17626,18770,7.2,9,9,13,219,21.9,0,0,0,1,1,162,16.2,2,13,5,5,6.0,15168,15115,1511.5,-3602,-2511,1
5641,39,-301,1542.9,15429,18085,7.0,4,4,5,238,23.8,0,0,0,1,1,238,23.8,1,2,3,3,7.0,18386,15390,1539.0,301,-39,1
5642,-455,-767,1527.1,15271,18226,7.0,3,3,3,236,23.6,1,1,1,0,0,258,25.8,0,3,3,3,7.2,18993,15726,1572.6,767,455,1
5643,-2377,-2713,1496.1,14961,17746,6.6,2,2,3,210,21.0,2,1,0,1,0,269,26.9,0,4,5,5,7.6,20459,17338,1733.8,2713,2377,1
5644,11467,8265,2342.4,23424,18730,7.4,14,14,14,220,22.0,0,0,1,0,0,117,11.7,0,2,3,3,5.0,10465,11957,1195.7,-8265,-11467,1
5645,-125,-479,1698.3,16983,18675,7.2,8,8,6,198,19.8,0,0,1,0,1,208,20.8,1,7,8,8,7.4,19154,17108,1710.8,479,125,0
5646,2880,3031,1749.0,17490,19737,7.6,7,7,8,259,25.9,0,0,1,0,0,215,21.5,0,2,2,2,6.6,16706,14610,1461.0,-3031,-2880,0
5647,2789,585,1886.3,18863,18943,7.2,15,15,12,195,19.5,0,0,1,0,0,192,19.2,0,4,6,6,7.0,18358,16074,1607.4,-585,-2789,0
5648,2254,1555,1825.9,18259,19685,7.2,12,12,9,218,21.8,1,1,1,0,0,215,21.5,0,3,6,6,7.0,18130,16005,1600.5,-1555,-2254,1
5649,3246,409,1793.9,17939,18687,7.2,9,9,13,220,22.0,1,1,1,0,0,235,23.5,0,0,3,3,7.0,18278,14693,1469.3,-409,-3246,1
5650,-1766,-639,1469.5,14695,18082,7.2,4,4,5,200,20.0,1,1,0,1,0,259,25.9,0,3,5,5,7.0,18721,16461,1646.1,639,1766,0
5651,-4376,-3665,1429.9,14299,15937,6.4,3,3,2,207,20.7,1,1,1,0,0,206,20.6,1,14,12,12,7.4,19602,18675,1867.5,3665,4376,0
5652,2357,2202,1732.8,17328,19304,7.2,8,8,9,228,22.8,1,1,0,1,0,222,22.2,0,2,3,3,6.8,17102,14971,1497.1,-2202,-2357,1
5653,2079,1371,1729.9,17299,18277,7.0,9,9,11,213,21.3,1,1,0,1,0,193,19.3,0,4,5,5,6.6,16906,15220,1522.0,-1371,-2079,1
5654,4362,2989,1854.1,18541,18196,7.0,10,10,14,210,21.0,1,1,0,1,0,176,17.6,0,2,4,4,6.4,15207,14179,1417.9,-2989,-4362,1
5655,-3330,-2255,1485.4,14854,17513,6.8,2,2,3,250,25.0,0,0,0,1,1,248,24.8,1,10,7,7,7.4,19768,18184,1818.4,2255,3330,0
5656,1488,1092,1781.6,17816,18626,7.4,11,11,15,209,20.9,2,1,1,0,0,225,22.5,0,9,6,6,7.0,17534,16328,1632.8,-1092,-1488,0
5657,-561,-489,1748.2,17482,18618,7.2,7,7,9,233,23.3,0,0,0,1,0,224,22.4,0,9,9,9,7.2,19107,18043,1804.3,489,561,0
5658,1379,246,1975.4,19754,18453,7.0,11,11,9,227,22.7,1,0,0,1,1,215,21.5,1,15,9,9,7.2,18207,18375,1837.5,-246,-1379,1
5659,1250,297,1792.8,17928,17767,6.8,8,8,6,217,21.7,1,1,1,0,0,192,19.2,0,13,8,8,6.8,17470,16678,1667.8,-297,-1250,1
5660,464,1383,1627.3,16273,19013,7.2,6,6,6,237,23.7,1,1,0,1,0,235,23.5,1,2,5,5,7.0,17630,15809,1580.9,-1383,-464,1
5661,-628,-582,1647.3,16473,17992,7.0,6,6,6,204,20.4,0,0,0,1,1,218,21.8,1,4,7,7,7.2,18574,17101,1710.1,582,628,1
5662,-2746,-827,1603.3,16033,17043,7.0,5,5,4,207,20.7,0,0,0,1,0,202,20.2,0,17,12,12,6.8,17870,18779,1877.9,827,2746,1
5663,-2340,-2351,1800.2,18002,17743,6.8,12,12,14,178,17.8,0,0,1,0,1,220,22.0,1,16,13,13,7.6,20094,20342,2034.2,2351,2340,0
5664,3034,1636,1936.0,19360,19057,7.2,13,13,12,238,23.8,1,1,1,0,0,183,18.3,0,7,7,7,6.6,17421,16326,1632.6,-1636,-3034,1
5665,-1664,-990,1477.7,14777,17674,6.8,1,1,1,231,23.1,0,0,0,1,0,236,23.6,1,7,5,5,7.2,18664,16441,1644.1,990,1664,0
5666,-1428,-671,1673.8,16738,17657,6.8,8,8,9,199,19.9,0,0,0,1,1,201,20.1,1,16,10,10,7.0,18328,18166,1816.6,671,1428,0
5667,1451,1441,1707.0,17070,18583,7.2,7,7,7,223,22.3,1,1,1,0,0,199,19.9,0,4,4,4,6.8,17142,15619,1561.9,-1441,-1451,1
5668,-1666,-759,1699.5,16995,17908,6.8,7,7,7,217,21.7,0,0,1,0,1,243,24.3,1,15,10,10,7.0,18667,18661,1866.1,759,1666,0
5669,1076,1288,1789.6,17896,18474,6.8,9,9,12,215,21.5,1,1,0,1,0,222,22.2,0,10,7,7,6.8,17186,16820,1682.0,-1288,-1076,1
5670,-35,1112,1518.6,15186,18537,7.2,2,2,5,236,23.6,0,0,0,1,0,236,23.6,0,4,3,3,6.8,17425,15221,1522.1,-1112,35,1
5671,2480,3168,1729.4,17294,19906,7.4,7,7,4,246,24.6,0,0,1,0,0,218,21.8,0,2,2,2,6.6,16738,14814,1481.4,-3168,-2480,0
5672,1717,508,1644.3,16443,18538,7.0,5,5,7,238,23.8,1,1,1,0,0,197,19.7,0,4,2,2,7.0,18030,14726,1472.6,-508,-1717,1
5673,-692,-604,1542.0,15420,16502,6.6,5,5,5,210,21.0,0,0,0,1,1,193,19.3,2,7,7,7,6.8,17106,16112,1611.2,604,692,0
5674,-1171,-496,1497.9,14979,17553,7.0,3,3,4,237,23.7,0,0,0,1,0,251,25.1,0,3,3,3,7.0,18049,16150,1615.0,496,1171,1
5675,469,-755,1698.4,16984,17114,6.8,8,8,8,205,20.5,1,1,1,0,0,233,23.3,1,5,6,6,7.0,17869,16515,1651.5,755,-469,1
5676,-334,-1403,1658.0,16580,17570,7.0,7,7,6,207,20.7,1,1,0,1,0,228,22.8,0,5,5,5,7.0,18973,16914,1691.4,1403,334,1
5677,924,1282,1452.9,14529,17655,7.0,1,1,1,241,24.1,1,1,1,0,0,215,21.5,1,0,1,1,6.4,16373,13605,1360.5,-1282,-924,1
5678,-827,-981,1661.6,16616,17294,6.6,5,5,5,218,21.8,0,0,1,0,0,243,24.3,0,11,8,8,6.8,18275,17443,1744.3,981,827,1
5679,-1631,-1338,1519.9,15199,17382,6.8,3,3,3,235,23.5,1,1,1,0,0,206,20.6,1,7,7,7,7.0,18720,16830,1683.0,1338,1631,1
5680,-2184,-1298,1624.0,16240,18554,7.2,6,6,9,205,20.5,0,0,0,1,1,250,25.0,1,9,9,9,7.2,19852,18424,1842.4,1298,2184,0
5681,-833,-1553,1571.9,15719,16209,6.4,7,7,10,172,17.2,1,1,1,0,0,201,20.1,0,7,8,8,6.8,17762,16552,1655.2,1553,833,0
5682,-1471,-1810,1723.1,17231,17898,7.0,8,8,15,193,19.3,1,1,1,0,0,213,21.3,0,11,10,10,7.2,19708,18702,1870.2,1810,1471,1
5683,2542,525,1894.5,18945,18620,7.0,10,10,12,234,23.4,1,1,1,0,0,231,23.1,0,4,4,4,6.8,18095,16403,1640.3,-525,-2542,1
5684,1468,195,1677.9,16779,18171,7.0,8,8,9,224,22.4,1,1,1,0,0,212,21.2,1,4,5,5,7.0,17976,15311,1531.1,-195,-1468,1
5685,2782,4425,1799.3,17993,20973,7.8,7,7,4,253,25.3,1,0,0,1,1,221,22.1,1,4,3,3,6.4,16548,15211,1521.1,-4425,-2782,1
5686,-2323,-2444,1578.2,15782,16191,6.8,8,8,5,182,18.2,1,0,0,1,1,185,18.5,1,8,9,9,7.0,18635,18105,1810.5,2444,2323,0
5687,2786,3197,1791.0,17910,20300,7.2,10,10,8,211,21.1,1,1,0,1,0,175,17.5,0,4,5,5,6.8,17103,15124,1512.4,-3197,-2786,1
5688,2209,1640,1731.9,17319,18310,7.0,7,7,4,253,25.3,0,0,0,1,1,159,15.9,2,6,7,7,6.8,16670,15110,1511.0,-1640,-2209,0
5689,4961,3591,1778.8,17788,19185,7.2,7,7,4,256,25.6,2,1,1,0,0,202,20.2,0,0,0,0,6.2,15594,12827,1282.7,-3591,-4961,1
5690,-61,-1738,1630.4,16304,15338,6.2,7,7,14,182,18.2,1,1,0,1,0,219,21.9,0,8,6,6,6.4,17076,16365,1636.5,1738,61,1
5691,-38,2015,1543.8,15438,19325,7.2,3,3,1,213,21.3,1,0,0,1,1,218,21.8,1,3,4,4,6.8,17310,15476,1547.6,-2015,38,0
5692,1912,1686,1887.9,18879,19472,7.4,12,12,9,219,21.9,0,0,0,1,1,197,19.7,1,8,7,7,7.0,17786,16967,1696.7,-1686,-1912,1
5693,2407,543,1698.7,16987,18078,6.8,7,7,10,235,23.5,0,0,1,0,1,168,16.8,2,2,5,5,6.8,17535,14580,1458.0,-543,-2407,1
5694,1078,2430,1574.0,15740,18504,7.0,6,6,2,201,20.1,0,0,1,0,1,158,15.8,1,5,5,5,6.6,16074,14662,1466.2,-2430,-1078,1
5695,-1489,-2144,1537.5,15375,18057,7.0,4,4,5,220,22.0,1,1,0,1,0,230,23.0,0,3,8,8,7.6,20201,16864,1686.4,2144,1489,0
5696,-2184,-2333,1665.8,16658,17588,6.6,7,7,8,192,19.2,0,0,0,1,1,202,20.2,1,8,13,13,7.4,19921,18842,1884.2,2333,2184,0
5697,3905,1506,1813.0,18130,18640,7.0,10,10,8,216,21.6,0,0,1,0,1,173,17.3,1,3,3,3,6.8,17134,14225,1422.5,-1506,-3905,1
5698,-1433,-394,1348.6,13486,16382,6.6,1,1,1,200,20.0,1,1,0,1,0,241,24.1,0,2,2,2,6.6,16776,14919,1491.9,394,1433,0
5699,-3543,-1737,1342.1,13421,17265,6.6,0,0,0,221,22.1,0,0,0,1,1,242,24.2,1,7,6,6,7.2,19002,16964,1696.4,1737,3543,0
5700,-3541,-4118,1458.7,14587,14862,6.2,5,5,7,171,17.1,1,1,1,0,0,218,21.8,0,12,11,11,7.2,18980,18128,1812.8,4118,3541,0
5701,-425,-284,1574.1,15741,18215,7.0,4,4,5,224,22.4,0,0,0,1,1,228,22.8,1,5,4,4,7.0,18499,16166,1616.6,284,425,0
5702,2730,3068,1809.8,18098,19504,7.2,8,8,9,212,21.2,0,0,0,1,1,215,21.5,1,2,5,5,6.4,16436,15368,1536.8,-3068,-2730,0
5703,4298,2299,1869.5,18695,19263,7.2,9,9,9,245,24.5,1,1,0,1,0,190,19.0,1,2,3,3,6.8,16964,14397,1439.7,-2299,-4298,1
5704,-1841,-357,1554.9,15549,18169,6.8,4,4,6,228,22.8,0,0,1,0,0,223,22.3,0,11,8,8,7.0,18526,17390,1739.0,357,1841,0
5705,3022,2631,1795.1,17951,18502,7.2,10,10,13,226,22.6,1,1,0,1,0,209,20.9,0,5,3,3,6.6,15871,14929,1492.9,-2631,-3022,1
5706,3117,1745,1842.8,18428,18214,7.0,12,12,11,218,21.8,1,1,1,0,0,254,25.4,0,4,3,3,6.6,16469,15311,1531.1,-1745,-3117,0
5707,2489,2364,1646.6,16466,18740,6.8,8,8,4,205,20.5,1,1,1,0,0,194,19.4,0,2,2,2,6.8,16376,13977,1397.7,-2364,-2489,1
5708,3515,2156,1705.6,17056,18608,7.0,7,7,8,232,23.2,1,1,0,1,0,208,20.8,1,1,1,1,6.6,16452,13541,1354.1,-2156,-3515,1
5709,1937,766,1801.7,18017,19071,7.2,9,9,7,210,21.0,1,1,1,0,0,209,20.9,0,6,6,6,7.2,18305,16080,1608.0,-766,-1937,1
5710,4999,1094,2274.5,22745,17394,6.8,17,17,21,205,20.5,0,0,0,1,1,175,17.5,1,11,10,10,6.4,16300,17746,1774.6,-1094,-4999,1
5711,-5086,-3284,1399.8,13998,17086,6.6,1,1,2,207,20.7,0,0,0,1,1,258,25.8,1,8,7,7,7.6,20370,19084,1908.4,3284,5086,0
5712,1194,2051,1801.2,18012,19569,7.0,9,9,7,239,23.9,0,0,0,1,1,221,22.1,1,6,7,7,6.6,17518,16818,1681.8,-2051,-1194,0
5713,923,828,1584.0,15840,17440,6.8,5,5,6,211,21.1,0,0,1,0,1,235,23.5,1,4,3,3,6.4,16612,14917,1491.7,-828,-923,0
5714,1500,-1268,1778.4,17784,17328,7.0,6,6,12,223,22.3,2,1,1,0,0,233,23.3,0,6,4,4,7.2,18596,16284,1628.4,1268,-1500,1
5715,2691,2585,1816.7,18167,18502,7.0,8,8,12,222,22.2,2,1,0,1,0,234,23.4,0,4,4,4,6.2,15917,15476,1547.6,-2585,-2691,1
5716,4498,3370,1879.5,18795,20241,7.4,10,10,15,260,26.0,1,1,1,0,0,226,22.6,0,2,1,1,6.4,16871,14297,1429.7,-3370,-4498,1
5717,2711,2160,1799.9,17999,19381,7.2,8,8,15,214,21.4,2,1,0,1,0,213,21.3,0,3,5,5,7.0,17221,15288,1528.8,-2160,-2711,1
5718,1300,1783,1738.1,17381,19539,7.2,7,7,5,234,23.4,1,1,0,1,0,227,22.7,0,6,5,5,6.8,17756,16081,1608.1,-1783,-1300,1
5719,-5553,-4226,1419.4,14194,14858,6.2,2,2,2,195,19.5,0,0,0,1,0,233,23.3,1,12,10,10,7.2,19084,19747,1974.7,4226,5553,0
5720,17,-1014,1573.2,15732,16582,6.6,5,5,6,218,21.8,0,0,0,1,0,248,24.8,0,4,4,4,7.0,17596,15715,1571.5,1014,-17,0
5721,2498,732,1833.5,18335,17921,6.8,11,11,10,238,23.8,0,0,1,0,0,194,19.4,0,7,6,6,6.8,17189,15837,1583.7,-732,-2498,1
5722,1323,183,1778.5,17785,17509,7.0,9,9,12,202,20.2,1,0,1,0,1,181,18.1,1,6,8,8,6.8,17326,16462,1646.2,-183,-1323,1
5723,2265,2392,1691.1,16911,19106,7.2,8,8,11,217,21.7,1,1,0,1,0,178,17.8,0,4,4,4,6.8,16714,14646,1464.6,-2392,-2265,1
5724,5956,4568,2144.2,21442,20440,7.6,16,16,16,232,23.2,0,0,1,0,0,185,18.5,0,5,6,6,6.4,15872,15486,1548.6,-4568,-5956,1
5725,-1075,11,1465.2,14652,18395,7.0,3,3,2,235,23.5,0,0,0,1,1,233,23.3,1,2,4,4,7.2,18384,15727,1572.7,-11,1075,0
5726,-301,71,1693.6,16936,17513,6.8,5,5,6,215,21.5,0,0,0,1,1,187,18.7,1,10,8,8,7.0,17442,17237,1723.7,-71,301,1
5727,-3364,-1990,1582.1,15821,17419,6.8,6,6,6,208,20.8,0,0,1,0,0,230,23.0,1,7,9,9,7.2,19409,19185,1918.5,1990,3364,0
5728,3109,3007,1786.3,17863,19967,7.4,7,7,8,257,25.7,1,1,0,1,0,204,20.4,0,5,4,4,6.4,16960,14754,1475.4,-3007,-3109,1
5729,3309,2603,2030.0,20300,19812,7.4,16,16,16,192,19.2,1,1,0,1,0,194,19.4,1,6,7,7,6.8,17209,16991,1699.1,-2603,-3309,1
5730,-226,972,1596.4,15964,19695,7.2,5,5,3,206,20.6,0,0,1,0,1,208,20.8,1,7,6,6,7.2,18723,16190,1619.0,-972,226,0
5731,1390,437,1817.2,18172,17184,6.8,11,11,10,191,19.1,1,1,1,0,0,181,18.1,0,7,9,9,6.6,16747,16782,1678.2,-437,-1390,0
5732,-3983,-1784,1566.2,15662,16109,6.4,6,6,5,191,19.1,0,0,0,1,1,218,21.8,1,13,13,13,7.2,17893,19645,1964.5,1784,3983,0
5733,-5961,-4133,1286.3,12863,16182,6.6,0,0,0,177,17.7,0,0,0,1,1,244,24.4,1,9,10,10,7.6,20315,18824,1882.4,4133,5961,0
5734,2249,2480,1923.6,19236,20585,7.4,11,11,13,231,23.1,1,1,1,0,0,219,21.9,0,8,9,9,7.0,18105,16987,1698.7,-2480,-2249,1
5735,-981,-1105,1650.0,16500,18352,7.0,4,4,5,249,24.9,0,0,1,0,1,193,19.3,2,10,9,9,7.2,19457,17481,1748.1,1105,981,0
5736,-1774,-2576,1529.2,15292,17578,6.8,2,2,2,252,25.2,0,0,0,1,1,267,26.7,1,4,5,5,7.6,20154,17066,1706.6,2576,1774,1
5737,6581,3949,1967.7,19677,17356,6.8,11,11,10,217,21.7,0,0,1,0,0,132,13.2,0,5,4,4,5.8,13407,13096,1309.6,-3949,-6581,1
5738,-2602,-550,1566.0,15660,18016,7.0,5,5,4,201,20.1,0,0,0,1,1,197,19.7,1,14,10,10,7.2,18566,18262,1826.2,550,2602,0
5739,-2608,-1326,1563.9,15639,17326,6.4,4,4,3,227,22.7,0,0,0,1,0,198,19.8,0,13,12,12,7.0,18652,18247,1824.7,1326,2608,1
5740,1066,-560,1674.6,16746,18699,7.2,5,5,6,247,24.7,2,1,1,0,0,239,23.9,0,4,5,5,7.4,19259,15680,1568.0,560,-1066,1
5741,-3052,-775,1504.2,15042,16868,6.8,5,5,1,189,18.9,0,0,0,1,1,201,20.1,1,13,10,10,7.0,17643,18094,1809.4,775,3052,1
5742,-2452,-2422,1349.6,13496,16421,6.6,1,1,2,186,18.6,0,0,0,1,1,255,25.5,1,3,3,3,7.2,18843,15948,1594.8,2422,2452,0
5743,-1330,378,1742.1,17421,17858,6.8,8,8,9,217,21.7,2,1,0,1,0,217,21.7,0,10,9,9,7.0,17480,18751,1875.1,-378,1330,0
5744,-2942,-1785,1569.6,15696,16453,6.6,5,5,6,195,19.5,0,0,1,0,0,212,21.2,0,14,11,11,7.0,18238,18638,1863.8,1785,2942,0
5745,-546,-1470,1557.7,15577,17552,6.8,3,3,1,220,22.0,1,1,0,1,0,229,22.9,0,7,5,5,7.2,19022,16123,1612.3,1470,546,0
5746,268,789,1756.3,17563,18068,7.0,8,8,10,190,19.0,1,0,1,0,0,234,23.4,0,13,9,9,6.6,17279,17295,1729.5,-789,-268,1
5747,-501,-934,1538.7,15387,16280,6.6,5,5,4,196,19.6,0,0,0,1,0,210,21.0,0,3,4,4,6.6,17214,15888,1588.8,934,501,0
5748,-2541,-3552,1461.2,14612,16340,6.6,2,2,2,242,24.2,0,0,1,0,1,220,22.0,1,8,7,7,7.4,19892,17153,1715.3,3552,2541,0
5749,942,1300,1789.8,17898,19411,7.4,8,8,8,232,23.2,2,1,1,0,0,245,24.5,0,6,7,7,7.0,18111,16956,1695.6,-1300,-942,0
5750,653,462,1837.6,18376,18388,7.2,9,9,11,238,23.8,1,1,0,1,0,204,20.4,0,18,9,9,7.0,17926,17723,1772.3,-462,-653,1
5751,2203,2404,1723.5,17235,18992,7.0,8,8,6,214,21.4,0,0,0,1,1,205,20.5,1,5,4,4,6.6,16588,15032,1503.2,-2404,-2203,0
5752,-3593,-2516,1373.6,13736,16381,6.2,2,2,1,188,18.8,0,0,0,1,1,227,22.7,2,7,6,6,7.0,18897,17329,1732.9,2516,3593,0
5753,283,165,1681.8,16818,16676,6.8,10,10,10,183,18.3,0,0,1,0,1,219,21.9,1,9,7,7,6.6,16511,16535,1653.5,-165,-283,0
5754,3657,3286,1995.0,19950,18520,7.0,14,14,15,212,21.2,0,0,0,1,1,156,15.6,1,12,8,8,6.2,15234,16293,1629.3,-3286,-3657,1
5755,793,461,1684.0,16840,18528,7.0,8,8,5,209,20.9,0,0,0,1,1,232,23.2,1,5,4,4,7.0,18067,16047,1604.7,-461,-793,0
5756,-4731,-2817,1396.1,13961,14440,6.2,3,3,6,168,16.8,0,0,0,1,0,206,20.6,0,21,12,12,6.8,17257,18692,1869.2,2817,4731,0
5757,-1332,-1998,1540.4,15404,16706,6.6,4,4,6,203,20.3,2,1,1,0,0,204,20.4,0,4,8,8,7.2,18704,16736,1673.6,1998,1332,0
5758,-253,111,1548.1,15481,17409,6.8,5,5,4,191,19.1,1,1,1,0,0,234,23.4,0,2,4,4,6.6,17298,15734,1573.4,-111,253,1
5759,832,551,1675.1,16751,18674,7.0,6,6,9,239,23.9,1,1,0,1,0,225,22.5,0,2,2,2,6.8,18123,15919,1591.9,-551,-832,1
5760,1745,1766,1844.7,18447,20232,7.4,9,9,10,243,24.3,1,1,1,0,0,240,24.0,0,7,6,6,7.2,18466,16702,1670.2,-1766,-1745,1
5761,-355,-560,1698.3,16983,17858,6.8,7,7,8,227,22.7,0,0,0,1,1,218,21.8,1,10,7,7,7.0,18418,17338,1733.8,560,355,1
5762,-1883,-1131,1459.6,14596,17298,6.8,2,2,2,204,20.4,1,1,0,1,0,254,25.4,0,2,6,6,6.8,18429,16479,1647.9,1131,1883,0
5763,2061,1314,1662.2,16622,19176,7.2,5,5,6,235,23.5,0,0,1,0,0,219,21.9,0,0,2,2,7.0,17862,14561,1456.1,-1314,-2061,1
5764,-828,-1255,1673.0,16730,17780,7.0,6,6,7,208,20.8,0,0,0,1,0,233,23.3,0,7,8,8,7.2,19035,17558,1755.8,1255,828,1
5765,2364,2384,1807.3,18073,21032,7.6,8,8,9,239,23.9,0,0,1,0,0,233,23.3,0,2,4,4,7.0,18648,15709,1570.9,-2384,-2364,0
5766,2962,1156,1862.2,18622,18509,7.0,9,9,9,230,23.0,1,0,0,1,1,181,18.1,1,6,4,4,6.8,17353,15660,1566.0,-1156,-2962,1
5767,178,424,1673.0,16730,19072,7.0,9,9,2,198,19.8,2,1,1,0,0,245,24.5,0,3,4,4,7.2,18648,16552,1655.2,-424,-178,0
5768,-3798,-2337,1572.4,15724,15533,6.4,7,7,8,163,16.3,0,0,0,1,0,222,22.2,1,10,10,10,7.0,17870,19522,1952.2,2337,3798,1
5769,-3761,-2475,1616.1,16161,16954,6.8,5,5,7,213,21.3,0,0,0,1,1,241,24.1,2,13,10,10,7.2,19429,19922,1992.2,2475,3761,0
5770,684,-474,1617.5,16175,17305,6.8,4,4,3,253,25.3,0,0,1,0,0,232,23.2,0,4,4,4,7.0,17779,15491,1549.1,474,-684,0
5771,-2215,-2114,1535.5,15355,17119,6.6,3,3,3,204,20.4,0,0,0,1,1,240,24.0,2,8,7,7,7.2,19233,17570,1757.0,2114,2215,0
5772,3446,1559,1850.4,18504,19016,7.0,10,10,13,206,20.6,0,0,1,0,1,221,22.1,1,2,4,4,6.8,17457,15058,1505.8,-1559,-3446,1
5773,-1546,-1047,1714.7,17147,17510,6.8,8,8,11,194,19.4,1,0,0,1,1,244,24.4,1,12,9,9,6.8,18557,18693,1869.3,1047,1546,0
5774,1384,201,1661.6,16616,19052,7.0,1,1,1,253,25.3,2,1,0,1,0,241,24.1,0,4,2,2,7.2,18851,15232,1523.2,-201,-1384,1
5775,708,1840,1547.1,15471,19583,7.4,7,7,6,206,20.6,1,1,1,0,0,228,22.8,0,2,2,2,7.0,17743,14763,1476.3,-1840,-708,1
5776,-1075,-1160,1707.5,17075,18691,7.2,7,7,6,230,23.0,0,0,1,0,1,232,23.2,1,10,9,9,7.2,19851,18150,1815.0,1160,1075,0
5777,-3798,-2950,1451.9,14519,17122,6.8,2,2,2,223,22.3,1,0,0,1,1,226,22.6,1,13,10,10,7.4,20072,18317,1831.7,2950,3798,0
5778,3326,3001,1866.4,18664,20054,7.4,8,8,14,233,23.3,1,1,1,0,0,215,21.5,0,2,4,4,6.6,17053,15338,1533.8,-3001,-3326,1
5779,-2337,-1158,1476.8,14768,17244,6.6,5,5,4,157,15.7,0,0,0,1,1,217,21.7,1,6,6,6,7.2,18402,17105,1710.5,1158,2337,0
5780,-898,-655,1585.9,15859,18955,7.0,4,4,3,250,25.0,1,1,1,0,0,193,19.3,0,9,7,7,7.0,19610,16757,1675.7,655,898,1
5781,2939,1636,1943.2,19432,19488,7.4,12,12,10,232,23.2,0,0,0,1,0,203,20.3,0,8,8,8,6.8,17852,16493,1649.3,-1636,-2939,0
5782,-3768,-2111,1541.2,15412,17502,6.8,3,3,2,211,21.1,0,0,0,1,1,246,24.6,2,9,7,7,7.4,19613,19180,1918.0,2111,3768,1
5783,-1171,-11,1530.6,15306,17560,6.8,4,4,3,220,22.0,0,0,0,1,0,211,21.1,0,5,6,6,6.8,17571,16477,1647.7,11,1171,0
5784,-2167,-1447,1637.7,16377,17958,7.0,5,5,4,228,22.8,0,0,0,1,0,216,21.6,1,12,10,10,7.2,19405,18544,1854.4,1447,2167,0
5785,498,244,1656.3,16563,18469,7.2,8,8,8,199,19.9,1,1,1,0,0,209,20.9,0,2,6,6,7.0,18225,16065,1606.5,-244,-498,1
5786,4513,3883,1887.9,18879,19552,7.2,10,10,11,222,22.2,1,0,1,0,0,195,19.5,0,3,4,4,6.4,15669,14366,1436.6,-3883,-4513,1
5787,-4201,-4782,1465.6,14656,15475,6.4,5,5,6,186,18.6,0,0,1,0,1,216,21.6,1,11,12,12,7.4,20257,18857,1885.7,4782,4201,0
5788,-4800,-1308,1312.9,13129,16126,6.6,1,1,1,184,18.4,0,0,0,1,0,218,21.8,0,10,8,8,7.0,17434,17929,1792.9,1308,4800,0
5789,2050,1834,1625.6,16256,17985,7.0,5,5,10,218,21.8,2,1,0,1,0,217,21.7,0,3,2,2,6.4,16151,14206,1420.6,-1834,-2050,1
5790,-657,-81,1517.9,15179,17410,6.8,3,3,4,237,23.7,0,0,0,1,1,237,23.7,2,4,4,4,7.0,17491,15836,1583.6,81,657,0
5791,2245,304,1738.4,17384,18045,7.0,6,6,5,241,24.1,0,0,1,0,1,223,22.3,1,3,3,3,6.8,17741,15139,1513.9,-304,-2245,1
5792,4254,3059,1828.0,18280,19206,7.4,12,12,16,209,20.9,1,1,1,0,0,204,20.4,0,4,3,3,6.6,16147,14026,1402.6,-3059,-4254,1
5793,1156,1711,1825.3,18253,19481,7.2,9,9,8,203,20.3,1,0,1,0,0,221,22.1,0,7,7,7,7.0,17770,17097,1709.7,-1711,-1156,0
5794,-455,-1,1472.2,14722,18209,7.2,1,1,1,254,25.4,1,1,0,1,0,263,26.3,1,0,2,2,7.2,18210,15177,1517.7,1,455,0
5795,2277,1630,1859.3,18593,20037,7.4,8,8,9,252,25.2,0,0,0,1,1,203,20.3,1,9,7,7,7.2,18407,16316,1631.6,-1630,-2277,1
5796,928,-128,1734.5,17345,18944,7.0,8,8,9,236,23.6,1,1,1,0,0,198,19.8,0,7,7,7,7.2,19072,16417,1641.7,128,-928,1
5797,4607,2975,1880.4,18804,19826,7.2,9,9,11,272,27.2,1,1,1,0,0,197,19.7,0,2,2,2,6.6,16851,14197,1419.7,-2975,-4607,0
5798,200,532,1559.7,15597,18348,7.2,3,3,5,249,24.9,1,1,0,1,0,203,20.3,0,2,5,5,7.0,17816,15397,1539.7,-532,-200,1
5799,1068,-736,1646.0,16460,17623,7.0,7,7,10,220,22.0,1,1,1,0,0,209,20.9,0,5,5,5,6.8,18359,15392,1539.2,736,-1068,1
5800,1639,1308,1615.6,16156,18605,7.0,3,3,4,233,23.3,1,0,1,0,1,241,24.1,1,3,1,1,7.0,17297,14517,1451.7,-1308,-1639,0
5801,1305,1032,1646.3,16463,17675,6.8,7,7,8,223,22.3,1,0,0,1,0,244,24.4,0,3,3,3,6.6,16643,15158,1515.8,-1032,-1305,1
5802,1764,2586,1754.1,17541,19979,7.2,7,7,5,232,23.2,1,1,1,0,0,208,20.8,0,7,5,5,6.8,17393,15777,1577.7,-2586,-1764,1
5803,-2620,-1037,1502.0,15020,16196,6.6,5,5,6,182,18.2,1,0,0,1,1,197,19.7,1,11,10,10,6.8,17233,17640,1764.0,1037,2620,0
5804,-2142,-1742,1468.7,14687,16647,6.6,4,4,2,216,21.6,0,0,0,1,1,223,22.3,1,5,6,6,6.8,18389,16829,1682.9,1742,2142,1
5805,-938,-729,1550.2,15502,16609,6.8,4,4,6,227,22.7,0,0,0,1,1,239,23.9,1,5,6,6,6.8,17338,16440,1644.0,729,938,0
5806,2646,2305,1741.3,17413,19603,7.2,6,6,1,257,25.7,0,0,1,0,1,210,21.0,1,2,2,2,6.6,17298,14767,1476.7,-2305,-2646,1
5807,-54,616,1600.1,16001,18372,7.2,3,3,5,265,26.5,1,1,0,1,0,223,22.3,0,6,4,4,6.6,17756,16055,1605.5,-616,54,0
5808,293,718,1704.0,17040,18774,7.2,4,4,2,228,22.8,1,0,0,1,1,204,20.4,1,7,7,7,6.8,18056,16747,1674.7,-718,-293,0
5809,-1138,-1025,1592.0,15920,17523,6.6,4,4,5,234,23.4,1,1,1,0,0,237,23.7,0,8,7,7,7.0,18548,17058,1705.8,1025,1138,0
5810,360,97,1740.8,17408,17809,7.0,9,9,11,207,20.7,2,1,0,1,0,191,19.1,0,12,8,8,7.0,17712,17048,1704.8,-97,-360,1
5811,-127,515,1639.4,16394,18234,7.0,5,5,5,251,25.1,0,0,0,1,1,194,19.4,1,12,7,7,7.0,17719,16521,1652.1,-515,127,0
5812,-3160,-3099,1340.8,13408,16175,6.4,2,2,0,192,19.2,0,0,1,0,1,224,22.4,1,6,5,5,7.2,19274,16568,1656.8,3099,3160,0
5813,118,-2044,1769.7,17697,16356,6.8,8,8,7,208,20.8,0,0,1,0,1,200,20.0,1,5,9,9,7.2,18400,17579,1757.9,2044,-118,1
5814,-3205,-2487,1570.8,15708,17799,7.0,5,5,4,219,21.9,1,1,0,1,0,231,23.1,1,8,12,12,7.4,20286,18913,1891.3,2487,3205,1
5815,-206,290,1840.9,18409,17925,7.0,11,11,12,219,21.9,0,0,0,1,0,174,17.4,0,12,11,11,7.0,17635,18615,1861.5,-290,206,1
5816,-6954,-5631,1262.2,12622,13759,5.8,1,1,1,185,18.5,0,0,1,0,1,228,22.8,2,16,13,13,7.4,19390,19576,1957.6,5631,6954,0
5817,2471,827,1750.3,17503,18043,7.2,9,9,9,204,20.4,0,0,1,0,1,212,21.2,1,4,3,3,6.8,17216,15032,1503.2,-827,-2471,1
5818,-96,827,1693.6,16936,18077,7.0,7,7,7,236,23.6,1,0,0,1,1,211,21.1,1,8,8,8,6.8,17250,17032,1703.2,-827,96,1
5819,-1567,-713,1462.2,14622,18174,7.2,3,3,3,206,20.6,0,0,0,1,1,237,23.7,1,3,5,5,7.2,18887,16189,1618.9,713,1567,0
5820,920,1098,1626.6,16266,17825,7.0,6,6,3,213,21.3,0,0,0,1,0,210,21.0,0,4,6,6,6.6,16727,15346,1534.6,-1098,-920,1
5821,-1279,-1122,1524.0,15240,17456,6.8,3,3,9,243,24.3,1,1,0,1,0,244,24.4,0,6,4,4,7.2,18578,16519,1651.9,1122,1279,0
5822,681,2047,1691.1,16911,18891,7.2,5,5,3,247,24.7,1,0,0,1,1,196,19.6,1,10,7,7,6.8,16844,16230,1623.0,-2047,-681,1
5823,-3872,-3173,1405.5,14055,17109,6.8,1,1,1,204,20.4,1,0,0,1,0,214,21.4,0,9,9,9,7.6,20282,17927,1792.7,3173,3872,0
5824,1329,1625,1722.7,17227,20568,7.6,7,7,5,218,21.8,2,1,1,0,0,207,20.7,0,3,5,5,7.0,18943,15898,1589.8,-1625,-1329,1
5825,-1784,-2938,1552.5,15525,16079,6.6,4,4,3,198,19.8,0,0,1,0,0,227,22.7,0,7,8,8,7.0,19017,17309,1730.9,2938,1784,0
5826,-7911,-3435,1419.9,14199,16214,6.4,2,2,4,167,16.7,0,0,0,1,1,223,22.3,1,17,12,12,7.2,19649,22110,2211.0,3435,7911,0
5827,828,-804,1661.0,16610,17963,7.0,5,5,6,263,26.3,1,1,0,1,0,243,24.3,0,3,4,4,7.2,18767,15782,1578.2,804,-828,1
5828,-3418,-3733,1430.7,14307,16295,6.4,1,1,2,211,21.1,0,0,0,1,1,234,23.4,2,5,6,6,7.4,20028,17725,1772.5,3733,3418,0
5829,2522,2156,1664.6,16646,18209,7.0,9,9,7,236,23.6,0,0,1,0,1,210,21.0,1,3,3,3,6.6,16053,14124,1412.4,-2156,-2522,1
5830,-2882,-1423,1531.6,15316,17001,6.4,4,4,8,215,21.5,1,0,0,1,1,218,21.8,1,14,10,10,6.8,18424,18198,1819.8,1423,2882,0
5831,-2714,-427,1483.4,14834,16539,6.6,4,4,5,191,19.1,0,0,0,1,0,198,19.8,1,11,8,8,6.8,16966,17548,1754.8,427,2714,1
5832,276,-106,1602.7,16027,18775,7.0,6,6,2,231,23.1,1,1,1,0,0,239,23.9,0,4,4,4,7.2,18881,15751,1575.1,106,-276,1
5833,-704,-1028,1563.1,15631,18436,7.2,3,3,2,252,25.2,0,0,0,1,1,229,22.9,1,4,5,5,7.4,19464,16335,1633.5,1028,704,0
5834,-1210,-2064,1511.4,15114,16890,6.8,4,4,4,193,19.3,1,1,1,0,0,213,21.3,0,4,9,9,7.2,18954,16324,1632.4,2064,1210,0
5835,1101,1147,1692.9,16929,19425,7.4,6,6,5,263,26.3,2,1,1,0,0,242,24.2,0,3,3,3,7.2,18278,15828,1582.8,-1147,-1101,1
5836,371,514,1782.8,17828,18635,7.0,10,10,12,184,18.4,1,1,1,0,0,219,21.9,1,9,9,9,7.0,18121,17457,1745.7,-514,-371,1
5837,-2226,-2642,1406.2,14062,17156,6.8,2,2,1,219,21.9,0,0,0,1,1,238,23.8,2,2,6,6,7.4,19798,16288,1628.8,2642,2226,0
5838,-508,-1263,1588.5,15885,16411,6.6,5,5,4,213,21.3,1,1,1,0,0,235,23.5,0,5,5,5,7.0,17674,16393,1639.3,1263,508,1
5839,-2971,-1923,1397.6,13976,16595,6.6,1,1,2,211,21.1,0,0,0,1,1,231,23.1,1,7,7,7,7.2,18518,16947,1694.7,1923,2971,0
5840,734,1966,1689.8,16898,18746,7.2,8,8,14,213,21.3,0,0,0,1,0,209,20.9,0,9,6,6,6.4,16780,16164,1616.4,-1966,-734,1
5841,956,2176,1653.5,16535,19103,7.2,5,5,3,206,20.6,1,1,0,1,0,197,19.7,0,5,7,7,6.6,16927,15579,1557.9,-2176,-956,1
5842,1840,-279,1684.7,16847,17476,7.0,7,7,9,223,22.3,0,0,1,0,1,224,22.4,1,1,3,3,6.8,17755,15007,1500.7,279,-1840,0
5843,-2138,-990,1593.7,15937,18739,7.2,4,4,4,219,21.9,0,0,0,1,1,254,25.4,1,13,8,8,7.2,19729,18075,1807.5,990,2138,0
5844,-5403,-4604,1345.3,13453,15565,6.4,1,1,1,215,21.5,0,0,0,1,1,232,23.2,1,17,12,12,7.4,20169,18856,1885.6,4604,5403,0
5845,-1763,-2184,1707.1,17071,17610,6.8,4,4,8,205,20.5,0,0,0,1,1,236,23.6,1,10,9,9,7.4,19794,18834,1883.4,2184,1763,0
5846,-294,321,1622.4,16224,18247,7.0,4,4,2,212,21.2,0,0,0,1,0,205,20.5,0,5,7,7,7.0,17926,16518,1651.8,-321,294,0
5847,2806,-579,1977.6,19776,17806,7.0,16,16,26,191,19.1,1,1,1,0,0,197,19.7,0,11,7,7,7.2,18385,16970,1697.0,579,-2806,1
5848,3119,896,1746.1,17461,18412,7.2,9,9,13,235,23.5,1,1,1,0,0,228,22.8,1,1,1,1,7.0,17516,14342,1434.2,-896,-3119,1
5849,-495,934,1635.5,16355,17876,7.0,8,8,9,193,19.3,0,0,0,1,1,191,19.1,1,7,7,7,6.6,16942,16850,1685.0,-934,495,0
5850,2905,2774,1732.5,17325,20228,7.6,7,7,7,238,23.8,2,1,1,0,0,222,22.2,0,3,2,2,6.6,17454,14420,1442.0,-2774,-2905,1
5851,-842,-711,1639.1,16391,17744,6.8,5,5,9,228,22.8,0,0,1,0,1,239,23.9,1,9,8,8,7.0,18455,17233,1723.3,711,842,1
5852,1881,635,1693.8,16938,18241,7.0,4,4,5,213,21.3,1,0,1,0,0,224,22.4,0,5,4,4,6.8,17606,15057,1505.7,-635,-1881,1
5853,-2883,-3312,1531.6,15316,15976,6.6,4,4,5,184,18.4,0,0,0,1,1,194,19.4,1,15,15,15,7.2,19288,18199,1819.9,3312,2883,0
5854,-5394,-5037,1230.0,12300,14201,6.0,1,1,0,171,17.1,0,0,0,1,1,246,24.6,2,8,7,7,7.2,19238,17694,1769.4,5037,5394,0
5855,-4432,-3639,1537.3,15373,16348,6.6,4,4,5,217,21.7,1,0,0,1,1,226,22.6,1,16,11,11,7.4,19987,19805,1980.5,3639,4432,0
5856,52,-934,1519.6,15196,17168,6.8,1,1,2,262,26.2,0,0,0,1,0,246,24.6,1,2,3,3,7.0,18102,15144,1514.4,934,-52,0
5857,1835,393,1718.4,17184,16943,6.6,7,7,7,206,20.6,1,0,0,1,1,217,21.7,1,5,6,6,6.6,16550,15349,1534.9,-393,-1835,1
5858,173,461,1613.5,16135,16458,6.6,4,4,8,213,21.3,0,0,1,0,1,196,19.6,1,11,6,6,6.4,15997,15962,1596.2,-461,-173,1
5859,-1957,422,1465.8,14658,16832,6.6,2,2,1,210,21.0,0,0,0,1,1,209,20.9,1,7,5,5,6.6,16410,16615,1661.5,-422,1957,0
5860,-1633,-2918,1542.0,15420,16822,6.8,4,4,5,235,23.5,0,0,1,0,0,253,25.3,1,5,6,6,7.4,19740,17053,1705.3,2918,1633,1
5861,2635,2531,1813.0,18130,19442,7.2,9,9,8,220,22.0,0,0,1,0,0,195,19.5,0,4,6,6,6.6,16911,15495,1549.5,-2531,-2635,1
5862,-326,-294,1511.9,15119,18281,6.8,1,1,1,249,24.9,1,1,0,1,0,228,22.8,1,3,3,3,7.4,18575,15445,1544.5,294,326,1
5863,3157,1899,1710.1,17101,18332,7.0,9,9,10,207,20.7,1,1,1,0,0,239,23.9,0,0,1,1,6.4,16433,13944,1394.4,-1899,-3157,1
5864,-386,-775,1583.2,15832,17807,7.0,5,5,4,225,22.5,0,0,1,0,0,244,24.4,0,4,4,4,7.0,18582,16218,1621.8,775,386,1
5865,-1685,-2902,1508.8,15088,16413,6.6,3,3,4,209,20.9,1,0,1,0,0,235,23.5,0,6,7,7,7.4,19315,16773,1677.3,2902,1685,1
5866,1962,730,1621.3,16213,18235,7.2,3,3,3,247,24.7,0,0,1,0,0,212,21.2,1,6,3,3,6.8,17505,14251,1425.1,-730,-1962,1
5867,2298,1572,1730.0,17300,19249,7.0,8,8,10,223,22.3,1,0,1,0,1,248,24.8,1,0,2,2,7.0,17677,15002,1500.2,-1572,-2298,1
5868,588,1104,1681.8,16818,18842,7.0,8,8,4,213,21.3,0,0,1,0,1,232,23.2,1,7,6,6,7.0,17738,16230,1623.0,-1104,-588,1
5869,-2880,-2174,1716.3,17163,17099,6.6,9,9,13,190,19.0,0,0,1,0,0,213,21.3,0,11,13,13,7.0,19273,20043,2004.3,2174,2880,0
5870,-1071,-120,1552.2,15522,18317,7.0,4,4,4,214,21.4,1,0,0,1,1,246,24.6,1,7,5,5,7.2,18437,16593,1659.3,120,1071,1
5871,-1001,-825,1699.1,16991,17910,7.0,8,8,10,205,20.5,1,1,0,1,0,225,22.5,0,6,10,10,7.2,18735,17992,1799.2,825,1001,0
5872,1253,-235,1755.6,17556,18073,7.0,9,9,10,220,22.0,0,0,1,0,0,191,19.1,0,4,7,7,7.0,18308,16303,1630.3,235,-1253,1
5873,887,346,1735.9,17359,18731,7.2,9,9,12,225,22.5,0,0,0,1,0,237,23.7,0,2,6,6,6.8,18385,16472,1647.2,-346,-887,1
5874,702,4,1884.9,18849,18593,7.2,12,12,10,216,21.6,0,0,1,0,1,182,18.2,1,12,11,11,7.0,18589,18147,1814.7,-4,-702,0
5875,-1443,-1629,1526.0,15260,17024,6.8,4,4,6,201,20.1,0,0,1,0,1,212,21.2,1,9,6,6,7.4,18653,16703,1670.3,1629,1443,1
5876,3113,2284,1830.7,18307,19026,7.2,9,9,10,244,24.4,0,0,1,0,1,213,21.3,1,3,4,4,6.4,16742,15194,1519.4,-2284,-3113,1
5877,-2151,-852,1536.3,15363,15411,6.2,7,7,9,171,17.1,1,1,1,0,0,199,19.9,0,9,11,11,6.4,16263,17514,1751.4,852,2151,0
5878,204,-344,1754.3,17543,19187,7.2,7,7,8,236,23.6,0,0,1,0,1,237,23.7,1,7,9,9,7.2,19531,17339,1733.9,344,-204,0
5879,710,288,1851.3,18513,17991,7.0,10,10,14,213,21.3,1,1,1,0,0,191,19.1,0,13,9,9,6.8,17703,17803,1780.3,-288,-710,1
5880,-483,320,1591.3,15913,16789,6.8,6,6,5,197,19.7,0,0,1,0,0,187,18.7,1,7,8,8,6.6,16469,16396,1639.6,-320,483,1
5881,-643,508,1660.5,16605,18407,7.0,7,7,4,199,19.9,1,1,1,0,0,241,24.1,1,5,5,5,6.8,17899,17248,1724.8,-508,643,1
5882,436,338,1764.1,17641,16803,6.8,9,9,13,199,19.9,1,1,1,0,0,207,20.7,0,11,9,9,6.4,16465,17205,1720.5,-338,-436,0
5883,2005,2005,1856.4,18564,19783,7.2,9,9,8,212,21.2,0,0,1,0,0,236,23.6,0,7,5,5,7.2,17778,16559,1655.9,-2005,-2005,1
5884,192,88,1558.8,15588,17603,6.8,4,4,3,225,22.5,0,0,0,1,1,241,24.1,2,7,4,4,6.6,17515,15396,1539.6,-88,-192,1
5885,-675,-2016,1472.2,14722,16664,6.4,4,4,3,187,18.7,1,1,0,1,0,185,18.5,0,5,5,5,7.2,18680,15397,1539.7,2016,675,1
5886,-869,327,1653.1,16531,16364,6.6,7,7,10,202,20.2,0,0,0,1,1,219,21.9,1,9,7,7,6.6,16037,17400,1740.0,-327,869,0
5887,-390,-502,1547.1,15471,17472,7.0,3,3,3,233,23.3,1,1,1,0,0,240,24.0,1,5,3,3,6.8,17974,15861,1586.1,502,390,0
5888,2369,2245,1727.1,17271,18144,7.0,7,7,7,246,24.6,1,0,1,0,1,190,19.0,1,4,5,5,6.4,15899,14902,1490.2,-2245,-2369,1
5889,3251,2936,1735.1,17351,19306,7.2,8,8,8,235,23.5,1,1,0,1,0,213,21.3,1,1,2,2,6.6,16370,14100,1410.0,-2936,-3251,1
5890,-1642,-703,1486.9,14869,17895,6.8,2,2,2,238,23.8,1,0,0,1,1,224,22.4,1,8,6,6,7.2,18598,16511,1651.1,703,1642,0
5891,-1256,-844,1653.4,16534,17934,7.0,6,6,5,231,23.1,0,0,1,0,0,235,23.5,1,9,9,9,7.2,18778,17790,1779.0,844,1256,0
5892,-1613,474,1622.6,16226,18754,7.2,6,6,4,221,22.1,1,0,0,1,1,215,21.5,1,11,10,10,7.0,18280,17839,1783.9,-474,1613,1
5893,2341,2303,1684.7,16847,19065,7.4,6,6,6,220,22.0,1,1,1,0,0,214,21.4,0,3,3,3,6.6,16762,14506,1450.6,-2303,-2341,1
5894,-1635,-2200,1658.3,16583,17229,6.4,8,8,9,198,19.8,0,0,0,1,1,211,21.1,1,7,11,11,7.2,19429,18218,1821.8,2200,1635,1
5895,66,319,1557.3,15573,18440,7.0,1,1,1,246,24.6,0,0,1,0,1,233,23.3,2,6,3,3,7.0,18121,15507,1550.7,-319,-66,0
5896,995,2657,1777.0,17770,19036,7.4,10,10,6,239,23.9,0,0,1,0,0,155,15.5,0,8,9,9,6.6,16379,16775,1677.5,-2657,-995,1
5897,1207,1885,1585.0,15850,18831,7.2,4,4,4,233,23.3,0,0,0,1,1,229,22.9,1,4,3,3,6.6,16946,14643,1464.3,-1885,-1207,0
5898,-3750,-3108,1375.6,13756,16900,6.6,1,1,1,238,23.8,0,0,0,1,1,244,24.4,2,3,4,4,7.2,20008,17506,1750.6,3108,3750,1
5899,-3240,-2369,1519.2,15192,16557,6.6,5,5,5,198,19.8,0,0,0,1,0,252,25.2,0,18,9,9,7.2,18926,18432,1843.2,2369,3240,0
5900,1706,1239,1761.1,17611,18414,7.2,9,9,11,223,22.3,1,0,1,0,1,233,23.3,1,6,4,4,6.8,17175,15905,1590.5,-1239,-1706,1
5901,-2183,-1025,1479.6,14796,17144,6.6,4,4,3,209,20.9,0,0,0,1,1,236,23.6,1,5,6,6,6.8,18169,16979,1697.9,1025,2183,1
5902,5222,3469,1851.9,18519,20004,7.2,8,8,8,235,23.5,2,1,1,0,0,187,18.7,0,0,0,0,6.6,16535,13297,1329.7,-3469,-5222,1
5903,755,-289,1575.0,15750,18310,7.0,4,4,3,233,23.3,0,0,0,1,1,248,24.8,1,2,2,2,7.0,18599,14995,1499.5,289,-755,1
5904,-2068,36,1596.7,15967,17259,6.8,7,7,4,205,20.5,0,0,0,1,0,210,21.0,0,12,11,11,6.8,17223,18035,1803.5,-36,2068,0
5905,295,857,1677.7,16777,18587,7.0,6,6,6,212,21.2,0,0,1,0,1,218,21.8,1,7,7,7,7.0,17730,16482,1648.2,-857,-295,0
5906,2563,1726,1714.5,17145,17795,7.0,8,8,11,204,20.4,0,0,1,0,1,181,18.1,1,5,5,5,6.6,16069,14582,1458.2,-1726,-2563,1
5907,763,1025,1730.9,17309,19092,7.2,7,7,4,253,25.3,0,0,1,0,1,217,21.7,1,9,7,7,7.0,18067,16546,1654.6,-1025,-763,1
5908,2346,1776,1921.9,19219,18673,7.0,10,10,9,229,22.9,1,1,1,0,0,177,17.7,0,10,9,9,6.8,16897,16873,1687.3,-1776,-2346,1
5909,113,-518,1616.4,16164,18306,7.0,6,6,3,226,22.6,0,0,1,0,1,223,22.3,1,9,5,5,7.4,18824,16051,1605.1,518,-113,1
5910,135,794,1722.0,17220,18678,7.2,7,7,9,202,20.2,1,1,0,1,0,228,22.8,0,6,7,7,6.8,17884,17085,1708.5,-794,-135,0
5911,-1063,63,1452.7,14527,17128,6.8,5,5,4,195,19.5,2,1,1,0,0,217,21.7,0,4,5,5,6.8,17065,15590,1559.0,-63,1063,1
5912,59,1149,1435.5,14355,17580,6.8,2,2,2,217,21.7,1,0,0,1,1,205,20.5,1,6,3,3,6.6,16431,14296,1429.6,-1149,-59,0
5913,3579,2473,1867.2,18672,19616,7.2,10,10,11,243,24.3,1,0,1,0,1,212,21.2,1,2,3,3,6.8,17143,15093,1509.3,-2473,-3579,1
5914,563,-1127,1648.1,16481,18268,7.2,5,5,4,221,22.1,0,0,1,0,1,217,21.7,1,4,6,6,7.2,19395,15918,1591.8,1127,-563,1
5915,2595,776,1837.6,18376,17877,7.0,7,7,10,225,22.5,0,0,0,1,1,201,20.1,2,4,6,6,6.6,17101,15781,1578.1,-776,-2595,0
5916,-6134,-6414,1389.9,13899,15844,6.4,2,2,3,195,19.5,0,0,0,1,1,236,23.6,1,9,12,12,8.2,22258,20033,2003.3,6414,6134,0
5917,1284,-1614,1634.5,16345,17851,7.0,5,5,7,230,23.0,1,1,1,0,0,200,20.0,1,3,5,5,7.2,19465,15061,1506.1,1614,-1284,1
5918,4042,4968,1796.4,17964,18073,7.2,7,7,14,216,21.6,1,1,1,0,0,172,17.2,0,4,5,5,5.4,13105,13922,1392.2,-4968,-4042,1
5919,-817,-1289,1459.1,14591,17823,6.8,1,1,0,230,23.0,0,0,0,1,1,253,25.3,1,0,1,1,7.0,19112,15408,1540.8,1289,817,0
5920,1118,871,1648.6,16486,18617,7.2,4,4,5,256,25.6,2,1,0,1,0,224,22.4,0,6,4,4,6.8,17746,15368,1536.8,-871,-1118,1
5921,1833,899,1663.6,16636,18741,7.2,6,6,4,225,22.5,0,0,1,0,1,201,20.1,1,3,2,2,6.8,17842,14803,1480.3,-899,-1833,1
5922,3052,3581,1758.5,17585,19376,7.2,4,4,4,270,27.0,0,0,0,1,0,200,20.0,0,8,3,3,6.6,15795,14533,1453.3,-3581,-3052,1
5923,-3559,-3823,1623.3,16233,17101,6.4,3,3,5,216,21.6,1,1,0,1,0,236,23.6,1,6,9,9,7.6,20924,19792,1979.2,3823,3559,0
5924,-1619,265,1683.0,16830,17100,7.0,8,8,9,206,20.6,0,0,0,1,0,158,15.8,1,19,12,12,7.0,16835,18449,1844.9,-265,1619,0
5925,3766,3001,1925.7,19257,18701,7.0,9,9,8,224,22.4,1,0,1,0,0,186,18.6,0,9,6,6,6.4,15700,15491,1549.1,-3001,-3766,1
5926,1807,1076,1697.7,16977,18682,7.0,5,5,5,231,23.1,0,0,1,0,0,237,23.7,1,1,2,2,7.0,17606,15170,1517.0,-1076,-1807,1
5927,697,951,1551.7,15517,17441,6.8,4,4,2,215,21.5,2,1,0,1,0,211,21.1,0,3,3,3,6.8,16490,14820,1482.0,-951,-697,1
5928,532,-883,1781.0,17810,16753,6.6,12,12,13,150,15.0,2,1,1,0,0,255,25.5,0,8,7,7,6.8,17636,17278,1727.8,883,-532,0
5929,-824,-976,1545.4,15454,16466,6.8,5,5,9,210,21.0,0,0,0,1,0,240,24.0,0,8,5,5,6.8,17442,16278,1627.8,976,824,0
5930,4294,2844,1804.8,18048,19291,7.0,12,12,10,185,18.5,1,1,1,0,0,176,17.6,0,0,1,1,6.4,16447,13754,1375.4,-2844,-4294,1
5931,206,-453,1693.8,16938,18493,7.2,7,7,7,223,22.3,1,1,1,0,0,234,23.4,1,3,6,6,7.4,18946,16732,1673.2,453,-206,0
5932,2851,1140,1858.7,18587,19265,7.4,9,9,14,223,22.3,0,0,0,1,1,226,22.6,1,3,4,4,6.8,18125,15736,1573.6,-1140,-2851,1
5933,-4331,-3757,1371.1,13711,15114,6.2,2,2,1,180,18.0,0,0,0,1,1,216,21.6,2,12,10,10,7.2,18871,18042,1804.2,3757,4331,1
5934,4039,1819,1768.7,17687,18128,7.0,6,6,9,232,23.2,0,0,1,0,0,217,21.7,0,1,1,1,6.6,16309,13648,1364.8,-1819,-4039,1
5935,2241,639,1717.0,17170,18330,6.8,6,6,6,238,23.8,1,0,1,0,0,214,21.4,0,3,3,3,6.6,17691,14929,1492.9,-639,-2241,0
5936,567,1254,1705.5,17055,19405,7.2,7,7,7,230,23.0,0,0,0,1,1,201,20.1,1,7,6,6,7.0,18151,16488,1648.8,-1254,-567,0
5937,226,-957,1676.0,16760,16804,6.8,9,9,10,193,19.3,0,0,0,1,0,213,21.3,0,2,6,6,6.8,17761,16534,1653.4,957,-226,0
5938,-3865,-1779,1568.0,15680,18107,6.8,5,5,4,197,19.7,1,1,0,1,0,223,22.3,0,15,13,13,7.2,19886,19545,1954.5,1779,3865,0
5939,-6282,-4301,1367.0,13670,15417,6.2,4,4,3,166,16.6,0,0,0,1,1,233,23.3,1,8,9,9,7.2,19718,19952,1995.2,4301,6282,0
5940,3072,3561,2030.5,20305,19846,7.4,14,14,17,239,23.9,1,1,0,1,0,189,18.9,0,9,8,8,6.8,16285,17233,1723.3,-3561,-3072,1
5941,55,-1918,1620.9,16209,18162,7.0,5,5,7,231,23.1,1,1,1,0,0,228,22.8,0,3,6,6,7.2,20080,16154,1615.4,1918,-55,1
5942,4299,3637,2086.0,20860,19749,7.2,13,13,17,239,23.9,2,1,0,1,0,192,19.2,0,10,8,8,6.4,16112,16561,1656.1,-3637,-4299,1
5943,1338,1039,1618.0,16180,17769,6.8,4,4,6,217,21.7,1,0,0,1,0,216,21.6,0,3,4,4,6.6,16730,14842,1484.2,-1039,-1338,0
5944,2185,955,1760.8,17608,18800,7.2,8,8,8,210,21.0,0,0,1,0,0,231,23.1,0,4,3,3,6.8,17845,15423,1542.3,-955,-2185,1
5945,-109,158,1724.8,17248,16433,6.6,9,9,8,185,18.5,1,1,0,1,0,195,19.5,0,6,11,11,6.4,16275,17357,1735.7,-158,109,0
5946,1196,-85,1702.5,17025,18219,7.0,6,6,6,211,21.1,0,0,0,1,1,228,22.8,1,2,4,4,7.0,18304,15829,1582.9,85,-1196,1
5947,-3028,-3555,1445.1,14451,16229,6.8,3,3,8,225,22.5,0,0,1,0,0,223,22.3,1,8,8,8,7.4,19784,17479,1747.9,3555,3028,0
5948,734,-965,1716.9,17169,17752,7.0,8,8,9,210,21.0,0,0,1,0,0,207,20.7,0,5,7,7,7.0,18717,16435,1643.5,965,-734,0
5949,-1035,-442,1590.8,15908,18702,7.2,6,6,7,208,20.8,2,1,0,1,0,229,22.9,0,2,6,6,7.2,19144,16943,1694.3,442,1035,0
5950,-3669,-2489,1494.8,14948,17592,6.8,2,2,3,226,22.6,0,0,0,1,1,255,25.5,1,14,8,8,7.6,20081,18617,1861.7,2489,3669,1
5951,-1833,-393,1694.1,16941,17520,7.0,8,8,14,203,20.3,0,0,0,1,1,210,21.0,2,17,12,12,7.0,17913,18774,1877.4,393,1833,0
5952,714,-176,1841.0,18410,18561,7.2,9,9,7,253,25.3,1,1,1,0,0,232,23.2,0,10,10,10,7.0,18737,17696,1769.6,176,-714,1
5953,-1652,466,1528.8,15288,18328,6.8,5,5,3,218,21.8,1,1,0,1,0,224,22.4,0,9,6,6,6.8,17862,16940,1694.0,-466,1652,0
5954,-4840,-4530,1344.6,13446,15362,6.4,1,1,0,204,20.4,0,0,1,0,1,258,25.8,2,6,6,6,7.2,19892,18286,1828.6,4530,4840,0
5955,3247,576,1880.2,18802,17609,6.8,8,8,11,236,23.6,1,0,1,0,0,207,20.7,0,4,5,5,6.8,17033,15555,1555.5,-576,-3247,1
5956,1343,519,1639.8,16398,17792,7.0,5,5,6,234,23.4,0,0,1,0,1,225,22.5,1,1,2,2,6.8,17273,15055,1505.5,-519,-1343,1
5957,36,-325,1577.8,15778,18381,7.2,4,4,4,219,21.9,0,0,0,1,0,220,22.0,0,1,4,4,7.2,18706,15742,1574.2,325,-36,0
5958,-879,254,1463.4,14634,18284,7.0,3,3,1,213,21.3,0,0,0,1,1,248,24.8,1,3,3,3,7.0,18030,15513,1551.3,-254,879,0
5959,-3941,-3623,1426.9,14269,15867,6.4,2,2,3,203,20.3,0,0,0,1,1,239,23.9,1,9,9,9,7.2,19490,18210,1821.0,3623,3941,1
5960,-987,-1705,1603.1,16031,17016,6.6,6,6,11,215,21.5,1,1,1,0,0,223,22.3,0,8,8,8,6.8,18721,17018,1701.8,1705,987,0
5961,-3294,-2723,1381.7,13817,14829,6.4,3,3,3,167,16.7,0,0,0,1,1,206,20.6,1,5,8,8,6.6,17552,17111,1711.1,2723,3294,0
5962,-2198,-1633,1628.0,16280,17350,6.6,5,5,5,199,19.9,1,1,0,1,0,188,18.8,0,15,11,11,7.2,18983,18478,1847.8,1633,2198,0
5963,-3916,-1400,1482.3,14823,17193,6.8,3,3,5,193,19.3,0,0,0,1,1,245,24.5,2,7,8,8,7.0,18593,18739,1873.9,1400,3916,1
5964,-1342,-1278,1717.4,17174,18159,7.0,9,9,7,189,18.9,0,0,1,0,1,238,23.8,1,10,9,9,7.2,19437,18516,1851.6,1278,1342,1
5965,1942,1658,1734.9,17349,19375,7.6,8,8,8,197,19.7,1,0,0,1,1,228,22.8,1,2,4,4,6.8,17717,15407,1540.7,-1658,-1942,1
5966,-2466,-1449,1323.5,13235,15728,6.4,1,1,2,187,18.7,1,0,0,1,1,221,22.1,1,6,5,5,6.6,17177,15701,1570.1,1449,2466,0
5967,-1535,-838,1623.1,16231,16805,6.6,6,6,8,179,17.9,0,0,0,1,1,192,19.2,1,11,10,10,6.8,17643,17766,1776.6,838,1535,0
5968,-965,658,1525.5,15255,18352,7.2,4,4,3,228,22.8,2,1,0,1,0,223,22.3,0,5,5,5,7.0,17694,16220,1622.0,-658,965,1
5969,-1676,-532,1533.7,15337,18920,7.2,2,2,1,235,23.5,0,0,0,1,0,228,22.8,0,8,5,5,7.4,19452,17013,1701.3,532,1676,1
5970,2847,1559,1805.0,18050,17022,6.6,9,9,9,220,22.0,0,0,1,0,1,176,17.6,1,6,6,6,6.2,15463,15203,1520.3,-1559,-2847,1
5971,1383,660,1573.0,15730,18012,6.8,4,4,4,240,24.0,1,1,1,0,0,221,22.1,0,1,2,2,6.6,17352,14347,1434.7,-660,-1383,1
5972,-439,-983,1475.2,14752,17798,6.8,2,2,3,230,23.0,0,0,0,1,1,222,22.2,2,3,3,3,7.2,18781,15191,1519.1,983,439,0
5973,1989,2500,1757.8,17578,19495,7.2,9,9,10,213,21.3,0,0,0,1,1,218,21.8,1,5,5,5,6.8,16995,15589,1558.9,-2500,-1989,1
5974,-775,-393,1539.7,15397,17110,6.6,5,5,3,222,22.2,1,1,0,1,0,191,19.1,0,5,6,6,6.8,17503,16172,1617.2,393,775,1
5975,872,-215,1701.2,17012,17507,7.0,8,8,10,225,22.5,1,0,1,0,1,214,21.4,1,6,6,6,6.8,17722,16140,1614.0,215,-872,0
5976,762,1570,1488.6,14886,18605,6.8,2,2,1,234,23.4,1,0,1,0,1,209,20.9,1,1,2,2,6.8,17035,14124,1412.4,-1570,-762,1
5977,3214,2261,1959.2,19592,19231,7.2,12,12,14,235,23.5,2,1,1,0,0,184,18.4,0,5,7,7,7.0,16970,16378,1637.8,-2261,-3214,1
5978,175,989,1755.0,17550,18791,7.2,7,7,6,237,23.7,0,0,0,1,1,221,22.1,1,9,9,9,6.8,17802,17375,1737.5,-989,-175,0
5979,1138,558,1710.6,17106,17550,6.8,7,7,6,226,22.6,0,0,1,0,0,202,20.2,1,5,6,6,6.8,16992,15968,1596.8,-558,-1138,1
5980,1062,445,1797.7,17977,18586,7.2,8,8,9,255,25.5,1,0,1,0,1,203,20.3,1,8,7,7,7.2,18141,16915,1691.5,-445,-1062,0
5981,2348,2678,1695.3,16953,19642,7.2,6,6,5,248,24.8,1,1,1,0,0,225,22.5,0,3,2,2,6.6,16964,14605,1460.5,-2678,-2348,1
5982,-4770,-3411,1355.0,13550,15932,6.4,2,2,2,183,18.3,0,0,0,1,1,236,23.6,1,7,10,10,7.4,19343,18320,1832.0,3411,4770,0
5983,-3595,-1973,1522.4,15224,16862,6.8,4,4,7,189,18.9,0,0,0,1,1,221,22.1,1,11,11,11,7.0,18835,18819,1881.9,1973,3595,0
5984,3881,3409,1858.2,18582,19702,7.6,9,9,9,243,24.3,1,1,1,0,0,217,21.7,0,4,3,3,6.6,16293,14701,1470.1,-3409,-3881,1
5985,6577,4426,2120.2,21202,21701,7.8,15,15,12,238,23.8,1,0,1,0,0,188,18.8,0,3,3,3,7.0,17275,14625,1462.5,-4426,-6577,1
5986,-1247,400,1606.6,16066,17944,6.8,7,7,3,224,22.4,2,1,1,0,0,225,22.5,0,3,5,5,6.8,17544,17313,1731.3,-400,1247,0
5987,1669,113,1807.7,18077,17869,6.8,9,9,11,235,23.5,1,1,0,1,0,218,21.8,0,4,6,6,7.0,17756,16408,1640.8,-113,-1669,1
5988,580,709,1604.2,16042,19220,7.2,3,3,6,255,25.5,1,1,0,1,0,231,23.1,1,2,3,3,7.0,18511,15462,1546.2,-709,-580,0
5989,165,267,1478.1,14781,16316,6.6,4,4,7,209,20.9,0,0,1,0,1,185,18.5,1,8,4,4,6.4,16049,14616,1461.6,-267,-165,1
5990,-1597,-1321,1590.4,15904,15750,6.4,7,7,4,198,19.8,1,0,1,0,1,170,17.0,1,15,11,11,6.8,17071,17501,1750.1,1321,1597,0
5991,-736,-1526,1528.1,15281,16663,6.6,4,4,5,211,21.1,0,0,0,1,1,229,22.9,1,4,5,5,7.0,18189,16017,1601.7,1526,736,1
5992,-3431,-1020,1479.5,14795,16491,6.6,4,4,7,190,19.0,0,0,0,1,1,221,22.1,1,11,8,8,6.8,17511,18226,1822.6,1020,3431,0
5993,-2560,-2062,1506.5,15065,17306,6.8,3,3,3,239,23.9,0,0,0,1,1,242,24.2,2,6,7,7,7.2,19368,17625,1762.5,2062,2560,1
5994,3451,202,1901.1,19011,17878,7.0,9,9,18,201,20.1,2,1,1,0,0,224,22.4,0,4,5,5,7.0,17676,15560,1556.0,-202,-3451,1
5995,1980,1777,1636.6,16366,18102,7.0,6,6,3,237,23.7,0,0,1,0,1,203,20.3,1,4,4,4,6.4,16325,14386,1438.6,-1777,-1980,0
5996,-629,180,1670.9,16709,19029,7.2,7,7,5,227,22.7,0,0,0,1,0,223,22.3,0,9,9,9,7.2,18849,17338,1733.8,-180,629,1
5997,-361,671,1579.8,15798,18818,7.0,5,5,2,231,23.1,1,0,0,1,1,248,24.8,1,3,4,4,7.0,18147,16159,1615.9,-671,361,1
5998,742,2904,1523.9,15239,18919,7.2,5,5,5,218,21.8,1,1,1,0,0,182,18.2,0,4,3,3,6.6,16015,14497,1449.7,-2904,-742,1
5999,886,684,1728.7,17287,18312,7.0,8,8,11,224,22.4,1,1,1,0,0,228,22.8,0,8,6,6,6.8,17628,16401,1640.1,-684,-886,1
6000,-166,-1446,1478.8,14788,16201,6.6,3,3,5,223,22.3,0,0,1,0,0,188,18.8,0,3,5,5,7.0,17647,14954,1495.4,1446,166,1
6001,433,-323,1673.6,16736,18814,7.0,7,7,7,217,21.7,1,1,1,0,0,262,26.2,0,6,5,5,7.2,19137,16303,1630.3,323,-433,1
6002,31,-472,1687.6,16876,17943,7.0,7,7,8,223,22.3,1,1,1,0,0,207,20.7,0,12,9,9,7.2,18415,16845,1684.5,472,-31,0
6003,-3004,-3860,1456.3,14563,15835,6.6,4,4,6,196,19.6,1,1,1,0,0,229,22.9,0,10,8,8,7.2,19695,17567,1756.7,3860,3004,0
6004,1034,-973,1591.2,15912,16609,6.4,3,3,5,236,23.6,0,0,0,1,1,169,16.9,1,2,5,5,6.8,17582,14878,1487.8,973,-1034,0
6005,1060,2796,1662.4,16624,18064,6.8,5,5,9,208,20.8,1,0,0,1,1,190,19.0,1,7,5,5,6.6,15268,15564,1556.4,-2796,-1060,0
6006,3126,3795,1901.8,19018,19294,7.2,10,10,9,209,20.9,1,1,1,0,0,162,16.2,0,11,7,7,6.4,15499,15892,1589.2,-3795,-3126,1
6007,-257,1379,1668.2,16682,19047,7.2,6,6,6,209,20.9,0,0,0,1,1,209,20.9,1,8,7,7,6.8,17668,16939,1693.9,-1379,257,1
6008,1095,768,1724.9,17249,18964,7.0,6,6,8,239,23.9,2,1,1,0,0,247,24.7,0,6,4,4,7.0,18196,16154,1615.4,-768,-1095,0
6009,-84,221,1572.7,15727,18903,7.2,4,4,3,247,24.7,0,0,0,1,0,216,21.6,0,4,6,6,7.2,18682,15811,1581.1,-221,84,1
6010,-1672,-2213,1496.2,14962,18176,7.0,4,4,3,201,20.1,0,0,0,1,0,237,23.7,0,3,6,6,7.4,20389,16634,1663.4,2213,1672,0
6011,1644,987,1739.0,17390,19841,7.4,6,6,7,239,23.9,1,1,1,0,0,250,25.0,1,4,2,2,7.0,18854,15746,1574.6,-987,-1644,0
6012,-1069,-587,1663.2,16632,17520,6.8,7,7,8,191,19.1,1,1,1,0,0,202,20.2,0,11,10,10,6.8,18107,17701,1770.1,587,1069,1
6013,1352,-81,1670.6,16706,17948,7.0,5,5,5,231,23.1,1,1,1,0,0,230,23.0,0,2,3,3,7.0,18029,15354,1535.4,81,-1352,1
6014,816,-457,1496.9,14969,16983,6.8,2,2,3,246,24.6,0,0,1,0,1,213,21.3,2,2,1,1,6.8,17440,14153,1415.3,457,-816,0
6015,-159,-206,1663.0,16630,19373,7.2,4,4,5,251,25.1,2,1,0,1,0,244,24.4,0,6,5,5,7.2,19579,16789,1678.9,206,159,1
6016,-1896,-1756,1703.7,17037,18710,7.0,7,7,11,243,24.3,0,0,1,0,1,243,24.3,1,13,11,11,7.4,20466,18933,1893.3,1756,1896,0
6017,2248,3163,1672.9,16729,19694,7.2,7,7,3,231,23.1,0,0,1,0,0,206,20.6,0,1,2,2,6.4,16531,14481,1448.1,-3163,-2248,0
6018,128,-368,1628.1,16281,17527,6.8,5,5,6,233,23.3,0,0,1,0,1,223,22.3,1,10,5,5,7.2,17895,16153,1615.3,368,-128,1
6019,1389,1615,1637.5,16375,18060,7.2,6,6,11,226,22.6,0,0,1,0,1,198,19.8,2,3,4,4,6.6,16445,14986,1498.6,-1615,-1389,1
6020,1116,2834,1684.9,16849,20518,7.6,7,7,4,234,23.4,1,1,1,0,0,237,23.7,0,6,4,4,6.8,17684,15733,1573.3,-2834,-1116,1
6021,4358,4325,1819.5,18195,19078,7.2,10,10,16,220,22.0,1,0,1,0,0,207,20.7,0,3,2,2,6.0,14753,13837,1383.7,-4325,-4358,1
6022,-306,-953,1582.5,15825,18247,7.0,4,4,2,235,23.5,0,0,0,1,1,227,22.7,1,7,7,7,7.4,19200,16131,1613.1,953,306,1
6023,2915,2523,1848.3,18483,19419,7.4,11,11,8,199,19.9,0,0,1,0,0,209,20.9,0,6,7,7,6.6,16896,15568,1556.8,-2523,-2915,1
6024,1927,495,1827.0,18270,18940,7.0,10,10,14,234,23.4,0,0,0,1,1,224,22.4,2,7,6,6,7.0,18445,16343,1634.3,-495,-1927,0
6025,1491,1101,1737.2,17372,17545,6.8,9,9,11,202,20.2,0,0,1,0,1,206,20.6,2,6,6,6,6.4,16444,15881,1588.1,-1101,-1491,0
6026,4267,2764,1958.2,19582,19381,7.4,11,11,13,228,22.8,0,0,0,1,0,200,20.0,0,2,4,4,6.6,16617,15315,1531.5,-2764,-4267,1
6027,1409,2767,1682.3,16823,19226,7.2,5,5,3,226,22.6,0,0,0,1,0,188,18.8,0,7,4,4,6.6,16459,15414,1541.4,-2767,-1409,1
6028,2188,2716,1826.4,18264,20134,7.4,9,9,9,234,23.4,2,1,0,1,0,227,22.7,0,5,4,4,6.8,17418,16076,1607.6,-2716,-2188,1
6029,-3107,-1687,1514.2,15142,16713,6.8,3,3,2,211,21.1,0,0,0,1,1,222,22.2,1,21,10,10,6.8,18400,18249,1824.9,1687,3107,0
6030,-1640,-907,1639.6,16396,18166,7.2,5,5,4,211,21.1,1,1,1,0,0,250,25.0,0,9,8,8,7.2,19073,18036,1803.6,907,1640,0
6031,-1806,-226,1543.4,15434,18097,7.0,4,4,3,235,23.5,0,0,0,1,1,224,22.4,1,12,7,7,7.2,18323,17240,1724.0,226,1806,1
6032,4518,1715,1856.4,18564,18738,7.0,6,6,7,239,23.9,1,1,1,0,0,169,16.9,0,2,3,3,6.8,17023,14046,1404.6,-1715,-4518,1
6033,1127,1908,1730.4,17304,19455,7.2,8,8,9,233,23.3,0,0,0,1,1,211,21.1,1,5,6,6,6.8,17547,16177,1617.7,-1908,-1127,0
6034,2597,2731,1778.5,17785,19422,7.2,8,8,5,238,23.8,0,0,1,0,1,199,19.9,1,4,5,5,6.6,16691,15188,1518.8,-2731,-2597,0
6035,2406,1503,1729.9,17299,17445,6.8,8,8,11,233,23.3,0,0,1,0,0,194,19.4,0,2,4,4,6.2,15942,14893,1489.3,-1503,-2406,1
6036,-3546,-1919,1552.8,15528,17206,6.6,7,7,4,235,23.5,0,0,0,1,0,238,23.8,0,12,11,11,7.2,19125,19074,1907.4,1919,3546,0
6037,1920,1140,1653.2,16532,16932,6.6,6,6,10,213,21.3,0,0,1,0,1,155,15.5,1,9,5,5,6.4,15792,14612,1461.2,-1140,-1920,0
6038,1079,784,1627.9,16279,18119,7.0,6,6,7,227,22.7,1,1,1,0,0,223,22.3,0,4,4,4,6.6,17335,15200,1520.0,-784,-1079,0
6039,3108,2974,1924.5,19245,20286,7.6,11,11,10,245,24.5,1,1,1,0,0,194,19.4,0,6,5,5,6.8,17312,16137,1613.7,-2974,-3108,1
6040,-1431,269,1499.8,14998,17794,7.0,1,1,1,246,24.6,0,0,0,1,0,230,23.0,0,8,5,5,6.8,17525,16429,1642.9,-269,1431,1
6041,-1595,-907,1539.1,15391,16901,6.6,6,6,5,182,18.2,1,1,0,1,0,201,20.1,0,5,7,7,6.8,17808,16986,1698.6,907,1595,1
6042,1536,624,1845.9,18459,17481,7.0,11,11,10,224,22.4,0,0,1,0,1,197,19.7,1,12,8,8,6.6,16857,16923,1692.3,-624,-1536,0
6043,-1608,-572,1553.5,15535,18068,6.8,4,4,5,214,21.4,0,0,0,1,1,220,22.0,2,9,7,7,7.0,18640,17143,1714.3,572,1608,0
6044,2955,2093,1722.6,17226,19043,7.4,6,6,9,269,26.9,0,0,1,0,0,224,22.4,1,1,1,1,6.8,16950,14271,1427.1,-2093,-2955,1
6045,-720,-1533,1574.3,15743,16662,6.6,5,5,6,212,21.2,1,0,1,0,1,229,22.9,1,11,6,6,7.0,18195,16463,1646.3,1533,720,1
6046,-492,89,1465.9,14659,16878,6.6,2,2,0,233,23.3,0,0,0,1,0,175,17.5,0,3,5,5,6.8,16789,15151,1515.1,-89,492,0
6047,-3579,-3233,1567.4,15674,16123,6.4,7,7,14,176,17.6,1,0,1,0,1,203,20.3,1,18,10,10,7.2,19356,19253,1925.3,3233,3579,0
6048,7721,5190,2069.9,20699,19768,7.4,13,13,14,249,24.9,0,0,1,0,0,200,20.0,0,0,1,1,6.0,14578,12978,1297.8,-5190,-7721,1
6049,3436,1760,1763.1,17631,18612,6.8,10,10,9,201,20.1,1,1,1,0,0,206,20.6,1,1,3,3,6.6,16852,14195,1419.5,-1760,-3436,0
6050,813,1913,1628.2,16282,19492,7.2,5,5,3,225,22.5,1,1,1,0,0,225,22.5,0,4,5,5,7.0,17579,15469,1546.9,-1913,-813,1
6051,-3144,-3235,1424.9,14249,16596,6.6,3,3,3,220,22.0,2,1,0,1,0,255,25.5,0,4,7,7,7.2,19831,17393,1739.3,3235,3144,0
6052,-48,482,1815.9,18159,18557,7.0,12,12,10,207,20.7,1,1,1,0,0,159,15.9,0,16,11,11,7.2,18075,18207,1820.7,-482,48,0
6053,-2468,-2552,1566.6,15666,16073,6.4,6,6,9,208,20.8,1,1,0,1,0,231,23.1,1,6,8,8,7.2,18625,18134,1813.4,2552,2468,0
6054,-4849,-4463,1330.5,13305,15657,6.2,1,1,1,196,19.6,0,0,0,1,1,276,27.6,2,9,8,8,7.4,20120,18154,1815.4,4463,4849,0
6055,1786,-5,1656.3,16563,18392,7.0,6,6,5,215,21.5,1,1,1,0,0,201,20.1,0,2,3,3,7.0,18397,14777,1477.7,5,-1786,1
6056,4128,2704,1833.9,18339,18855,7.2,11,11,4,216,21.6,1,1,1,0,0,158,15.8,0,4,4,4,6.4,16151,14211,1421.1,-2704,-4128,1
6057,-184,-835,1766.6,17666,16963,6.8,11,11,11,193,19.3,0,0,0,1,0,234,23.4,0,12,8,8,7.0,17798,17850,1785.0,835,184,1
6058,-2881,-981,1531.5,15315,17674,7.0,4,4,7,188,18.8,1,1,0,1,0,230,23.0,1,11,9,9,7.0,18655,18196,1819.6,981,2881,0
6059,2863,2632,1862.8,18628,18625,7.0,12,12,13,239,23.9,0,0,0,1,0,207,20.7,0,7,5,5,6.6,15993,15765,1576.5,-2632,-2863,1
6060,2783,1844,1734.2,17342,18792,7.2,7,7,7,248,24.8,1,1,0,1,0,197,19.7,0,3,3,3,6.8,16948,14559,1455.9,-1844,-2783,1
6061,1157,-173,1800.0,18000,17798,6.8,7,7,7,210,21.0,0,0,1,0,0,190,19.0,0,10,8,8,7.0,17971,16843,1684.3,173,-1157,0
6062,-942,120,1531.8,15318,17968,6.8,3,3,2,235,23.5,1,0,0,1,1,263,26.3,1,5,4,4,6.8,17848,16260,1626.0,-120,942,1
6063,1367,1620,1779.5,17795,19812,7.4,9,9,9,237,23.7,1,0,1,0,1,217,21.7,1,4,5,5,7.0,18192,16428,1642.8,-1620,-1367,1
6064,-2929,-154,1635.1,16351,18380,7.0,6,6,5,234,23.4,0,0,1,0,1,233,23.3,1,10,8,8,7.2,18534,19280,1928.0,154,2929,0
6065,-1992,-1722,1484.2,14842,17067,6.8,4,4,2,184,18.4,1,1,1,0,0,209,20.9,1,5,5,5,7.2,18789,16834,1683.4,1722,1992,0
6066,567,1168,1543.9,15439,18214,7.0,2,2,6,250,25.0,0,0,1,0,0,225,22.5,1,6,3,3,6.6,17046,14872,1487.2,-1168,-567,1
6067,446,2153,1699.4,16994,19700,7.6,9,9,5,225,22.5,1,0,1,0,1,234,23.4,1,5,6,6,6.8,17547,16548,1654.8,-2153,-446,1
6068,-1661,-1369,1625.0,16250,17026,6.8,7,7,15,157,15.7,0,0,1,0,0,243,24.3,0,9,7,7,7.2,18395,17911,1791.1,1369,1661,0
6069,-5163,-3425,1478.9,14789,16856,6.6,2,2,2,221,22.1,0,0,0,1,1,237,23.7,1,13,12,12,7.4,20281,19952,1995.2,3425,5163,0
6070,-572,-636,1483.0,14830,16901,6.8,3,3,2,184,18.4,0,0,0,1,1,194,19.4,1,3,4,4,7.0,17537,15402,1540.2,636,572,1
6071,-4219,-3256,1425.2,14252,16567,6.6,1,1,1,229,22.9,0,0,0,1,1,268,26.8,2,9,7,7,7.2,19823,18471,1847.1,3256,4219,0
6072,-2604,-2089,1730.0,17300,18747,7.2,6,6,5,229,22.9,1,1,0,1,0,214,21.4,0,12,13,13,7.6,20836,19904,1990.4,2089,2604,0
6073,-3064,-537,1739.1,17391,18031,6.8,10,10,6,202,20.2,1,1,0,1,0,180,18.0,1,11,12,12,7.2,18568,20455,2045.5,537,3064,0
6074,-2689,-1566,1560.0,15600,16412,6.6,5,5,5,169,16.9,0,0,0,1,1,223,22.3,1,12,10,10,7.0,17978,18289,1828.9,1566,2689,0
6075,857,22,1613.4,16134,16880,6.6,8,8,7,183,18.3,1,1,1,0,0,210,21.0,0,1,4,4,6.6,16858,15277,1527.7,-22,-857,1
6076,3418,3608,1847.0,18470,19952,7.4,11,11,11,231,23.1,0,0,0,1,0,214,21.4,0,3,4,4,6.4,16344,15052,1505.2,-3608,-3418,1
6077,-1317,-872,1529.8,15298,17728,6.8,3,3,1,233,23.3,1,1,1,0,0,204,20.4,0,11,6,6,7.0,18600,16615,1661.5,872,1317,0
6078,1236,478,1584.9,15849,17178,6.8,5,5,7,220,22.0,1,1,1,0,0,202,20.2,0,6,3,3,6.6,16700,14613,1461.3,-478,-1236,1
6079,-1254,-293,1579.3,15793,16329,6.4,5,5,10,215,21.5,1,0,0,1,0,188,18.8,0,11,7,7,6.8,16622,17047,1704.7,293,1254,1
6080,337,124,1439.2,14392,17199,6.6,1,1,1,222,22.2,1,1,1,0,0,197,19.7,0,2,2,2,6.8,17075,14055,1405.5,-124,-337,1
6081,-745,156,1550.8,15508,17029,7.0,6,6,6,193,19.3,0,0,0,1,1,250,25.0,1,3,4,4,6.6,16873,16253,1625.3,-156,745,0
6082,-2524,-376,1546.7,15467,18928,7.0,2,2,2,228,22.8,1,1,0,1,0,252,25.2,0,6,8,8,7.0,19304,17991,1799.1,376,2524,1
6083,2685,1605,1990.4,19904,18106,7.0,14,14,16,179,17.9,1,1,0,1,0,205,20.5,0,7,9,9,6.6,16501,17219,1721.9,-1605,-2685,1
6084,-621,-428,1720.6,17206,16783,6.8,9,9,7,216,21.6,0,0,0,1,0,211,21.1,0,10,10,10,6.8,17211,17827,1782.7,428,621,1
6085,-335,262,1660.0,16600,18623,7.0,7,7,11,195,19.5,0,0,0,1,0,206,20.6,0,6,7,7,7.2,18361,16935,1693.5,-262,335,0
6086,-773,609,1615.4,16154,18329,6.8,5,5,5,235,23.5,1,1,0,1,0,201,20.1,1,8,6,6,6.8,17720,16927,1692.7,-609,773,1
6087,-2060,-2850,1521.8,15218,16410,6.4,5,5,12,198,19.8,1,1,0,1,0,240,24.0,0,6,7,7,7.2,19260,17278,1727.8,2850,2060,0
6088,-2497,-1376,1513.5,15135,17507,6.6,5,5,5,176,17.6,1,0,1,0,1,231,23.1,1,9,7,7,7.2,18883,17632,1763.2,1376,2497,1
6089,-2958,-1627,1498.0,14980,17697,6.8,3,3,1,210,21.0,0,0,0,1,1,268,26.8,1,4,6,6,7.2,19324,17938,1793.8,1627,2958,0
6090,-30,1427,1628.3,16283,19282,7.2,7,7,5,206,20.6,1,1,0,1,0,217,21.7,0,5,4,4,7.0,17855,16313,1631.3,-1427,30,1
6091,207,-1880,1470.6,14706,15747,6.6,3,3,3,203,20.3,0,0,0,1,0,242,24.2,0,1,2,2,6.8,17627,14499,1449.9,1880,-207,1
6092,1442,322,1850.8,18508,18693,7.4,12,12,14,205,20.5,1,1,0,1,0,225,22.5,0,4,5,5,7.0,18371,17066,1706.6,-322,-1442,0
6093,2215,2315,1832.4,18324,18932,7.2,5,5,7,227,22.7,1,0,1,0,0,203,20.3,0,13,6,6,6.6,16617,16109,1610.9,-2315,-2215,0
6094,-4486,-5334,1496.9,14969,16183,6.6,4,4,2,208,20.8,0,0,0,1,0,222,22.2,0,8,13,13,7.6,21517,19455,1945.5,5334,4486,0
6095,-434,673,1511.6,15116,18375,7.0,4,4,1,228,22.8,1,1,0,1,0,246,24.6,0,4,3,3,7.0,17702,15550,1555.0,-673,434,1
6096,-717,8,1575.2,15752,18629,7.0,5,5,2,217,21.7,0,0,0,1,0,218,21.8,0,4,5,5,7.2,18621,16469,1646.9,-8,717,0
6097,4312,1000,1905.6,19056,18501,7.2,10,10,14,233,23.3,1,0,1,0,1,211,21.1,1,1,3,3,6.8,17501,14744,1474.4,-1000,-4312,0
6098,980,1536,1641.2,16412,18935,7.2,5,5,7,223,22.3,1,1,0,1,0,232,23.2,0,5,4,4,6.8,17399,15432,1543.2,-1536,-980,0
6099,2898,1941,1777.3,17773,19376,7.0,8,8,9,235,23.5,1,1,1,0,0,181,18.1,0,4,4,4,7.0,17435,14875,1487.5,-1941,-2898,1
6100,-1799,-1942,1471.0,14710,16797,6.8,3,3,4,227,22.7,0,0,0,1,1,204,20.4,1,8,5,5,7.0,18739,16509,1650.9,1942,1799,0
6101,304,-302,1754.3,17543,18113,7.0,8,8,9,190,19.0,0,0,1,0,1,196,19.6,1,3,9,9,7.0,18415,17239,1723.9,302,-304,0
6102,354,1465,1598.1,15981,18320,7.0,6,6,3,219,21.9,1,1,0,1,0,217,21.7,0,4,4,4,6.6,16855,15627,1562.7,-1465,-354,1
6103,124,659,1757.0,17570,19555,7.2,8,8,3,230,23.0,1,0,1,0,1,215,21.5,1,10,8,8,7.0,18896,17446,1744.6,-659,-124,0
6104,-4531,-2325,1450.5,14505,17362,6.8,3,3,2,216,21.6,1,1,0,1,0,252,25.2,1,8,7,7,7.2,19687,19036,1903.6,2325,4531,0
6105,1000,346,1761.8,17618,19203,7.2,5,5,5,225,22.5,1,0,0,1,1,199,19.9,1,7,7,7,7.0,18857,16618,1661.8,-346,-1000,0
6106,878,2182,1885.8,18858,19797,7.4,11,11,17,214,21.4,1,1,0,1,0,204,20.4,0,11,10,10,6.8,17615,17980,1798.0,-2182,-878,1
6107,-2564,-1518,1540.0,15400,16910,6.6,4,4,8,219,21.9,0,0,0,1,0,229,22.9,0,10,9,9,6.8,18428,17964,1796.4,1518,2564,0
6108,1890,1473,1735.5,17355,17548,6.8,8,8,13,204,20.4,1,1,1,0,0,177,17.7,0,5,5,5,6.4,16075,15465,1546.5,-1473,-1890,1
6109,497,-743,1599.9,15999,18110,7.0,5,5,5,211,21.1,0,0,1,0,0,229,22.9,0,3,3,3,7.2,18853,15502,1550.2,743,-497,0
6110,2537,2412,1826.2,18262,19248,7.2,8,8,9,224,22.4,0,0,1,0,1,208,20.8,1,6,6,6,6.6,16836,15725,1572.5,-2412,-2537,1
6111,-1640,-1839,1551.4,15514,17211,6.8,6,6,4,185,18.5,1,1,1,0,0,234,23.4,1,8,7,7,7.2,19050,17154,1715.4,1839,1640,0
6112,1351,433,1667.8,16678,17929,7.0,9,9,11,201,20.1,0,0,1,0,1,228,22.8,1,6,3,3,6.8,17496,15327,1532.7,-433,-1351,1
6113,850,-98,1666.0,16660,17964,6.8,6,6,8,241,24.1,1,1,1,0,0,215,21.5,0,4,5,5,7.0,18062,15810,1581.0,98,-850,0
6114,2865,2606,1739.2,17392,18794,7.0,8,8,15,215,21.5,1,1,0,1,0,225,22.5,0,3,2,2,6.4,16188,14527,1452.7,-2606,-2865,1
6115,2176,1739,1667.4,16674,18431,7.2,7,7,7,221,22.1,1,1,1,0,0,212,21.2,0,3,3,3,6.6,16692,14498,1449.8,-1739,-2176,1
6116,-1678,-2431,1570.3,15703,17235,7.0,5,5,4,210,21.0,1,1,1,0,0,202,20.2,0,5,9,9,7.4,19666,17381,1738.1,2431,1678,0
6117,2234,1897,1679.7,16797,19788,7.2,5,5,4,268,26.8,1,1,1,0,0,273,27.3,0,0,0,0,6.8,17891,14563,1456.3,-1897,-2234,1
6118,290,477,1760.6,17606,17803,6.8,7,7,8,227,22.7,2,1,1,0,0,232,23.2,0,13,8,8,6.6,17326,17316,1731.6,-477,-290,1
6119,-1607,-215,1599.3,15993,18112,6.8,6,6,7,226,22.6,0,0,0,1,1,217,21.7,1,13,9,9,7.0,18327,17600,1760.0,215,1607,1
6120,753,2050,1662.2,16622,18996,7.4,7,7,7,206,20.6,0,0,0,1,1,213,21.3,1,6,5,5,6.6,16946,15869,1586.9,-2050,-753,1
6121,239,1281,1580.7,15807,17244,6.8,6,6,6,221,22.1,0,0,0,1,1,213,21.3,1,3,4,4,6.6,15963,15568,1556.8,-1281,-239,0
6122,2976,1300,1855.5,18555,19740,7.2,9,9,12,250,25.0,1,1,0,1,0,207,20.7,0,6,6,6,7.0,18440,15579,1557.9,-1300,-2976,1
6123,5616,3916,1882.6,18826,19835,7.2,10,10,8,259,25.9,2,1,1,0,0,184,18.4,0,2,2,2,6.6,15919,13210,1321.0,-3916,-5616,1
6124,-2404,-2013,1478.7,14787,16543,6.6,4,4,3,185,18.5,0,0,0,1,0,228,22.8,0,8,8,8,7.0,18556,17191,1719.1,2013,2404,0
6125,2125,2034,1867.5,18675,20603,7.6,8,8,12,219,21.9,0,0,1,0,1,222,22.2,1,5,6,6,7.0,18569,16550,1655.0,-2034,-2125,1
6126,450,-219,1710.6,17106,18424,7.2,7,7,7,231,23.1,1,1,1,0,0,241,24.1,1,5,5,5,7.0,18643,16656,1665.6,219,-450,1
6127,-172,594,1695.6,16956,19155,7.2,6,6,4,242,24.2,0,0,1,0,1,213,21.3,1,10,7,7,7.2,18561,17128,1712.8,-594,172,1
6128,-4267,-3389,1387.9,13879,15363,6.2,2,2,1,185,18.5,0,0,0,1,1,232,23.2,2,5,9,9,7.0,18752,18146,1814.6,3389,4267,0
6129,-185,-1101,1516.4,15164,17014,7.0,4,4,6,216,21.6,1,0,0,1,1,233,23.3,1,1,3,3,7.2,18115,15349,1534.9,1101,185,1
6130,2094,2789,1684.9,16849,19849,7.4,6,6,4,241,24.1,0,0,1,0,0,208,20.8,0,3,2,2,6.8,17060,14755,1475.5,-2789,-2094,1
6131,302,-1958,1691.4,16914,16785,6.4,6,6,6,184,18.4,1,0,0,1,1,208,20.8,1,6,8,8,7.2,18743,16612,1661.2,1958,-302,1
6132,102,65,1672.8,16728,17494,7.0,7,7,10,231,23.1,1,1,0,1,0,195,19.5,0,8,7,7,6.6,17429,16626,1662.6,-65,-102,0
6133,370,92,1669.4,16694,17192,6.8,8,8,9,227,22.7,0,0,0,1,1,213,21.3,1,6,6,6,6.8,17100,16324,1632.4,-92,-370,1
6134,-1177,-1157,1582.6,15826,17837,6.8,5,5,6,235,23.5,1,1,0,1,0,242,24.2,0,4,6,6,7.4,18994,17003,1700.3,1157,1177,0
6135,-3180,-3271,1555.8,15558,16462,6.4,5,5,6,203,20.3,1,1,0,1,0,218,21.8,0,14,13,13,7.4,19733,18738,1873.8,3271,3180,0
6136,-3045,-810,1405.3,14053,16510,6.6,4,4,4,169,16.9,0,0,0,1,0,229,22.9,0,11,6,6,6.8,17320,17098,1709.8,810,3045,0
6137,2049,699,2088.7,20887,18795,7.0,14,14,14,215,21.5,0,0,0,1,1,191,19.1,2,11,11,11,6.8,18096,18838,1883.8,-699,-2049,0
6138,-1323,-1422,1537.3,15373,16354,6.4,4,4,3,228,22.8,1,1,1,0,0,216,21.6,0,5,6,6,7.0,17776,16696,1669.6,1422,1323,1
6139,2392,511,1752.2,17522,18612,7.2,8,8,6,257,25.7,1,0,1,0,0,222,22.2,0,1,4,4,7.0,18101,15130,1513.0,-511,-2392,1
6140,262,-229,1708.8,17088,17650,7.0,9,9,15,179,17.9,1,1,0,1,0,222,22.2,0,9,7,7,7.0,17879,16826,1682.6,229,-262,1
6141,423,318,1696.8,16968,18303,7.2,6,6,4,231,23.1,0,0,0,1,1,219,21.9,2,8,6,6,7.0,17985,16545,1654.5,-318,-423,0
6142,1810,2115,1798.7,17987,19698,7.4,10,10,10,232,23.2,0,0,0,1,0,222,22.2,1,4,5,5,6.8,17583,16177,1617.7,-2115,-1810,1
6143,-89,-144,1687.1,16871,17798,6.8,6,6,8,263,26.3,1,1,0,1,0,232,23.2,0,13,7,7,7.2,17942,16960,1696.0,144,89,1
6144,4481,3872,1903.5,19035,19600,7.4,11,11,13,207,20.7,1,1,1,0,0,189,18.9,0,4,4,4,6.4,15728,14554,1455.4,-3872,-4481,1
6145,-4446,-3703,1338.0,13380,14784,6.2,2,2,1,188,18.8,0,0,0,1,1,233,23.3,1,10,9,9,7.2,18487,17826,1782.6,3703,4446,0
6146,324,-574,1583.4,15834,18253,7.0,3,3,4,248,24.8,0,0,1,0,1,220,22.0,2,3,3,3,7.2,18827,15510,1551.0,574,-324,1
6147,-1517,-1331,1520.9,15209,16799,6.8,5,5,3,208,20.8,0,0,0,1,0,229,22.9,0,8,7,7,7.0,18130,16726,1672.6,1331,1517,0
6148,2063,708,1642.6,16426,18180,7.0,3,3,6,236,23.6,1,1,1,0,0,210,21.0,0,6,2,2,6.6,17472,14363,1436.3,-708,-2063,1
6149,-3019,-848,1535.8,15358,17610,6.8,4,4,4,210,21.0,0,0,0,1,1,207,20.7,1,12,11,11,7.2,18458,18377,1837.7,848,3019,0
6150,-399,-868,1589.4,15894,16813,6.6,6,6,2,205,20.5,0,0,1,0,1,213,21.3,1,4,7,7,7.0,17681,16293,1629.3,868,399,0
6151,-1999,-2041,1409.2,14092,16918,6.4,2,2,1,201,20.1,1,1,0,1,0,257,25.7,0,3,2,2,7.0,18959,16091,1609.1,2041,1999,1
6152,3158,1518,1755.9,17559,17788,7.0,10,10,18,217,21.7,1,1,1,0,0,184,18.4,0,3,2,2,6.4,16270,14401,1440.1,-1518,-3158,1
6153,647,-710,1584.7,15847,17815,7.0,2,2,3,241,24.1,0,0,0,1,1,221,22.1,1,5,4,4,7.2,18525,15200,1520.0,710,-647,0
6154,-2034,-1071,1528.0,15280,16614,6.6,3,3,4,220,22.0,1,1,0,1,0,220,22.0,0,17,9,9,6.8,17685,17314,1731.4,1071,2034,0
6155,299,-1051,1818.7,18187,18454,7.0,6,6,6,223,22.3,0,0,0,1,0,215,21.5,1,7,9,9,7.2,19505,17888,1788.8,1051,-299,0
6156,-1335,-1142,1550.9,15509,17265,6.8,5,5,4,220,22.0,1,0,1,0,1,230,23.0,1,10,5,5,7.0,18407,16844,1684.4,1142,1335,0
6157,1589,1075,1631.9,16319,18982,7.2,6,6,7,207,20.7,1,1,0,1,0,215,21.5,0,2,3,3,6.6,17907,14730,1473.0,-1075,-1589,1
6158,-2627,-4080,1458.8,14588,15647,6.2,4,4,4,207,20.7,1,1,0,1,0,225,22.5,1,4,9,9,7.4,19727,17215,1721.5,4080,2627,0
6159,-1579,-1715,1674.8,16748,16907,6.8,8,8,8,178,17.8,0,0,0,1,1,215,21.5,1,8,10,10,7.2,18622,18327,1832.7,1715,1579,1
6160,366,596,1651.6,16516,17456,7.0,6,6,8,184,18.4,2,1,0,1,0,221,22.1,0,7,6,6,6.6,16860,16150,1615.0,-596,-366,1
6161,1177,226,1725.6,17256,18265,7.0,7,7,10,228,22.8,2,1,1,0,0,217,21.7,0,6,4,4,6.8,18039,16079,1607.9,-226,-1177,0
6162,-2,866,1639.6,16396,18419,7.0,7,7,6,204,20.4,1,1,0,1,0,202,20.2,0,5,7,7,6.8,17553,16398,1639.8,-866,2,0
6163,-6139,-4548,1453.9,14539,16271,6.6,4,4,3,165,16.5,0,0,0,1,0,224,22.4,0,12,13,13,7.6,20819,20678,2067.8,4548,6139,0
6164,-987,-555,1465.7,14657,17306,6.6,3,3,4,204,20.4,1,1,0,1,0,246,24.6,0,4,4,4,7.0,17861,15644,1564.4,555,987,1
6165,42,666,1865.6,18656,19253,7.2,10,10,5,227,22.7,1,1,0,1,0,211,21.1,0,14,13,13,7.0,18587,18614,1861.4,-666,-42,0
6166,-265,-2101,1660.9,16609,16960,6.8,5,5,6,216,21.6,1,1,1,0,0,225,22.5,0,3,7,7,7.2,19061,16874,1687.4,2101,265,0
6167,-2489,-2828,1529.9,15299,16493,6.6,4,4,7,196,19.6,1,1,0,1,0,233,23.3,0,8,8,8,7.4,19321,17788,1778.8,2828,2489,0
6168,2032,2196,1694.2,16942,18645,7.0,6,6,5,216,21.6,1,1,1,0,0,210,21.0,0,3,3,3,6.4,16449,14910,1491.0,-2196,-2032,1
6169,-136,-385,1536.5,15365,16848,6.4,6,6,3,186,18.6,0,0,0,1,0,219,21.9,0,3,3,3,6.6,17233,15501,1550.1,385,136,0
6170,-1825,-1458,1605.2,16052,15330,6.4,8,8,11,159,15.9,0,0,1,0,1,213,21.3,1,14,10,10,6.6,16788,17877,1787.7,1458,1825,0
6171,-191,533,1687.5,16875,18652,7.2,7,7,4,214,21.4,0,0,0,1,1,230,23.0,1,13,7,7,7.0,18119,17066,1706.6,-533,191,1
6172,1792,-764,1662.3,16623,18555,7.2,6,6,10,211,21.1,1,1,1,0,0,223,22.3,1,2,2,2,7.0,19319,14831,1483.1,764,-1792,1
6173,70,508,1681.3,16813,18065,6.8,8,8,11,200,20.0,2,1,1,0,0,204,20.4,0,9,6,6,6.8,17557,16743,1674.3,-508,-70,1
6174,-1469,-2427,1676.3,16763,17386,7.0,7,7,8,221,22.1,1,1,1,0,0,214,21.4,0,10,12,12,7.4,19813,18232,1823.2,2427,1469,0
6175,-6185,-2328,1460.3,14603,15446,6.4,5,5,2,181,18.1,0,0,0,1,1,195,19.5,1,20,16,16,7.0,17774,20788,2078.8,2328,6185,0
6176,2962,3043,1800.5,18005,19501,7.0,10,10,11,210,21.0,1,1,1,0,0,187,18.7,0,1,4,4,6.6,16458,15043,1504.3,-3043,-2962,1
6177,-2538,-1731,1527.4,15274,17169,6.6,5,5,4,228,22.8,0,0,0,1,1,219,21.9,1,8,9,9,7.2,18900,17812,1781.2,1731,2538,1
6178,99,-174,1521.6,15216,18663,7.2,1,1,1,251,25.1,1,1,0,1,0,217,21.7,0,5,2,2,7.0,18837,15117,1511.7,174,-99,0
6179,2510,758,1775.6,17756,18394,7.2,8,8,10,231,23.1,1,1,1,0,0,218,21.8,0,3,3,3,6.8,17636,15246,1524.6,-758,-2510,1
6180,1408,957,1747.6,17476,18428,7.0,6,6,6,219,21.9,1,1,0,1,0,231,23.1,0,6,6,6,6.8,17471,16068,1606.8,-957,-1408,1
6181,2917,930,1801.7,18017,18434,7.0,9,9,14,208,20.8,0,0,1,0,0,210,21.0,0,1,3,3,6.8,17504,15100,1510.0,-930,-2917,0
6182,-537,176,1553.1,15531,17915,7.0,6,6,2,192,19.2,1,1,1,0,0,198,19.8,0,5,5,5,6.8,17739,16068,1606.8,-176,537,0
6183,-3590,-3279,1479.9,14799,16562,6.8,4,4,5,207,20.7,0,0,1,0,1,259,25.9,1,9,8,8,7.4,19841,18389,1838.9,3279,3590,0
6184,3026,1849,1800.9,18009,19630,7.4,10,10,9,226,22.6,1,1,1,0,0,205,20.5,0,1,4,4,6.8,17781,14983,1498.3,-1849,-3026,1
6185,-1195,-1492,1626.5,16265,17407,7.0,5,5,7,217,21.7,0,0,0,1,1,244,24.4,1,6,8,8,7.2,18899,17460,1746.0,1492,1195,0
6186,-814,-374,1502.3,15023,17293,6.8,4,4,2,226,22.6,0,0,0,1,0,232,23.2,1,4,4,4,6.8,17667,15837,1583.7,374,814,0
6187,67,-820,1708.3,17083,17538,6.6,9,9,12,183,18.3,0,0,1,0,1,225,22.5,1,5,8,8,7.0,18358,17016,1701.6,820,-67,0
6188,-2527,-2193,1595.4,15954,16521,6.8,5,5,5,192,19.2,0,0,0,1,1,197,19.7,1,8,10,10,7.4,18714,18481,1848.1,2193,2527,0
6189,-44,277,1689.2,16892,18225,7.0,6,6,5,226,22.6,0,0,1,0,1,185,18.5,1,10,8,8,7.0,17948,16936,1693.6,-277,44,0
6190,262,1643,1458.3,14583,17525,6.6,1,1,1,244,24.4,1,0,0,1,1,224,22.4,1,3,2,2,6.4,15882,14321,1432.1,-1643,-262,1
6191,-1599,-1890,1680.2,16802,17626,6.8,6,6,10,243,24.3,0,0,0,1,0,237,23.7,0,12,7,7,7.2,19516,18401,1840.1,1890,1599,0
6192,-206,-1872,1695.7,16957,17005,6.6,8,8,8,220,22.0,0,0,1,0,0,204,20.4,0,5,9,9,7.2,18877,17163,1716.3,1872,206,0
6193,-27,-371,1581.7,15817,17992,7.0,5,5,5,218,21.8,2,1,1,0,0,203,20.3,0,7,6,6,7.2,18363,15844,1584.4,371,27,0
6194,-1213,-769,1721.9,17219,18160,6.8,5,5,5,241,24.1,0,0,1,0,0,183,18.3,0,14,11,11,7.2,18929,18432,1843.2,769,1213,0
6195,-1933,-2906,1542.4,15424,17357,6.8,4,4,5,211,21.1,1,1,1,0,0,256,25.6,0,3,7,7,7.6,20263,17357,1735.7,2906,1933,0
6196,342,-444,1650.2,16502,17726,7.0,8,8,9,198,19.8,1,0,1,0,1,195,19.5,1,8,8,8,7.0,18170,16160,1616.0,444,-342,1
6197,-943,-708,1632.4,16324,17213,6.8,5,5,5,193,19.3,0,0,0,1,1,174,17.4,1,13,10,10,7.0,17921,17267,1726.7,708,943,0
6198,-1021,-1439,1453.2,14532,17477,6.6,2,2,0,217,21.7,0,0,0,1,0,206,20.6,0,2,4,4,7.2,18916,15553,1555.3,1439,1021,0
6199,-1367,-412,1464.4,14644,17550,6.8,4,4,2,222,22.2,1,0,0,1,0,201,20.1,0,6,5,5,7.0,17962,16011,1601.1,412,1367,0
6200,-47,318,1661.6,16616,18633,7.0,5,5,3,211,21.1,1,0,0,1,1,219,21.9,1,10,7,7,7.0,18315,16663,1666.3,-318,47,0
6201,-1769,-845,1475.4,14754,16591,6.6,1,1,1,230,23.0,0,0,0,1,0,224,22.4,0,4,4,4,7.0,17436,16523,1652.3,845,1769,0
6202,-2954,-1250,1424.2,14242,17184,6.6,2,2,2,212,21.2,0,0,0,1,0,244,24.4,1,3,7,7,7.0,18434,17196,1719.6,1250,2954,0
6203,2877,1714,1708.3,17083,18346,7.0,8,8,15,229,22.9,0,0,0,1,1,212,21.2,1,1,2,2,6.6,16632,14206,1420.6,-1714,-2877,1
6204,5656,3415,1971.6,19716,20456,7.6,10,10,13,219,21.9,1,1,1,0,0,222,22.2,0,1,3,3,6.6,17041,14060,1406.0,-3415,-5656,1
6205,3668,4509,1840.1,18401,20273,7.6,10,10,13,236,23.6,1,1,0,1,0,195,19.5,1,3,4,4,6.6,15764,14733,1473.3,-4509,-3668,1
6206,1,-116,1735.9,17359,18754,7.2,7,7,6,221,22.1,2,1,1,0,0,221,22.1,0,6,9,9,7.0,18870,17358,1735.8,116,-1,0
6207,2294,2616,1774.2,17742,18795,7.0,7,7,4,203,20.3,1,1,0,1,0,186,18.6,0,6,6,6,6.6,16179,15448,1544.8,-2616,-2294,1
6208,-940,-43,1443.1,14431,17984,7.0,2,2,1,194,19.4,1,1,0,1,0,234,23.4,0,3,4,4,6.8,18027,15371,1537.1,43,940,1
6209,2828,2738,1812.5,18125,21102,7.8,9,9,9,236,23.6,0,0,0,1,1,227,22.7,1,2,3,3,7.2,18364,15297,1529.7,-2738,-2828,1
6210,1091,605,1721.0,17210,18131,7.0,6,6,6,220,22.0,0,0,1,0,0,178,17.8,0,10,8,8,7.0,17526,16119,1611.9,-605,-1091,1
6211,-1237,-285,1569.7,15697,16449,6.8,6,6,8,196,19.6,0,0,1,0,0,201,20.1,0,13,8,8,6.4,16734,16934,1693.4,285,1237,0
6212,-2658,-3328,1459.1,14591,15636,6.2,3,3,5,177,17.7,2,1,0,1,0,209,20.9,0,9,8,8,7.0,18964,17249,1724.9,3328,2658,1
6213,-3152,-2754,1448.8,14488,16390,6.4,4,4,5,197,19.7,0,0,0,1,1,196,19.6,1,7,7,7,7.2,19144,17640,1764.0,2754,3152,0
6214,4242,2348,1886.9,18869,18526,7.0,9,9,12,206,20.6,0,0,1,0,0,164,16.4,0,6,6,6,6.6,16178,14627,1462.7,-2348,-4242,1
6215,598,374,1668.2,16682,18272,7.0,6,6,4,236,23.6,0,0,1,0,1,235,23.5,1,5,5,5,6.8,17898,16084,1608.4,-374,-598,0
6216,-2787,-4217,1589.8,15898,14230,5.8,7,7,6,131,13.1,0,0,0,1,1,224,22.4,2,10,13,13,6.8,18447,18685,1868.5,4217,2787,0
6217,-2650,-388,1548.5,15485,17335,6.6,6,6,2,191,19.1,0,0,0,1,1,201,20.1,1,10,10,10,6.8,17723,18135,1813.5,388,2650,0
6218,-692,-987,1666.7,16667,18874,7.4,7,7,4,213,21.3,0,0,1,0,1,245,24.5,1,6,8,8,7.4,19861,17359,1735.9,987,692,0
6219,-667,-1046,1618.2,16182,17509,7.0,5,5,6,245,24.5,0,0,1,0,1,234,23.4,2,9,6,6,7.0,18555,16849,1684.9,1046,667,0
6220,803,857,1657.4,16574,19529,7.2,5,5,5,235,23.5,1,0,1,0,1,204,20.4,1,6,5,5,7.2,18672,15771,1577.1,-857,-803,0
6221,-3619,-4011,1459.5,14595,15064,6.4,3,3,3,161,16.1,0,0,0,1,1,222,22.2,1,9,11,11,7.2,19075,18214,1821.4,4011,3619,0
6222,3002,2378,1885.6,18856,19293,7.2,9,9,13,236,23.6,0,0,0,1,1,217,21.7,2,6,4,4,6.8,16915,15854,1585.4,-2378,-3002,0
6223,-3607,-2956,1482.6,14826,16636,6.6,3,3,5,185,18.5,0,0,1,0,1,257,25.7,1,12,10,10,7.4,19592,18433,1843.3,2956,3607,0
6224,-958,-461,1623.7,16237,18980,7.0,6,6,6,222,22.2,0,0,0,1,1,232,23.2,2,6,6,6,7.2,19441,17195,1719.5,461,958,0
6225,2892,1413,1873.1,18731,18165,7.0,8,8,6,225,22.5,2,1,0,1,0,207,20.7,0,5,5,5,6.4,16752,15839,1583.9,-1413,-2892,1
6226,-997,-226,1544.3,15443,18156,7.0,5,5,2,220,22.0,2,1,1,0,0,207,20.7,0,7,5,5,7.0,18382,16440,1644.0,226,997,1
6227,472,426,1682.0,16820,17746,6.8,6,6,8,221,22.1,1,1,0,1,0,185,18.5,0,7,6,6,6.8,17320,16348,1634.8,-426,-472,1
6228,-465,-801,1499.7,14997,17630,7.2,1,1,1,229,22.9,1,1,0,1,0,219,21.9,0,3,3,3,7.0,18431,15462,1546.2,801,465,0
6229,23,306,1665.3,16653,17618,7.0,7,7,3,227,22.7,1,0,0,1,0,193,19.3,0,8,8,8,7.0,17312,16630,1663.0,-306,-23,1
6230,3422,2271,1778.1,17781,19251,7.2,9,9,9,228,22.8,1,0,0,1,1,212,21.2,1,3,2,2,6.6,16980,14359,1435.9,-2271,-3422,0
6231,3350,1590,1793.6,17936,18452,7.0,9,9,18,218,21.8,1,1,1,0,0,213,21.3,0,2,2,2,6.8,16862,14586,1458.6,-1590,-3350,1
6232,1316,1233,1676.9,16769,19760,7.2,3,3,3,257,25.7,1,1,1,0,0,241,24.1,0,4,3,3,7.2,18527,15453,1545.3,-1233,-1316,1
6233,91,798,1671.4,16714,19411,7.4,7,7,6,226,22.6,0,0,1,0,0,252,25.2,0,5,6,6,7.2,18613,16623,1662.3,-798,-91,0
6234,-5338,-5445,1351.7,13517,15501,6.4,1,1,1,187,18.7,0,0,0,1,0,243,24.3,1,13,12,12,7.6,20946,18855,1885.5,5445,5338,0
6235,-343,481,1551.4,15514,18750,7.0,5,5,1,217,21.7,0,0,0,1,1,204,20.4,1,5,5,5,6.8,18269,15857,1585.7,-481,343,1
6236,874,818,1613.1,16131,17436,6.8,5,5,5,223,22.3,1,1,0,1,0,219,21.9,0,5,5,5,6.6,16618,15257,1525.7,-818,-874,0
6237,-468,-1321,1561.3,15613,17932,7.0,3,3,4,214,21.4,1,1,1,0,0,230,23.0,0,3,4,4,7.2,19253,16081,1608.1,1321,468,0
6238,1401,1740,1667.8,16678,19110,7.2,6,6,7,248,24.8,1,0,1,0,1,233,23.3,1,6,5,5,6.8,17370,15277,1527.7,-1740,-1401,1
6239,2781,1229,1731.1,17311,18763,7.0,6,6,7,257,25.7,0,0,1,0,0,216,21.6,0,2,2,2,6.8,17534,14530,1453.0,-1229,-2781,1
6240,1051,612,1670.3,16703,17483,6.8,5,5,6,201,20.1,2,1,1,0,0,228,22.8,0,9,3,3,6.8,16871,15652,1565.2,-612,-1051,1
6241,-10329,-8531,1240.3,12403,11921,5.2,2,2,0,152,15.2,0,0,0,1,1,232,23.2,1,16,19,19,7.6,20452,22732,2273.2,8531,10329,0
6242,-2864,-3491,1558.5,15585,16636,6.6,5,5,5,200,20.0,1,1,1,0,0,224,22.4,0,8,9,9,7.2,20127,18449,1844.9,3491,2864,1
6243,241,-363,1655.8,16558,18174,6.8,8,8,6,238,23.8,1,1,0,1,0,222,22.2,0,6,4,4,7.0,18537,16317,1631.7,363,-241,1
6244,1479,-198,1821.1,18211,19027,7.2,8,8,7,204,20.4,1,0,1,0,1,217,21.7,1,6,6,6,7.4,19225,16732,1673.2,198,-1479,0
6245,-1425,-1068,1599.0,15990,17803,6.8,7,7,6,190,19.0,1,1,1,0,0,241,24.1,0,6,7,7,7.2,18871,17415,1741.5,1068,1425,0
6246,-4559,-1851,1514.7,15147,16605,6.4,4,4,8,188,18.8,0,0,0,1,1,241,24.1,1,22,12,12,7.2,18456,19706,1970.6,1851,4559,1
6247,1280,370,1700.8,17008,16893,6.6,8,8,12,203,20.3,2,1,0,1,0,245,24.5,0,5,5,5,6.4,16523,15728,1572.8,-370,-1280,0
6248,-707,-1088,1553.8,15538,16787,6.8,5,5,4,207,20.7,0,0,1,0,0,208,20.8,0,11,7,7,6.8,17875,16245,1624.5,1088,707,0
6249,620,-328,1709.7,17097,18614,7.2,7,7,10,220,22.0,1,1,1,0,0,207,20.7,0,4,6,6,7.2,18942,16477,1647.7,328,-620,1
6250,1224,625,1707.5,17075,18491,7.0,6,6,7,234,23.4,0,0,0,1,1,221,22.1,2,4,7,7,6.8,17866,15851,1585.1,-625,-1224,1
6251,-2691,-2196,1603.5,16035,18455,7.0,7,7,6,180,18.0,0,0,0,1,1,243,24.3,1,9,9,9,7.6,20651,18726,1872.6,2196,2691,0
6252,3039,712,1796.7,17967,18074,7.0,8,8,10,240,24.0,1,1,1,0,0,211,21.1,0,3,3,3,6.8,17362,14928,1492.8,-712,-3039,1
6253,381,1571,1727.3,17273,18297,7.0,8,8,9,208,20.8,0,0,1,0,0,181,18.1,0,9,9,9,6.8,16726,16892,1689.2,-1571,-381,1
6254,305,-443,1454.6,14546,17721,7.0,1,1,2,232,23.2,2,1,1,0,0,203,20.3,0,1,1,1,7.2,18164,14241,1424.1,443,-305,1
6255,-1767,-2080,1463.9,14639,17316,6.6,2,2,4,237,23.7,1,1,0,1,0,258,25.8,0,3,2,2,7.0,19396,16406,1640.6,2080,1767,1
6256,-1261,1286,1688.2,16882,18988,7.4,9,9,3,191,19.1,0,0,0,1,0,238,23.8,0,9,8,8,6.8,17702,18143,1814.3,-1286,1261,0
6257,5619,3506,2017.0,20170,19190,7.2,9,9,11,257,25.7,0,0,1,0,1,198,19.8,1,5,4,4,6.4,15684,14551,1455.1,-3506,-5619,1
6258,6445,4988,2002.9,20029,20123,7.4,13,13,16,213,21.3,1,1,1,0,0,176,17.6,0,4,4,4,6.0,15135,13584,1358.4,-4988,-6445,1
6259,1463,1277,1726.0,17260,19375,7.0,9,9,8,197,19.7,0,0,1,0,0,203,20.3,0,4,4,4,7.0,18098,15797,1579.7,-1277,-1463,1
6260,2639,1711,1819.2,18192,19823,7.2,11,11,4,221,22.1,0,0,1,0,0,230,23.0,0,2,3,3,7.0,18112,15553,1555.3,-1711,-2639,1
6261,3454,2249,1732.5,17325,18380,7.0,8,8,13,217,21.7,0,0,1,0,1,193,19.3,1,3,3,3,6.8,16131,13871,1387.1,-2249,-3454,1
6262,-1828,-1410,1616.3,16163,18244,6.8,5,5,3,218,21.8,0,0,0,1,0,235,23.5,1,17,9,9,7.2,19654,17991,1799.1,1410,1828,0
6263,-2168,-2823,1603.9,16039,16809,6.8,7,7,6,179,17.9,0,0,1,0,1,185,18.5,1,9,13,13,7.4,19632,18207,1820.7,2823,2168,0
6264,-112,727,1590.7,15907,17910,7.2,6,6,3,206,20.6,1,0,1,0,0,211,21.1,0,9,7,7,6.8,17183,16019,1601.9,-727,112,1
6265,4003,3255,1753.6,17536,19146,7.4,7,7,10,211,21.1,1,0,1,0,0,204,20.4,0,1,2,2,6.4,15891,13533,1353.3,-3255,-4003,0
6266,175,-532,1873.0,18730,18011,7.0,11,11,16,208,20.8,0,0,1,0,1,219,21.9,1,14,11,11,7.0,18543,18555,1855.5,532,-175,0
6267,2275,1667,1610.5,16105,18285,7.2,6,6,5,223,22.3,1,1,1,0,0,204,20.4,0,2,2,2,6.8,16618,13830,1383.0,-1667,-2275,1
6268,1301,1123,1584.3,15843,17751,6.8,4,4,1,243,24.3,1,1,1,0,0,205,20.5,0,6,3,3,6.6,16628,14542,1454.2,-1123,-1301,1
6269,7577,2363,2030.2,20302,18149,7.0,10,10,14,212,21.2,1,1,1,0,0,165,16.5,0,0,0,0,6.6,15786,12725,1272.5,-2363,-7577,1
6270,6161,5326,2023.6,20236,18603,7.0,10,10,9,257,25.7,1,0,0,1,1,146,14.6,1,6,4,4,5.8,13277,14075,1407.5,-5326,-6161,1
6271,664,515,1786.9,17869,17341,6.8,10,10,12,193,19.3,2,1,1,0,0,202,20.2,0,9,9,9,6.6,16826,17205,1720.5,-515,-664,1
6272,-3079,-1816,1449.9,14499,18406,7.0,3,3,1,201,20.1,1,0,0,1,1,245,24.5,1,4,6,6,7.2,20222,17578,1757.8,1816,3079,0
6273,-4651,-3870,1370.5,13705,16018,6.4,3,3,3,184,18.4,0,0,0,1,1,223,22.3,1,8,9,9,7.2,19888,18356,1835.6,3870,4651,0
6274,-4011,-2271,1368.5,13685,16729,6.6,2,2,1,182,18.2,0,0,0,1,1,243,24.3,2,6,7,7,7.2,19000,17696,1769.6,2271,4011,0
6275,-2698,-2969,1536.6,15366,16496,6.8,5,5,6,200,20.0,0,0,1,0,1,221,22.1,2,8,10,10,7.2,19465,18064,1806.4,2969,2698,1
6276,-1769,-2076,1417.5,14175,17400,6.6,0,0,0,234,23.4,1,0,0,1,1,249,24.9,1,6,4,4,7.4,19476,15944,1594.4,2076,1769,0
6277,-166,-337,1597.5,15975,16937,6.6,6,6,11,197,19.7,1,1,0,1,0,231,23.1,0,4,5,5,6.8,17274,16141,1614.1,337,166,0
6278,-3521,-4416,1309.9,13099,14520,5.8,1,1,2,191,19.1,0,0,1,0,1,247,24.7,1,8,7,7,7.2,18936,16620,1662.0,4416,3521,0
6279,611,1554,1557.8,15578,19730,7.4,3,3,0,249,24.9,1,1,1,0,0,245,24.5,0,0,0,0,6.8,18176,14967,1496.7,-1554,-611,1
6280,-4511,-4211,1421.8,14218,15368,6.2,2,2,1,200,20.0,0,0,1,0,1,213,21.3,1,18,13,13,7.4,19579,18729,1872.9,4211,4511,0
6281,-1157,-84,1519.8,15198,18952,7.0,2,2,2,231,23.1,0,0,1,0,1,211,21.1,1,9,7,7,7.4,19036,16355,1635.5,84,1157,1
6282,3295,2840,1747.4,17474,19214,7.4,7,7,8,238,23.8,0,0,1,0,0,229,22.9,0,3,2,2,6.6,16374,14179,1417.9,-2840,-3295,1
6283,3090,1008,1778.6,17786,19357,7.4,9,9,13,235,23.5,1,0,1,0,1,215,21.5,1,2,3,3,7.2,18349,14696,1469.6,-1008,-3090,1
6284,2388,1600,1708.2,17082,19192,7.2,7,7,6,224,22.4,0,0,1,0,1,224,22.4,1,2,3,3,7.0,17592,14694,1469.4,-1600,-2388,1
6285,-204,1135,1571.1,15711,19278,7.4,4,4,6,210,21.0,0,0,1,0,1,229,22.9,1,4,4,4,7.0,18143,15915,1591.5,-1135,204,0
6286,451,1068,1611.2,16112,18545,7.2,4,4,6,240,24.0,1,1,0,1,0,236,23.6,0,2,4,4,7.0,17477,15661,1566.1,-1068,-451,1
6287,-2943,-1203,1570.0,15700,17892,7.2,4,4,4,190,19.0,0,0,0,1,1,225,22.5,2,6,8,8,7.2,19095,18643,1864.3,1203,2943,0
6288,1419,557,1788.5,17885,18417,7.0,8,8,9,209,20.9,0,0,1,0,1,187,18.7,1,7,8,8,7.0,17860,16466,1646.6,-557,-1419,1
6289,856,-268,1570.5,15705,17630,6.6,2,2,2,230,23.0,0,0,1,0,1,219,21.9,1,6,3,3,7.0,17898,14849,1484.9,268,-856,1
6290,-5088,-3911,1336.4,13364,16851,6.6,0,0,0,203,20.3,0,0,0,1,1,259,25.9,2,8,8,8,7.6,20762,18452,1845.2,3911,5088,0
6291,-2247,-1938,1708.0,17080,18330,7.2,8,8,9,196,19.6,1,0,0,1,0,227,22.7,0,6,11,11,7.4,20268,19327,1932.7,1938,2247,0
6292,3298,1038,1739.5,17395,17215,6.8,11,11,15,170,17.0,0,0,1,0,0,210,21.0,0,1,2,2,6.6,16177,14097,1409.7,-1038,-3298,1
6293,744,927,1749.8,17498,19132,7.2,8,8,6,240,24.0,1,0,0,1,0,199,19.9,0,7,7,7,7.2,18205,16754,1675.4,-927,-744,1
6294,2194,2684,1764.9,17649,19655,7.4,6,6,4,276,27.6,0,0,0,1,1,221,22.1,1,3,4,4,6.8,16971,15455,1545.5,-2684,-2194,1
6295,4865,4641,1871.7,18717,20051,7.4,10,10,5,247,24.7,1,1,1,0,0,191,19.1,0,4,2,2,6.6,15410,13852,1385.2,-4641,-4865,1
6296,131,1381,1573.6,15736,18719,7.2,4,4,5,231,23.1,1,1,1,0,0,246,24.6,0,4,4,4,7.0,17338,15605,1560.5,-1381,-131,1
6297,-4921,-2826,1380.0,13800,15275,6.4,3,3,1,165,16.5,0,0,0,1,1,208,20.8,1,16,12,12,7.0,18101,18721,1872.1,2826,4921,0
6298,-1502,-429,1577.2,15772,17144,6.8,7,7,6,204,20.4,0,0,0,1,1,225,22.5,2,11,8,8,6.8,17573,17274,1727.4,429,1502,0
6299,389,1652,1682.5,16825,19699,7.4,7,7,5,229,22.9,1,1,1,0,0,194,19.4,1,8,7,7,7.0,18047,16436,1643.6,-1652,-389,1
6300,1792,217,1731.5,17315,18122,6.8,7,7,8,229,22.9,1,0,1,0,1,226,22.6,1,8,5,5,6.8,17905,15523,1552.3,-217,-1792,0
6301,-1122,-643,1414.4,14144,17041,6.8,2,2,1,208,20.8,0,0,0,1,1,230,23.0,1,1,4,4,6.8,17684,15266,1526.6,643,1122,0
6302,1192,836,1632.8,16328,17531,6.8,5,5,4,223,22.3,1,1,1,0,0,219,21.9,0,4,4,4,6.4,16695,15136,1513.6,-836,-1192,1
6303,-1161,-1685,1513.5,15135,17610,7.0,3,3,3,213,21.3,0,0,1,0,0,251,25.1,0,8,5,5,7.4,19295,16296,1629.6,1685,1161,1
6304,618,-308,1771.9,17719,18085,7.0,9,9,10,215,21.5,0,0,0,1,1,213,21.3,1,7,6,6,7.2,18393,17101,1710.1,308,-618,0
6305,-870,-1348,1629.1,16291,16508,6.4,8,8,12,180,18.0,0,0,1,0,1,207,20.7,1,11,8,8,7.0,17856,17161,1716.1,1348,870,0
6306,-2099,-2717,1504.8,15048,16313,6.6,5,5,3,209,20.9,1,0,1,0,1,239,23.9,1,6,6,6,7.4,19030,17147,1714.7,2717,2099,0
6307,-1735,-1786,1415.5,14155,16974,6.6,2,2,1,226,22.6,0,0,0,1,1,258,25.8,1,3,4,4,7.0,18760,15890,1589.0,1786,1735,0
6308,-5691,-2006,1510.2,15102,18032,6.8,5,5,4,174,17.4,0,0,0,1,1,226,22.6,2,8,9,9,7.4,20038,20793,2079.3,2006,5691,0
6309,-3819,-2264,1552.2,15522,16999,6.8,6,6,7,182,18.2,0,0,0,1,1,220,22.0,1,16,13,13,7.2,19263,19341,1934.1,2264,3819,0
6310,1926,3729,1785.0,17850,18858,7.4,11,11,12,204,20.4,1,0,0,1,1,167,16.7,1,8,6,6,6.4,15129,15924,1592.4,-3729,-1926,1
6311,-1884,-2885,1672.0,16720,16905,6.8,8,8,8,181,18.1,1,1,1,0,0,248,24.8,0,4,8,8,7.4,19790,18604,1860.4,2885,1884,0
6312,703,477,1732.1,17321,19677,7.6,8,8,5,238,23.8,0,0,0,1,1,212,21.2,1,6,7,7,7.2,19200,16618,1661.8,-477,-703,1
6313,-521,860,1667.2,16672,18698,7.0,7,7,7,210,21.0,0,0,1,0,1,250,25.0,1,11,6,6,7.0,17838,17193,1719.3,-860,521,1
6314,711,1245,1542.6,15426,19072,7.4,2,2,3,230,23.0,1,1,1,0,0,255,25.5,0,1,1,1,6.8,17827,14715,1471.5,-1245,-711,1
6315,736,1019,1640.4,16404,19029,7.0,6,6,4,246,24.6,1,1,1,0,0,203,20.3,0,4,3,3,6.8,18010,15668,1566.8,-1019,-736,1
6316,2685,1151,1829.3,18293,19481,7.2,11,11,14,218,21.8,1,1,0,1,0,228,22.8,0,4,3,3,7.0,18330,15608,1560.8,-1151,-2685,1
6317,31,-189,1660.5,16605,17961,7.0,5,5,4,207,20.7,1,1,1,0,0,207,20.7,0,7,7,7,7.0,18150,16574,1657.4,189,-31,0
6318,1060,7,1854.4,18544,17072,6.4,10,10,8,182,18.2,0,0,1,0,1,174,17.4,1,11,10,10,6.8,17065,17484,1748.4,-7,-1060,0
6319,3473,2812,1849.9,18499,17823,7.0,12,12,14,210,21.0,1,1,1,0,0,204,20.4,0,6,5,5,6.2,15011,15026,1502.6,-2812,-3473,1
6320,1913,842,1691.1,16911,17876,6.8,6,6,10,224,22.4,0,0,1,0,1,222,22.2,1,3,3,3,6.8,17034,14998,1499.8,-842,-1913,1
6321,707,730,1696.3,16963,17857,7.0,7,7,12,212,21.2,0,0,1,0,0,200,20.0,0,7,6,6,6.6,17127,16256,1625.6,-730,-707,1
6322,2227,2792,1766.9,17669,20105,7.4,9,9,3,218,21.8,2,1,1,0,0,203,20.3,0,4,5,5,6.8,17313,15442,1544.2,-2792,-2227,1
6323,-2901,-1904,1587.5,15875,18029,7.0,6,6,8,191,19.1,1,1,0,1,0,230,23.0,0,8,10,10,7.2,19933,18776,1877.6,1904,2901,0
6324,1161,2387,1627.3,16273,19371,7.2,5,5,4,241,24.1,0,0,0,1,1,224,22.4,1,3,4,4,6.6,16984,15112,1511.2,-2387,-1161,0
6325,-1845,-606,1584.8,15848,17347,6.6,4,4,7,238,23.8,1,0,0,1,1,224,22.4,1,14,8,8,6.8,17953,17693,1769.3,606,1845,0
6326,-502,-413,1529.7,15297,17644,6.6,4,4,4,201,20.1,1,1,0,1,0,209,20.9,0,7,5,5,7.0,18057,15799,1579.9,413,502,0
6327,-1530,-988,1640.6,16406,17714,7.0,6,6,5,208,20.8,1,0,0,1,1,224,22.4,1,10,10,10,7.0,18702,17936,1793.6,988,1530,0
6328,-2118,-2158,1750.9,17509,18038,7.2,8,8,7,234,23.4,0,0,1,0,1,209,20.9,1,9,11,11,7.4,20196,19627,1962.7,2158,2118,0
6329,-893,771,1539.8,15398,17802,6.8,4,4,5,200,20.0,1,1,0,1,0,212,21.2,0,4,4,4,6.8,17031,16291,1629.1,-771,893,1
6330,253,-121,1743.1,17431,18061,6.8,9,9,10,178,17.8,2,1,1,0,0,224,22.4,0,6,8,8,7.0,18182,17178,1717.8,121,-253,0
6331,5344,3793,1896.8,18968,20401,7.6,9,9,7,239,23.9,1,1,1,0,0,225,22.5,0,0,0,0,6.4,16608,13624,1362.4,-3793,-5344,1
6332,-326,315,1631.8,16318,17365,6.6,4,4,5,218,21.8,1,0,0,1,1,209,20.9,1,9,5,5,6.8,17050,16644,1664.4,-315,326,0
6333,2663,1537,1889.6,18896,19340,7.4,13,13,11,198,19.8,0,0,1,0,1,201,20.1,1,5,6,6,6.8,17803,16233,1623.3,-1537,-2663,1
6334,-1399,-1727,1596.4,15964,17011,6.8,5,5,4,204,20.4,1,1,1,0,0,217,21.7,0,7,8,8,7.2,18738,17363,1736.3,1727,1399,1
6335,-903,-729,1592.4,15924,16695,6.8,6,6,7,184,18.4,2,1,0,1,0,215,21.5,0,8,7,7,7.0,17424,16827,1682.7,729,903,0
6336,-2134,-339,1519.0,15190,18507,7.0,4,4,2,215,21.5,1,1,0,1,0,227,22.7,1,8,7,7,7.0,18846,17324,1732.4,339,2134,0
6337,3781,3184,1748.2,17482,19196,7.2,6,6,8,216,21.6,1,1,1,0,0,223,22.3,0,0,0,0,6.4,16012,13701,1370.1,-3184,-3781,1
6338,-611,-1958,1449.2,14492,16869,7.0,2,2,1,211,21.1,1,1,1,0,0,230,23.0,0,3,4,4,7.2,18827,15103,1510.3,1958,611,1
6339,2603,1105,1705.5,17055,17638,7.0,8,8,8,225,22.5,0,0,1,0,1,238,23.8,1,0,2,2,6.8,16533,14452,1445.2,-1105,-2603,1
6340,-1348,-10,1455.9,14559,17491,6.8,4,4,3,191,19.1,0,0,1,0,0,202,20.2,1,6,4,4,6.6,17501,15907,1590.7,10,1348,1
6341,-2468,-1853,1583.8,15838,18031,7.0,6,6,4,204,20.4,0,0,0,1,1,219,21.9,1,9,11,11,7.4,19884,18306,1830.6,1853,2468,0
6342,-518,-268,1604.7,16047,18460,6.8,6,6,6,250,25.0,0,0,0,1,1,211,21.1,2,3,8,8,7.2,18728,16565,1656.5,268,518,1
6343,752,1146,1651.3,16513,18896,7.2,6,6,6,241,24.1,0,0,1,0,1,216,21.6,1,6,4,4,7.0,17750,15761,1576.1,-1146,-752,0
6344,-1775,-2698,1544.5,15445,17280,6.6,4,4,2,222,22.2,0,0,0,1,0,228,22.8,1,6,9,9,7.4,19978,17220,1722.0,2698,1775,0
6345,4232,3448,1812.4,18124,19613,7.4,9,9,11,213,21.3,0,0,1,0,0,205,20.5,0,0,2,2,6.6,16165,13892,1389.2,-3448,-4232,1
6346,-4962,-2384,1426.8,14268,15723,6.4,3,3,4,213,21.3,0,0,0,1,0,216,21.6,0,14,11,11,7.0,18107,19230,1923.0,2384,4962,0
6347,379,406,1600.0,16000,17778,6.8,6,6,5,206,20.6,1,0,0,1,1,214,21.4,1,5,5,5,6.8,17372,15621,1562.1,-406,-379,1
6348,-2006,-101,1504.0,15040,17558,6.8,6,6,3,184,18.4,0,0,0,1,0,236,23.6,0,5,6,6,6.8,17659,17046,1704.6,101,2006,0
6349,-1342,-713,1541.6,15416,17061,6.8,6,6,8,199,19.9,1,1,0,1,0,248,24.8,0,7,5,5,6.8,17774,16758,1675.8,713,1342,1
6350,1037,111,1784.4,17844,18825,7.2,7,7,9,232,23.2,1,1,1,0,0,243,24.3,0,5,6,6,7.2,18714,16807,1680.7,-111,-1037,0
6351,1844,1397,1645.5,16455,17798,7.2,5,5,9,229,22.9,2,1,1,0,0,213,21.3,0,6,4,4,6.6,16401,14611,1461.1,-1397,-1844,0
6352,3524,2086,1736.8,17368,18140,7.2,6,6,8,252,25.2,1,1,1,0,0,195,19.5,0,2,2,2,6.4,16054,13844,1384.4,-2086,-3524,1
6353,2169,2322,1650.3,16503,19371,7.0,7,7,5,218,21.8,0,0,0,1,1,220,22.0,1,4,2,2,6.6,17049,14334,1433.4,-2322,-2169,0
6354,-1547,-1049,1506.3,15063,16316,6.6,5,5,4,198,19.8,1,1,1,0,0,229,22.9,0,3,6,6,6.8,17365,16610,1661.0,1049,1547,1
6355,1995,2344,1773.3,17733,19290,7.2,6,6,12,221,22.1,1,1,1,0,0,225,22.5,0,6,4,4,6.8,16946,15738,1573.8,-2344,-1995,1
6356,1146,1440,1572.0,15720,18012,7.0,4,4,5,224,22.4,0,0,1,0,1,211,21.1,1,3,3,3,6.8,16572,14574,1457.4,-1440,-1146,1
6357,1418,716,1645.7,16457,17837,7.0,5,5,9,228,22.8,2,1,0,1,0,238,23.8,0,2,3,3,6.4,17121,15039,1503.9,-716,-1418,1
6358,307,-269,1752.6,17526,18287,7.2,8,8,8,220,22.0,1,1,1,0,0,225,22.5,0,7,7,7,7.2,18556,17219,1721.9,269,-307,1
6359,803,2597,1720.4,17204,19878,7.2,8,8,8,215,21.5,1,1,0,1,0,216,21.6,0,7,5,5,6.8,17281,16401,1640.1,-2597,-803,1
6360,2420,2428,1697.3,16973,19798,7.2,4,4,5,271,27.1,2,1,1,0,0,247,24.7,0,2,1,1,6.6,17370,14553,1455.3,-2428,-2420,1
6361,-2976,-2255,1271.3,12713,14245,6.0,1,1,1,192,19.2,0,0,1,0,1,237,23.7,2,8,5,5,6.6,16500,15689,1568.9,2255,2976,0
6362,-451,-1201,1648.8,16488,17583,6.8,8,8,8,217,21.7,0,0,0,1,0,196,19.6,0,4,8,8,7.0,18784,16939,1693.9,1201,451,0
6363,161,1546,1580.1,15801,17655,7.0,6,6,6,208,20.8,0,0,0,1,0,197,19.7,0,3,5,5,6.6,16109,15640,1564.0,-1546,-161,0
6364,-3688,-4038,1475.0,14750,15820,6.6,5,5,4,185,18.5,0,0,0,1,1,189,18.9,2,12,10,10,7.2,19858,18438,1843.8,4038,3688,0
6365,-653,-1717,1770.9,17709,17077,6.6,9,9,7,213,21.3,0,0,0,1,0,193,19.3,0,15,12,12,7.0,18794,18362,1836.2,1717,653,1
6366,-2327,-2250,1582.7,15827,17027,6.8,6,6,7,181,18.1,0,0,0,1,1,251,25.1,2,5,9,9,7.4,19277,18154,1815.4,2250,2327,0
6367,1875,-622,1748.2,17482,17024,6.8,10,10,23,206,20.6,0,0,1,0,1,179,17.9,1,6,6,6,6.8,17646,15607,1560.7,622,-1875,0
6368,312,33,1545.0,15450,17766,7.0,4,4,5,202,20.2,0,0,0,1,1,243,24.3,2,8,3,3,7.2,17733,15138,1513.8,-33,-312,0
6369,989,-477,1572.8,15728,17209,6.8,7,7,5,208,20.8,1,1,1,0,0,208,20.8,0,2,3,3,6.6,17686,14739,1473.9,477,-989,0
6370,414,-1224,1558.8,15588,16904,6.6,5,5,7,202,20.2,1,0,1,0,1,207,20.7,1,2,3,3,7.0,18128,15174,1517.4,1224,-414,1
6371,416,1133,1867.6,18676,18145,7.0,10,10,16,217,21.7,1,1,0,1,0,211,21.1,0,14,12,12,6.6,17012,18260,1826.0,-1133,-416,1
6372,-869,-814,1582.9,15829,17626,6.8,4,4,6,185,18.5,0,0,0,1,1,231,23.1,1,2,6,6,6.8,18440,16698,1669.8,814,869,0
6373,-1031,122,1534.0,15340,18245,7.2,4,4,2,228,22.8,1,1,0,1,0,228,22.8,0,7,6,6,7.0,18123,16371,1637.1,-122,1031,1
6374,-389,226,1714.0,17140,18192,7.2,7,7,7,207,20.7,1,0,1,0,1,208,20.8,1,9,8,8,7.0,17966,17529,1752.9,-226,389,0
6375,-3513,-1630,1460.6,14606,17633,6.8,2,2,2,200,20.0,0,0,0,1,1,221,22.1,1,6,9,9,7.4,19263,18119,1811.9,1630,3513,0
6376,2605,2260,1752.8,17528,20077,7.2,6,6,4,257,25.7,1,0,0,1,1,254,25.4,1,3,2,2,6.8,17817,14923,1492.3,-2260,-2605,1
6377,408,165,1603.5,16035,17246,6.6,5,5,7,193,19.3,0,0,1,0,1,224,22.4,1,6,4,4,6.8,17081,15627,1562.7,-165,-408,0
6378,-4140,-2177,1455.9,14559,17148,6.8,3,3,5,193,19.3,1,1,0,1,0,236,23.6,0,8,9,9,7.4,19325,18699,1869.9,2177,4140,0
6379,5020,3785,1972.6,19726,19180,7.4,12,12,16,246,24.6,1,1,0,1,0,192,19.2,0,6,4,4,6.4,15395,14706,1470.6,-3785,-5020,1
6380,616,1673,1650.8,16508,18959,7.2,5,5,5,230,23.0,0,0,0,1,0,238,23.8,0,6,4,4,6.8,17286,15892,1589.2,-1673,-616,1
6381,-2744,-1330,1400.1,14001,16037,6.4,1,1,1,221,22.1,0,0,0,1,1,244,24.4,1,11,5,5,7.0,17367,16745,1674.5,1330,2744,0
6382,-249,-1163,1565.0,15650,17837,7.0,4,4,8,224,22.4,1,1,0,1,0,254,25.4,1,3,3,3,7.2,19000,15899,1589.9,1163,249,1
6383,-29,-997,1666.3,16663,18493,7.0,6,6,4,227,22.7,0,0,1,0,1,225,22.5,1,4,5,5,7.4,19490,16692,1669.2,997,29,0
6384,1475,-95,1705.2,17052,17766,6.8,7,7,5,241,24.1,0,0,1,0,1,206,20.6,1,5,4,4,6.6,17861,15577,1557.7,95,-1475,1
6385,-2055,-2649,1624.2,16242,16365,6.4,7,7,12,209,20.9,0,0,1,0,0,202,20.2,0,12,9,9,7.2,19014,18297,1829.7,2649,2055,0
6386,-1806,-1419,1500.9,15009,16571,6.4,4,4,2,211,21.1,0,0,0,1,1,220,22.0,2,7,6,6,7.0,17990,16815,1681.5,1419,1806,0
6387,-2237,-885,1546.2,15462,17446,6.6,4,4,8,209,20.9,0,0,0,1,1,256,25.6,1,12,7,7,6.8,18331,17699,1769.9,885,2237,0
6388,1992,3174,1697.2,16972,19381,7.2,7,7,6,222,22.2,0,0,0,1,1,221,22.1,1,6,4,4,6.4,16207,14980,1498.0,-3174,-1992,1
6389,1973,1236,1700.5,17005,19366,7.2,4,4,2,268,26.8,0,0,0,1,1,241,24.1,1,0,2,2,6.8,18130,15032,1503.2,-1236,-1973,1
6390,463,-8,1584.5,15845,17682,6.8,4,4,4,225,22.5,0,0,1,0,0,214,21.4,0,5,5,5,7.0,17690,15382,1538.2,8,-463,1
6391,-4004,-3300,1404.8,14048,16395,6.4,2,2,1,209,20.9,0,0,0,1,1,237,23.7,2,9,9,9,7.2,19695,18052,1805.2,3300,4004,0
6392,-3077,-3160,1538.8,15388,15544,6.4,6,6,10,153,15.3,1,1,1,0,0,214,21.4,1,5,8,8,7.0,18704,18465,1846.5,3160,3077,1
6393,-2542,-388,1462.2,14622,17798,6.6,4,4,3,176,17.6,1,1,0,1,0,238,23.8,0,10,7,7,7.0,18186,17164,1716.4,388,2542,0
6394,-700,906,1518.4,15184,17545,6.8,4,4,4,199,19.9,1,1,0,1,0,215,21.5,1,5,5,5,6.6,16639,15884,1588.4,-906,700,1
6395,-740,396,1760.7,17607,18633,7.0,10,10,8,195,19.5,0,0,0,1,1,214,21.4,1,11,12,12,7.0,18237,18347,1834.7,-396,740,0
6396,-3222,-1976,1525.8,15258,17586,6.8,6,6,7,179,17.9,0,0,0,1,1,240,24.0,1,11,10,10,7.2,19562,18480,1848.0,1976,3222,0
6397,6876,6535,1966.9,19669,17978,7.0,13,13,24,207,20.7,1,1,1,0,0,149,14.9,0,8,4,4,5.2,11443,12793,1279.3,-6535,-6876,1
6398,2871,1581,1786.5,17865,19417,7.4,7,7,8,251,25.1,2,1,1,0,0,215,21.5,0,4,4,4,7.2,17836,14994,1499.4,-1581,-2871,1
6399,2422,1048,1920.6,19206,17896,7.0,9,9,8,219,21.9,1,0,0,1,1,181,18.1,1,15,9,9,6.6,16848,16784,1678.4,-1048,-2422,0
6400,3299,1803,1806.8,18068,19266,7.2,7,7,8,252,25.2,1,1,1,0,0,201,20.1,1,3,3,3,6.8,17463,14769,1476.9,-1803,-3299,1
6401,751,615,1739.7,17397,18389,7.0,6,6,12,235,23.5,1,1,1,0,0,210,21.0,0,11,7,7,6.8,17774,16646,1664.6,-615,-751,1
6402,-866,259,1593.3,15933,18813,7.2,6,6,3,221,22.1,0,0,0,1,1,249,24.9,1,3,6,6,7.2,18554,16799,1679.9,-259,866,0
6403,-164,94,1555.2,15552,17498,6.8,5,5,4,239,23.9,1,1,1,0,0,203,20.3,1,6,5,5,7.0,17404,15716,1571.6,-94,164,0
6404,93,1943,1667.5,16675,18462,7.2,4,4,3,240,24.0,1,1,0,1,0,209,20.9,0,7,5,5,6.6,16519,16582,1658.2,-1943,-93,0
6405,-991,-844,1658.5,16585,18342,7.0,6,6,6,231,23.1,0,0,1,0,0,223,22.3,0,7,9,9,7.4,19186,17576,1757.6,844,991,0
6406,2524,1040,1866.5,18665,17762,7.0,12,12,15,213,21.3,1,1,1,0,0,202,20.2,1,7,6,6,6.6,16722,16141,1614.1,-1040,-2524,1
6407,2875,1386,1755.5,17555,17779,6.8,9,9,10,223,22.3,1,1,1,0,0,196,19.6,0,4,4,4,6.4,16393,14680,1468.0,-1386,-2875,1
6408,-1590,-1375,1594.2,15942,17493,6.8,5,5,5,215,21.5,0,0,0,1,1,221,22.1,1,13,9,9,7.0,18868,17532,1753.2,1375,1590,0
6409,-2100,-925,1618.5,16185,17924,6.8,6,6,9,204,20.4,0,0,1,0,1,199,19.9,2,12,8,8,7.0,18849,18285,1828.5,925,2100,0
6410,-1642,-4442,1744.4,17444,16497,6.4,7,7,11,213,21.3,0,0,1,0,1,223,22.3,1,16,11,11,7.6,20939,19086,1908.6,4442,1642,0
6411,-499,260,1547.1,15471,18216,6.8,4,4,7,220,22.0,1,1,0,1,0,252,25.2,0,4,4,4,7.0,17956,15970,1597.0,-260,499,0
6412,-1591,-1829,1504.3,15043,17227,6.8,3,3,3,225,22.5,1,1,1,0,0,236,23.6,1,4,5,5,7.4,19056,16634,1663.4,1829,1591,0
6413,-158,-688,1642.4,16424,18793,7.2,7,7,5,217,21.7,1,1,0,1,0,243,24.3,0,2,5,5,7.2,19481,16582,1658.2,688,158,1
6414,1195,538,1606.1,16061,17186,6.8,6,6,6,158,15.8,0,0,0,1,1,210,21.0,1,1,3,3,6.6,16648,14866,1486.6,-538,-1195,1
6415,-4644,-3580,1491.0,14910,16295,6.4,5,5,3,198,19.8,0,0,0,1,0,247,24.7,0,13,13,13,7.4,19875,19554,1955.4,3580,4644,0
6416,-4099,-4129,1512.7,15127,16197,6.4,5,5,8,193,19.3,0,0,0,1,0,225,22.5,0,11,11,11,7.4,20326,19226,1922.6,4129,4099,0
6417,-4944,-3928,1268.2,12682,15784,6.6,0,0,0,173,17.3,0,0,0,1,1,233,23.3,1,4,8,8,7.4,19712,17626,1762.6,3928,4944,0
6418,96,2988,1629.8,16298,19831,7.4,5,5,3,231,23.1,1,1,0,1,0,201,20.1,0,8,6,6,6.6,16843,16202,1620.2,-2988,-96,1
6419,4107,1820,1881.8,18818,19037,7.4,10,10,10,215,21.5,2,1,1,0,0,209,20.9,0,2,4,4,6.8,17217,14711,1471.1,-1820,-4107,1
6420,1823,1574,1722.1,17221,18574,7.4,7,7,7,199,19.9,1,1,1,0,0,208,20.8,0,3,4,4,6.6,17000,15398,1539.8,-1574,-1823,1
6421,2332,637,1789.7,17897,18898,7.0,7,7,9,237,23.7,2,1,1,0,0,190,19.0,0,4,4,4,7.0,18261,15565,1556.5,-637,-2332,1
6422,-2710,-2319,1465.7,14657,15612,6.2,4,4,11,194,19.4,0,0,0,1,1,227,22.7,1,9,7,7,7.0,17931,17367,1736.7,2319,2710,1
6423,260,-108,1723.2,17232,17997,6.8,8,8,5,231,23.1,0,0,1,0,0,205,20.5,0,7,8,8,7.0,18105,16972,1697.2,108,-260,0
6424,909,2001,1583.0,15830,19605,7.2,2,2,3,255,25.5,0,0,0,1,0,219,21.9,0,3,2,2,7.0,17604,14921,1492.1,-2001,-909,1
6425,-1984,-2084,1499.2,14992,16189,6.4,3,3,2,214,21.4,0,0,0,1,1,246,24.6,1,8,5,5,6.8,18273,16976,1697.6,2084,1984,0
6426,1259,-60,1900.0,19000,18915,7.2,10,10,11,233,23.3,0,0,1,0,0,264,26.4,0,7,6,6,7.0,18975,17741,1774.1,60,-1259,1
6427,-1522,-1611,1572.3,15723,17429,6.8,5,5,5,203,20.3,0,0,1,0,1,241,24.1,1,4,7,7,7.0,19040,17245,1724.5,1611,1522,0
6428,-2190,-3375,1542.8,15428,16985,6.8,4,4,6,213,21.3,0,0,1,0,1,218,21.8,2,7,8,8,7.6,20360,17618,1761.8,3375,2190,0
6429,-1208,-1061,1459.2,14592,16682,6.6,4,4,5,204,20.4,1,1,0,1,0,205,20.5,0,3,4,4,6.8,17743,15800,1580.0,1061,1208,0
6430,-2952,-2963,1561.3,15613,17057,6.8,4,4,5,202,20.2,0,0,1,0,1,221,22.1,1,8,11,11,7.4,20020,18565,1856.5,2963,2952,0
6431,749,570,1684.4,16844,18255,6.8,7,7,11,217,21.7,1,1,1,0,0,233,23.3,0,8,5,5,7.0,17685,16095,1609.5,-570,-749,0
6432,3324,1398,1770.9,17709,19221,7.2,7,7,11,242,24.2,1,1,1,0,0,227,22.7,1,0,1,1,6.6,17823,14385,1438.5,-1398,-3324,1
6433,147,1258,1502.8,15028,18170,6.8,3,3,3,212,21.2,1,0,0,1,1,231,23.1,1,5,2,2,6.8,16912,14881,1488.1,-1258,-147,0
6434,580,-54,1639.9,16399,17056,6.8,6,6,5,219,21.9,0,0,1,0,0,189,18.9,0,7,7,7,6.6,17110,15819,1581.9,54,-580,1
6435,1330,854,1907.9,19079,18774,7.0,12,12,10,206,20.6,1,1,1,0,0,212,21.2,0,7,8,8,7.0,17920,17749,1774.9,-854,-1330,0
6436,-2167,-1158,1580.9,15809,18227,7.0,6,6,7,202,20.2,0,0,0,1,0,243,24.3,0,6,9,9,7.2,19385,17976,1797.6,1158,2167,1
6437,1470,498,1675.5,16755,18596,7.2,5,5,4,261,26.1,1,1,1,0,0,217,21.7,0,3,5,5,7.0,18098,15285,1528.5,-498,-1470,0
6438,-635,202,1504.3,15043,17669,6.8,3,3,3,203,20.3,0,0,0,1,1,242,24.2,1,3,4,4,6.8,17467,15678,1567.8,-202,635,0
6439,-1467,-1504,1683.2,16832,17641,6.8,6,6,7,222,22.2,1,1,0,1,0,210,21.0,0,12,10,10,7.4,19145,18299,1829.9,1504,1467,1
6440,3391,2897,1758.0,17580,19527,7.2,9,9,8,210,21.0,1,1,1,0,0,195,19.5,0,1,2,2,6.6,16630,14189,1418.9,-2897,-3391,1
6441,-2980,-2882,1545.3,15453,16291,6.6,5,5,5,193,19.3,0,0,1,0,0,233,23.3,0,15,11,11,7.2,19173,18433,1843.3,2882,2980,1
6442,-397,-163,1586.9,15869,18217,7.0,3,3,3,261,26.1,0,0,1,0,1,227,22.7,1,5,5,5,7.0,18380,16266,1626.6,163,397,0
6443,1528,1785,1591.7,15917,18903,7.2,5,5,9,220,22.0,0,0,0,1,1,199,19.9,1,4,2,2,6.8,17118,14389,1438.9,-1785,-1528,1
6444,4871,2019,1961.2,19612,20290,7.6,11,11,9,259,25.9,1,1,1,0,0,210,21.0,0,1,4,4,7.0,18271,14741,1474.1,-2019,-4871,1
6445,-7527,-4309,1251.9,12519,13642,6.0,1,1,0,152,15.2,0,0,0,1,0,220,22.0,0,14,14,14,7.2,17951,20046,2004.6,4309,7527,0
6446,131,735,1622.7,16227,19425,7.2,5,5,7,221,22.1,1,1,0,1,0,206,20.6,0,8,6,6,7.0,18690,16096,1609.6,-735,-131,0
6447,-2889,-3905,1529.1,15291,15389,6.2,6,6,7,190,19.0,0,0,1,0,1,228,22.8,1,10,9,9,7.2,19294,18180,1818.0,3905,2889,0
6448,-2402,-1269,1444.2,14442,16949,6.8,3,3,2,209,20.9,0,0,0,1,1,240,24.0,2,7,5,5,7.0,18218,16844,1684.4,1269,2402,0
6449,1686,886,1896.8,18968,18902,7.0,12,12,12,201,20.1,0,0,0,1,0,186,18.6,0,8,8,8,7.0,18016,17282,1728.2,-886,-1686,1
6450,1408,1663,1618.7,16187,18182,6.8,5,5,4,239,23.9,2,1,1,0,0,204,20.4,0,3,3,3,6.6,16519,14779,1477.9,-1663,-1408,1
6451,-1293,-713,1806.2,18062,17871,7.0,10,10,10,190,19.0,1,1,1,0,0,247,24.7,0,10,10,10,7.2,18584,19355,1935.5,713,1293,1
6452,-1424,-2416,1482.4,14824,18421,7.2,1,1,0,230,23.0,0,0,0,1,1,228,22.8,1,3,5,5,7.6,20837,16248,1624.8,2416,1424,0
6453,-2336,-1282,1519.5,15195,18046,7.0,3,3,2,217,21.7,0,0,1,0,1,247,24.7,1,8,7,7,7.4,19328,17531,1753.1,1282,2336,0
6454,265,-267,1645.7,16457,18265,7.0,7,7,6,202,20.2,0,0,1,0,1,234,23.4,1,4,6,6,7.0,18532,16192,1619.2,267,-265,0
6455,3006,1814,1831.7,18317,19181,7.0,5,5,6,238,23.8,1,0,1,0,1,208,20.8,1,5,5,5,6.8,17367,15311,1531.1,-1814,-3006,1
6456,1110,1898,1631.9,16319,19461,7.4,7,7,6,218,21.8,1,1,1,0,0,198,19.8,0,4,5,5,6.8,17563,15209,1520.9,-1898,-1110,1
6457,2711,1931,1927.5,19275,18899,7.2,11,11,18,233,23.3,0,0,1,0,1,183,18.3,1,15,8,8,6.8,16968,16564,1656.4,-1931,-2711,1
6458,2086,360,1660.5,16605,17533,6.8,6,6,6,219,21.9,1,1,1,0,0,210,21.0,1,1,2,2,6.6,17173,14519,1451.9,-360,-2086,1
6459,3477,3386,1789.8,17898,19735,7.0,6,6,5,238,23.8,2,1,1,0,0,224,22.4,0,3,3,3,6.6,16349,14421,1442.1,-3386,-3477,1
6460,-1815,-671,1474.5,14745,17586,6.8,3,3,2,213,21.3,0,0,1,0,1,211,21.1,1,5,5,5,7.0,18257,16560,1656.0,671,1815,0
6461,1086,1804,1641.7,16417,18414,6.8,2,2,2,249,24.9,1,0,0,1,1,219,21.9,1,8,4,4,6.6,16610,15331,1533.1,-1804,-1086,1
6462,-145,120,1516.9,15169,17363,7.0,4,4,2,217,21.7,0,0,1,0,0,205,20.5,0,3,7,7,6.8,17243,15314,1531.4,-120,145,1
6463,-1519,-1363,1519.7,15197,17925,7.0,2,2,2,233,23.3,2,1,0,1,0,245,24.5,0,4,4,4,7.2,19288,16716,1671.6,1363,1519,0
6464,4538,3618,1820.8,18208,19824,7.2,8,8,8,248,24.8,1,1,1,0,0,176,17.6,0,1,4,4,6.4,16206,13670,1367.0,-3618,-4538,1
6465,4864,5310,1787.9,17879,19767,7.4,7,7,4,241,24.1,1,1,1,0,0,185,18.5,0,1,3,3,6.0,14457,13015,1301.5,-5310,-4864,1
6466,4121,3050,1794.7,17947,19669,7.2,9,9,6,239,23.9,0,0,1,0,0,177,17.7,0,1,2,2,6.8,16619,13826,1382.6,-3050,-4121,1
6467,-1101,-306,1539.3,15393,18185,7.0,3,3,3,243,24.3,1,1,0,1,0,267,26.7,0,7,5,5,7.0,18491,16494,1649.4,306,1101,1
6468,-448,-163,1572.9,15729,18102,7.0,4,4,2,205,20.5,0,0,1,0,1,232,23.2,1,6,6,6,7.0,18265,16177,1617.7,163,448,1
6469,3373,2383,1856.0,18560,19924,7.2,10,10,13,244,24.4,1,0,1,0,0,210,21.0,0,3,5,5,6.8,17541,15187,1518.7,-2383,-3373,1
6470,86,-315,1571.8,15718,17585,6.8,3,3,3,256,25.6,1,1,1,0,0,220,22.0,0,6,4,4,6.8,17900,15632,1563.2,315,-86,1
6471,-3792,-3472,1402.1,14021,15684,6.2,2,2,0,200,20.0,0,0,1,0,1,236,23.6,1,8,8,8,7.2,19156,17813,1781.3,3472,3792,0
6472,3823,2563,1948.5,19485,19900,7.4,13,13,10,196,19.6,0,0,1,0,0,201,20.1,0,5,5,5,6.6,17337,15662,1566.2,-2563,-3823,1
6473,-1350,-1765,1602.9,16029,17293,6.8,6,6,6,198,19.8,1,1,0,1,0,206,20.6,0,6,8,8,7.2,19058,17379,1737.9,1765,1350,0
6474,-1864,-2124,1437.2,14372,16842,6.8,4,4,2,205,20.5,1,0,0,1,0,216,21.6,0,3,6,6,7.2,18966,16236,1623.6,2124,1864,0
6475,1864,-797,1834.8,18348,17087,6.6,10,10,13,195,19.5,0,0,0,1,1,211,21.1,1,7,6,6,7.0,17884,16484,1648.4,797,-1864,1
6476,441,130,1646.4,16464,17678,6.8,7,7,11,206,20.6,1,1,0,1,0,229,22.9,0,5,4,4,6.8,17548,16023,1602.3,-130,-441,0
6477,-2218,-1083,1637.7,16377,18575,6.8,4,4,5,213,21.3,0,0,0,1,1,222,22.2,2,7,9,9,7.2,19658,18595,1859.5,1083,2218,0
6478,-120,-394,1742.1,17421,17407,6.6,9,9,9,203,20.3,1,1,0,1,0,225,22.5,0,11,10,10,6.8,17801,17541,1754.1,394,120,1
6479,-188,899,1528.4,15284,17975,6.8,4,4,4,221,22.1,0,0,0,1,0,226,22.6,0,6,5,5,6.8,17076,15472,1547.2,-899,188,1
6480,-1966,263,1490.0,14900,18354,7.0,3,3,3,214,21.4,1,1,1,0,0,214,21.4,0,7,7,7,7.2,18091,16866,1686.6,-263,1966,0
6481,-323,-992,1634.5,16345,16530,6.6,7,7,5,204,20.4,0,0,1,0,1,190,19.0,1,8,6,6,7.0,17522,16668,1666.8,992,323,1
6482,-708,387,1798.2,17982,18687,7.0,6,6,6,244,24.4,0,0,0,1,1,203,20.3,1,9,11,11,7.2,18300,18690,1869.0,-387,708,0
6483,-147,184,1625.9,16259,18818,7.2,6,6,5,232,23.2,0,0,0,1,1,237,23.7,1,6,6,6,7.0,18634,16406,1640.6,-184,147,0
6484,1041,1187,1847.2,18472,19144,7.2,10,10,8,228,22.8,0,0,1,0,1,175,17.5,1,8,11,11,6.8,17957,17431,1743.1,-1187,-1041,1
6485,873,678,1609.9,16099,18219,7.0,7,7,6,203,20.3,1,1,1,0,0,208,20.8,0,2,5,5,6.8,17541,15226,1522.6,-678,-873,1
6486,247,-1191,1594.7,15947,17352,6.8,4,4,8,231,23.1,0,0,1,0,1,219,21.9,1,5,4,4,6.8,18543,15700,1570.0,1191,-247,1
6487,1209,1099,1659.0,16590,19180,7.0,6,6,3,228,22.8,0,0,1,0,1,202,20.2,1,10,5,5,7.0,18081,15381,1538.1,-1099,-1209,1
6488,-495,-724,1498.6,14986,16975,6.4,3,3,3,229,22.9,1,0,1,0,1,246,24.6,1,4,4,4,7.0,17699,15481,1548.1,724,495,0
6489,2899,1508,1923.4,19234,18339,7.0,16,16,21,193,19.3,1,1,1,0,0,211,21.1,0,7,5,5,6.8,16831,16335,1633.5,-1508,-2899,0
6490,1129,218,1665.7,16657,18356,7.2,3,3,4,228,22.8,2,1,1,0,0,238,23.8,0,4,4,4,7.2,18138,15528,1552.8,-218,-1129,1
6491,5514,3051,2151.2,21512,19190,7.2,16,16,22,218,21.8,2,1,1,0,0,196,19.6,0,9,7,7,6.4,16139,15998,1599.8,-3051,-5514,1
6492,-1317,-1427,1590.5,15905,17754,7.0,6,6,5,200,20.0,1,0,1,0,1,203,20.3,1,10,7,7,7.2,19181,17222,1722.2,1427,1317,0
6493,-571,-932,1579.3,15793,17795,6.8,7,7,4,191,19.1,0,0,0,1,0,227,22.7,1,3,7,7,7.2,18727,16364,1636.4,932,571,0
6494,1485,-264,1788.3,17883,17407,6.8,10,10,12,198,19.8,0,0,1,0,1,194,19.4,1,10,8,8,6.8,17671,16398,1639.8,264,-1485,0
6495,1185,1042,1574.4,15744,18381,7.0,4,4,6,219,21.9,0,0,1,0,0,231,23.1,0,3,2,2,6.8,17339,14559,1455.9,-1042,-1185,0
6496,-2108,-1510,1476.5,14765,16480,6.8,5,5,3,189,18.9,1,1,0,1,0,212,21.2,0,8,7,7,7.4,17990,16873,1687.3,1510,2108,0
6497,3229,3548,1744.6,17446,20350,7.4,5,5,5,255,25.5,2,1,1,0,0,221,22.1,0,2,2,2,6.6,16802,14217,1421.7,-3548,-3229,1
6498,1267,920,1619.0,16190,17477,7.0,6,6,10,233,23.3,1,1,1,0,0,190,19.0,0,4,4,4,6.4,16557,14923,1492.3,-920,-1267,1
6499,-1513,-2959,1496.7,14967,16756,6.8,2,2,2,221,22.1,1,1,1,0,0,224,22.4,0,7,6,6,7.2,19715,16480,1648.0,2959,1513,1
6500,2967,947,1810.8,18108,18738,7.0,9,9,12,218,21.8,2,1,0,1,0,228,22.8,0,1,3,3,6.8,17791,15141,1514.1,-947,-2967,1
6501,-1023,-2028,1639.7,16397,17090,6.6,7,7,10,222,22.2,1,1,0,1,0,243,24.3,0,6,7,7,7.2,19118,17420,1742.0,2028,1023,0
6502,1385,969,1660.6,16606,18225,7.0,6,6,8,237,23.7,1,0,1,0,0,217,21.7,0,2,4,4,7.0,17256,15221,1522.1,-969,-1385,1
6503,-3540,-3645,1435.1,14351,16380,6.8,3,3,5,172,17.2,0,0,0,1,1,224,22.4,2,4,9,9,7.6,20025,17891,1789.1,3645,3540,1
6504,-2219,-1498,1486.4,14864,16742,6.6,2,2,2,249,24.9,1,0,0,1,1,229,22.9,1,15,7,7,7.0,18240,17083,1708.3,1498,2219,0
6505,1295,1330,1821.4,18214,19620,7.2,10,10,8,227,22.7,1,1,1,0,0,205,20.5,0,9,8,8,7.0,18290,16919,1691.9,-1330,-1295,1
6506,1601,1229,1705.9,17059,18162,7.2,8,8,12,200,20.0,0,0,1,0,1,206,20.6,2,3,3,3,6.8,16933,15458,1545.8,-1229,-1601,0
6507,-874,-1635,1435.3,14353,16624,6.4,2,2,2,215,21.5,1,1,0,1,0,216,21.6,0,5,4,4,7.0,18259,15227,1522.7,1635,874,0
6508,-551,-551,1658.0,16580,17438,7.0,4,4,6,205,20.5,1,0,0,1,1,218,21.8,1,10,6,6,6.8,17989,17131,1713.1,551,551,0
6509,395,-504,1742.6,17426,17243,7.0,9,9,11,234,23.4,0,0,0,1,0,188,18.8,0,9,8,8,6.8,17747,17031,1703.1,504,-395,1
6510,-52,430,1630.8,16308,18718,7.0,6,6,3,227,22.7,2,1,1,0,0,208,20.8,0,5,7,7,7.2,18288,16360,1636.0,-430,52,0
6511,4609,1189,1972.3,19723,19678,7.2,9,9,11,249,24.9,1,0,1,0,1,226,22.6,1,2,3,3,7.2,18489,15114,1511.4,-1189,-4609,1
6512,-1565,-467,1594.6,15946,17404,7.0,6,6,6,222,22.2,0,0,1,0,0,187,18.7,0,15,9,9,6.8,17871,17511,1751.1,467,1565,0
6513,3143,2852,1942.5,19425,20998,7.4,11,11,9,218,21.8,0,0,0,1,1,216,21.6,1,5,7,7,7.0,18146,16282,1628.2,-2852,-3143,1
6514,1490,1854,1813.5,18135,19550,7.0,14,14,5,198,19.8,2,1,0,1,0,180,18.0,0,7,7,7,7.0,17696,16645,1664.5,-1854,-1490,1
6515,-1130,275,1677.4,16774,17746,7.0,9,9,6,176,17.6,0,0,0,1,0,206,20.6,0,12,10,10,6.8,17471,17904,1790.4,-275,1130,0
6516,370,212,1663.7,16637,17981,7.2,6,6,5,215,21.5,1,1,0,1,0,207,20.7,0,5,5,5,7.0,17769,16267,1626.7,-212,-370,1
6517,-2128,-1873,1675.0,16750,17492,6.6,7,7,14,214,21.4,0,0,0,1,1,236,23.6,2,3,7,7,7.2,19365,18878,1887.8,1873,2128,0
6518,-3700,-2221,1349.3,13493,16560,6.6,1,1,0,218,21.8,1,1,0,1,0,229,22.9,0,8,8,8,7.0,18781,17193,1719.3,2221,3700,1
6519,-4649,-1914,1579.4,15794,17285,6.8,6,6,5,192,19.2,0,0,0,1,1,213,21.3,1,11,12,12,7.4,19199,20443,2044.3,1914,4649,0
6520,144,-227,1657.4,16574,17052,6.6,9,9,12,203,20.3,1,1,1,0,0,229,22.9,0,4,6,6,6.8,17279,16430,1643.0,227,-144,1
6521,3404,2667,2018.2,20182,20589,7.6,17,17,24,199,19.9,1,0,1,0,1,206,20.6,1,5,7,7,7.0,17922,16778,1677.8,-2667,-3404,1
6522,-2180,-3706,1540.2,15402,15435,6.2,4,4,6,205,20.5,0,0,1,0,0,204,20.4,0,12,11,11,7.2,19141,17582,1758.2,3706,2180,0
6523,-2545,-761,1541.4,15414,16960,6.4,6,6,5,188,18.8,1,1,1,0,0,225,22.5,1,5,6,6,6.8,17721,17959,1795.9,761,2545,0
6524,1935,162,1698.2,16982,17866,6.8,5,5,6,225,22.5,2,1,1,0,0,208,20.8,0,6,4,4,6.8,17704,15047,1504.7,-162,-1935,0
6525,-404,-419,1519.3,15193,16642,6.8,5,5,3,208,20.8,2,1,0,1,0,216,21.6,0,11,5,5,6.8,17061,15597,1559.7,419,404,1
6526,-1624,-1067,1596.8,15968,17837,6.8,5,5,4,226,22.6,0,0,1,0,1,198,19.8,1,13,9,9,7.2,18904,17592,1759.2,1067,1624,0
6527,-505,-602,1526.0,15260,18522,7.0,2,2,2,220,22.0,1,0,1,0,1,249,24.9,1,1,2,2,7.2,19124,15765,1576.5,602,505,1
6528,47,-856,1711.5,17115,17857,6.8,7,7,8,203,20.3,0,0,0,1,0,219,21.9,0,6,9,9,7.0,18713,17068,1706.8,856,-47,1
6529,-1754,-149,1636.5,16365,17954,6.8,5,5,7,225,22.5,0,0,0,1,1,243,24.3,1,13,8,8,7.0,18103,18119,1811.9,149,1754,0
6530,-424,308,1671.2,16712,18681,7.0,7,7,9,190,19.0,0,0,0,1,0,203,20.3,0,7,7,7,7.2,18373,17136,1713.6,-308,424,1
6531,2369,1517,1823.6,18236,17766,6.8,13,13,15,202,20.2,1,1,1,0,0,191,19.1,0,6,7,7,6.8,16249,15867,1586.7,-1517,-2369,1
6532,2778,-247,2006.7,20067,18286,7.0,13,13,15,206,20.6,0,0,1,0,1,184,18.4,1,4,10,10,7.0,18533,17289,1728.9,247,-2778,1
6533,-1183,-1235,1479.2,14792,16218,6.6,3,3,4,205,20.5,1,1,1,0,0,211,21.1,0,5,6,6,6.8,17453,15975,1597.5,1235,1183,0
6534,-2619,-1215,1474.8,14748,17867,6.8,1,1,0,212,21.2,0,0,0,1,1,237,23.7,1,8,6,6,7.2,19082,17367,1736.7,1215,2619,0
6535,2733,2062,1868.2,18682,19196,7.4,10,10,18,207,20.7,2,1,1,0,0,216,21.6,0,6,5,5,6.8,17134,15949,1594.9,-2062,-2733,1
6536,-277,-123,1588.3,15883,18069,6.8,3,3,2,229,22.9,0,0,1,0,0,242,24.2,0,5,4,4,7.0,18192,16160,1616.0,123,277,1
6537,673,-64,1593.8,15938,17167,6.8,5,5,5,200,20.0,0,0,1,0,0,210,21.0,1,3,4,4,6.6,17231,15265,1526.5,64,-673,1
6538,4817,4522,1840.5,18405,19055,7.0,11,11,16,228,22.8,0,0,1,0,0,193,19.3,0,2,2,2,6.2,14533,13588,1358.8,-4522,-4817,1
6539,956,-27,1616.4,16164,19020,7.2,4,4,5,246,24.6,0,0,1,0,1,242,24.2,1,3,2,2,7.2,19047,15208,1520.8,27,-956,1
6540,-3290,-1243,1500.0,15000,17095,6.8,3,3,2,212,21.2,1,0,0,1,1,252,25.2,1,7,7,7,7.2,18338,18290,1829.0,1243,3290,0
6541,-3003,-2118,1445.4,14454,17394,6.6,3,3,3,191,19.1,0,0,0,1,1,239,23.9,1,5,7,7,7.4,19512,17457,1745.7,2118,3003,0
6542,-1,-459,1745.9,17459,17773,6.8,7,7,7,209,20.9,1,1,0,1,0,231,23.1,0,6,8,8,6.8,18232,17460,1746.0,459,1,1
6543,2690,2444,1793.3,17933,19728,7.2,10,10,9,217,21.7,1,0,1,0,1,213,21.3,1,6,4,4,6.8,17284,15243,1524.3,-2444,-2690,1
6544,3568,2926,1478.0,14780,14277,6.0,2,2,1,188,18.8,1,0,1,0,0,132,13.2,0,0,1,1,4.8,11351,11212,1121.2,-2926,-3568,1
6545,777,742,1505.6,15056,18484,7.0,4,4,5,226,22.6,1,1,0,1,0,234,23.4,1,0,1,1,7.0,17742,14279,1427.9,-742,-777,0
6546,-5735,-5547,1333.7,13337,14550,6.0,2,2,3,158,15.8,0,0,0,1,1,232,23.2,2,6,8,8,7.6,20097,19072,1907.2,5547,5735,0
6547,4453,337,2016.9,20169,17549,7.0,13,13,18,205,20.5,1,1,1,0,0,162,16.2,0,9,6,6,6.6,17212,15716,1571.6,-337,-4453,1
6548,-193,-607,1554.9,15549,17486,6.8,5,5,5,222,22.2,1,0,0,1,1,248,24.8,1,2,4,4,6.8,18093,15742,1574.2,607,193,1
6549,2119,209,1839.2,18392,17969,7.2,10,10,14,221,22.1,1,1,1,0,0,206,20.6,0,6,5,5,7.0,17760,16273,1627.3,-209,-2119,1
6550,-480,-1045,1586.5,15865,16893,6.8,5,5,6,208,20.8,0,0,0,1,1,226,22.6,1,3,4,4,6.6,17938,16345,1634.5,1045,480,1
6551,1885,1636,1749.8,17498,18424,7.0,9,9,11,209,20.9,2,1,1,0,0,200,20.0,0,3,5,5,6.6,16788,15613,1561.3,-1636,-1885,1
6552,-1605,237,1460.6,14606,17820,7.0,2,2,3,221,22.1,1,1,0,1,0,235,23.5,0,7,5,5,7.0,17583,16211,1621.1,-237,1605,0
6553,-5691,-3094,1359.0,13590,16558,6.6,0,0,0,200,20.0,0,0,0,1,1,220,22.0,1,11,11,11,7.4,19652,19281,1928.1,3094,5691,0
6554,-995,181,1625.9,16259,18538,7.2,5,5,3,242,24.2,1,0,1,0,0,256,25.6,0,5,5,5,7.2,18357,17254,1725.4,-181,995,0
6555,-1730,24,1713.7,17137,18112,7.0,9,9,7,188,18.8,0,0,0,1,1,211,21.1,2,11,11,11,7.0,18088,18867,1886.7,-24,1730,0
6556,-1285,-1925,1477.5,14775,17337,6.8,2,2,4,206,20.6,0,0,1,0,0,227,22.7,1,7,4,4,7.2,19262,16060,1606.0,1925,1285,0
6557,-3024,-2806,1757.1,17571,16712,6.8,11,11,17,174,17.4,0,0,1,0,0,243,24.3,1,9,11,11,7.2,19518,20595,2059.5,2806,3024,1
6558,368,-774,1694.6,16946,18333,7.2,5,5,3,230,23.0,0,0,1,0,1,220,22.0,2,6,7,7,7.2,19107,16578,1657.8,774,-368,0
6559,969,-409,1643.7,16437,18096,6.8,2,2,4,244,24.4,1,0,1,0,1,236,23.6,1,3,1,1,7.0,18505,15468,1546.8,409,-969,0
6560,-259,1059,1688.1,16881,18875,7.2,6,6,5,241,24.1,0,0,0,1,0,188,18.8,0,9,8,8,7.0,17816,17140,1714.0,-1059,259,0
6561,443,1911,1593.8,15938,19963,7.2,2,2,3,242,24.2,1,1,0,1,0,244,24.4,0,1,3,3,7.0,18052,15495,1549.5,-1911,-443,1
6562,-1233,270,1563.9,15639,18956,7.0,4,4,4,230,23.0,1,1,0,1,0,243,24.3,0,5,4,4,7.2,18686,16872,1687.2,-270,1233,0
6563,-2298,-2281,1458.2,14582,16375,6.4,4,4,6,214,21.4,1,1,1,0,0,213,21.3,0,7,7,7,7.0,18656,16880,1688.0,2281,2298,0
6564,3608,2893,1953.7,19537,19905,7.4,13,13,8,242,24.2,0,0,1,0,1,188,18.8,1,10,6,6,6.6,17012,15929,1592.9,-2893,-3608,1
6565,-1762,-1592,1403.1,14031,16789,6.6,1,1,2,223,22.3,0,0,0,1,1,216,21.6,2,5,5,5,7.0,18381,15793,1579.3,1592,1762,0
6566,-2233,-1112,1674.9,16749,17716,7.0,7,7,6,192,19.2,0,0,0,1,1,215,21.5,1,10,11,11,7.2,18828,18982,1898.2,1112,2233,0
6567,1428,1200,1654.2,16542,19014,7.0,6,6,5,214,21.4,0,0,1,0,1,238,23.8,1,4,3,3,7.0,17814,15114,1511.4,-1200,-1428,1
6568,891,1526,1805.3,18053,19492,7.4,7,7,4,230,23.0,0,0,1,0,1,202,20.2,1,11,7,7,7.0,17966,17162,1716.2,-1526,-891,1
6569,1712,1178,1810.2,18102,18787,7.0,11,11,13,216,21.6,1,1,1,0,0,226,22.6,1,1,3,3,6.8,17609,16390,1639.0,-1178,-1712,0
6570,-874,-1370,1733.2,17332,16861,6.8,9,9,11,170,17.0,0,0,1,0,0,218,21.8,0,11,12,12,7.2,18231,18206,1820.6,1370,874,1
6571,1212,2099,1774.8,17748,19116,7.0,10,10,11,206,20.6,2,1,0,1,0,191,19.1,0,10,7,7,7.0,17017,16536,1653.6,-2099,-1212,1
6572,-370,555,1703.4,17034,18358,7.2,6,6,4,210,21.0,0,0,0,1,1,201,20.1,1,11,10,10,6.8,17803,17404,1740.4,-555,370,0
6573,230,1894,1600.0,16000,18965,7.2,6,6,4,181,18.1,1,1,0,1,0,236,23.6,0,4,5,5,6.8,17071,15770,1577.0,-1894,-230,0
6574,474,-102,1665.5,16655,18545,7.0,6,6,7,217,21.7,0,0,1,0,1,234,23.4,1,11,4,4,7.2,18647,16181,1618.1,102,-474,1
6575,-4492,-4085,1371.9,13719,16024,6.4,1,1,3,202,20.2,0,0,0,1,0,219,21.9,0,8,9,9,7.6,20109,18211,1821.1,4085,4492,0
6576,3037,2561,1726.4,17264,18301,7.0,5,5,7,248,24.8,0,0,1,0,0,174,17.4,0,2,3,3,6.4,15740,14227,1422.7,-2561,-3037,1
6577,-2686,-1780,1472.5,14725,17519,6.6,3,3,2,210,21.0,0,0,1,0,0,242,24.2,0,11,7,7,7.2,19299,17411,1741.1,1780,2686,0
6578,-3424,-1550,1436.0,14360,16876,6.6,4,4,2,175,17.5,0,0,0,1,1,207,20.7,1,4,6,6,7.2,18426,17784,1778.4,1550,3424,0
6579,135,-338,1622.3,16223,17419,6.8,6,6,6,233,23.3,0,0,1,0,1,202,20.2,1,9,6,6,6.8,17757,16088,1608.8,338,-135,1
6580,1755,717,1669.5,16695,17863,6.8,6,6,7,236,23.6,0,0,1,0,1,234,23.4,1,1,2,2,6.8,17146,14940,1494.0,-717,-1755,1
6581,-2523,-1057,1629.7,16297,19135,7.2,5,5,5,212,21.2,0,0,0,1,0,236,23.6,0,10,10,10,7.4,20192,18820,1882.0,1057,2523,1
6582,-1402,-1003,1538.6,15386,18832,7.2,2,2,2,246,24.6,2,1,0,1,0,264,26.4,0,4,6,6,7.6,19835,16788,1678.8,1003,1402,1
6583,4751,641,1843.5,18435,18643,7.2,6,6,9,254,25.4,2,1,1,0,0,203,20.3,0,0,1,1,6.8,18002,13684,1368.4,-641,-4751,1
6584,1238,1037,1700.8,17008,18978,7.2,7,7,8,216,21.6,0,0,0,1,1,231,23.1,1,5,4,4,6.8,17941,15770,1577.0,-1037,-1238,1
6585,2672,1784,1668.4,16684,19585,7.4,5,5,8,240,24.0,0,0,1,0,0,220,22.0,0,2,2,2,7.0,17801,14012,1401.2,-1784,-2672,1
6586,2954,4490,1796.5,17965,20621,7.4,9,9,5,229,22.9,1,1,1,0,0,208,20.8,0,8,4,4,6.4,16131,15011,1501.1,-4490,-2954,1
6587,272,-467,1673.7,16737,17553,6.8,5,5,10,231,23.1,1,1,1,0,0,218,21.8,0,8,5,5,7.0,18020,16465,1646.5,467,-272,1
6588,-2033,-1612,1363.8,13638,16479,6.8,1,1,1,190,19.0,0,0,0,1,0,238,23.8,0,3,3,3,7.2,18091,15671,1567.1,1612,2033,0
6589,-348,-901,1583.8,15838,18368,6.8,4,4,4,221,22.1,0,0,1,0,1,261,26.1,1,4,3,3,7.2,19269,16186,1618.6,901,348,0
6590,465,-911,1573.4,15734,18750,7.0,3,3,3,236,23.6,0,0,1,0,1,226,22.6,1,1,2,2,7.2,19661,15269,1526.9,911,-465,0
6591,-201,-14,1780.2,17802,18241,7.2,8,8,8,226,22.6,0,0,1,0,1,203,20.3,1,11,9,9,6.8,18255,18003,1800.3,14,201,0
6592,-393,-478,1614.9,16149,16018,6.4,7,7,7,186,18.6,0,0,1,0,0,173,17.3,0,7,9,9,6.4,16496,16542,1654.2,478,393,1
6593,-3485,-2423,1471.9,14719,16608,6.6,3,3,3,195,19.5,0,0,1,0,1,237,23.7,1,12,9,9,7.2,19031,18204,1820.4,2423,3485,0
6594,-791,-2157,1588.3,15883,16480,6.8,6,6,6,228,22.8,0,0,0,1,0,213,21.3,0,7,8,8,6.8,18637,16674,1667.4,2157,791,0
6595,3759,1339,1991.7,19917,18396,7.0,15,15,24,209,20.9,0,0,1,0,1,172,17.2,1,8,8,8,6.8,17057,16158,1615.8,-1339,-3759,1
6596,-1563,-1007,1613.7,16137,17136,6.4,7,7,10,203,20.3,0,0,0,1,1,219,21.9,1,8,8,8,7.0,18143,17700,1770.0,1007,1563,0
6597,3033,3187,1799.4,17994,20156,7.2,7,7,4,269,26.9,1,0,0,1,1,206,20.6,1,4,4,4,6.6,16969,14961,1496.1,-3187,-3033,0
6598,2120,2142,1769.3,17693,19209,7.2,9,9,4,226,22.6,1,1,1,0,0,178,17.8,0,6,5,5,6.8,17067,15573,1557.3,-2142,-2120,1
6599,-382,-247,1618.4,16184,18288,6.8,6,6,6,224,22.4,0,0,1,0,0,242,24.2,0,6,4,4,7.2,18535,16566,1656.6,247,382,1
6600,-478,346,1579.1,15791,18218,7.0,4,4,3,220,22.0,1,1,0,1,0,247,24.7,0,4,5,5,7.0,17872,16269,1626.9,-346,478,0
6601,566,-248,1542.6,15426,17927,7.0,3,3,2,202,20.2,0,0,1,0,0,249,24.9,0,0,2,2,6.8,18175,14860,1486.0,248,-566,0
6602,2657,2468,1688.5,16885,18326,7.2,5,5,7,229,22.9,1,1,1,0,0,200,20.0,0,4,3,3,6.4,15858,14228,1422.8,-2468,-2657,0
6603,-1891,263,1588.0,15880,18313,7.2,5,5,7,219,21.9,1,1,0,1,0,236,23.6,0,4,6,6,7.0,18050,17771,1777.1,-263,1891,0
6604,-16,-467,1670.1,16701,17762,7.0,6,6,10,196,19.6,1,1,0,1,0,232,23.2,0,3,6,6,7.2,18229,16717,1671.7,467,16,1
6605,1740,929,1704.0,17040,18469,7.2,8,8,6,230,23.0,0,0,1,0,1,198,19.8,1,5,6,6,6.8,17540,15300,1530.0,-929,-1740,0
6606,-1912,-957,1370.3,13703,16964,6.8,2,2,2,187,18.7,1,0,0,1,0,241,24.1,0,0,3,3,7.0,17921,15615,1561.5,957,1912,1
6607,-515,649,1695.3,16953,18996,7.0,8,8,1,238,23.8,1,1,0,1,0,211,21.1,0,11,9,9,7.2,18347,17468,1746.8,-649,515,0
6608,1570,1320,1632.7,16327,18521,7.0,6,6,1,190,19.0,0,0,0,1,1,214,21.4,1,1,4,4,6.8,17201,14757,1475.7,-1320,-1570,1
6609,3215,3092,1785.4,17854,20729,7.6,6,6,6,260,26.0,0,0,1,0,0,194,19.4,0,3,3,3,6.6,17637,14639,1463.9,-3092,-3215,1
6610,3605,3504,1997.0,19970,19994,7.2,12,12,14,221,22.1,0,0,0,1,0,186,18.6,0,8,7,7,6.4,16490,16365,1636.5,-3504,-3605,1
6611,-210,-589,1601.0,16010,17522,7.0,6,6,5,231,23.1,1,1,1,0,0,218,21.8,0,7,6,6,7.0,18111,16220,1622.0,589,210,0
6612,-1507,-1389,1689.9,16899,16675,6.8,9,9,12,180,18.0,0,0,0,1,1,217,21.7,2,14,11,11,7.0,18064,18406,1840.6,1389,1507,1
6613,-1114,-1440,1625.6,16256,16283,6.6,9,9,10,154,15.4,0,0,1,0,1,191,19.1,1,15,11,11,7.0,17723,17370,1737.0,1440,1114,0
6614,333,926,1667.6,16676,18660,7.0,6,6,6,238,23.8,0,0,0,1,0,241,24.1,0,9,5,5,6.8,17734,16343,1634.3,-926,-333,0
6615,1711,1767,1887.7,18877,19556,7.2,11,11,13,209,20.9,1,1,0,1,0,215,21.5,0,7,7,7,7.0,17789,17166,1716.6,-1767,-1711,1
6616,-2322,-1522,1482.7,14827,16610,6.6,4,4,6,187,18.7,0,0,0,1,1,222,22.2,1,5,6,6,7.0,18132,17149,1714.9,1522,2322,0
6617,65,351,1609.8,16098,17950,7.0,5,5,3,244,24.4,0,0,1,0,0,208,20.8,0,9,5,5,6.6,17599,16033,1603.3,-351,-65,0
6618,-305,242,1523.7,15237,17162,6.8,4,4,3,224,22.4,1,1,1,0,0,201,20.1,0,5,4,4,6.4,16920,15542,1554.2,-242,305,0
6619,311,707,1679.6,16796,19792,7.4,6,6,3,256,25.6,0,0,0,1,1,241,24.1,1,4,4,4,7.2,19085,16485,1648.5,-707,-311,0
6620,2728,1681,1932.3,19323,19481,7.4,10,10,11,220,22.0,1,0,0,1,0,241,24.1,0,7,5,5,7.0,17800,16595,1659.5,-1681,-2728,1
6621,2329,1331,1612.7,16127,17096,6.8,6,6,4,237,23.7,1,0,1,0,1,186,18.6,1,4,2,2,6.2,15765,13798,1379.8,-1331,-2329,1
6622,573,48,1702.7,17027,17004,6.8,9,9,12,175,17.5,0,0,1,0,0,191,19.1,0,11,6,6,7.0,16956,16454,1645.4,-48,-573,1
6623,-865,-20,1596.5,15965,17701,6.8,6,6,5,213,21.3,1,0,1,0,1,204,20.4,1,7,6,6,7.0,17721,16830,1683.0,20,865,0
6624,-2055,-214,1616.7,16167,18659,7.0,6,6,5,202,20.2,0,0,0,1,1,204,20.4,2,11,11,11,7.2,18873,18222,1822.2,214,2055,0
6625,3485,2447,1833.4,18334,18032,7.0,10,10,9,225,22.5,1,1,0,1,0,188,18.8,0,3,3,3,6.4,15585,14849,1484.9,-2447,-3485,1
6626,-1848,-1472,1519.1,15191,17269,6.6,3,3,4,214,21.4,0,0,0,1,1,219,21.9,2,9,7,7,7.0,18741,17039,1703.9,1472,1848,0
6627,-1989,-735,1613.2,16132,18044,7.0,6,6,3,222,22.2,1,0,0,1,1,218,21.8,1,6,7,7,7.4,18779,18121,1812.1,735,1989,0
6628,-100,-305,1509.8,15098,16937,6.6,3,3,2,232,23.2,0,0,1,0,1,178,17.8,1,4,6,6,6.8,17242,15198,1519.8,305,100,1
6629,1320,839,1626.1,16261,19301,7.2,5,5,3,221,22.1,1,1,1,0,0,204,20.4,0,6,4,4,7.0,18462,14941,1494.1,-839,-1320,1
6630,-311,-544,1642.7,16427,18653,7.2,5,5,9,248,24.8,0,0,0,1,0,227,22.7,0,10,7,7,7.2,19197,16738,1673.8,544,311,1
6631,-2834,-3402,1490.1,14901,14483,6.2,6,6,10,170,17.0,0,0,0,1,1,216,21.6,1,9,10,10,7.0,17885,17735,1773.5,3402,2834,0
6632,365,356,1707.0,17070,18022,6.8,7,7,10,232,23.2,1,1,0,1,0,201,20.1,0,10,6,6,7.0,17666,16705,1670.5,-356,-365,1
6633,112,79,1621.7,16217,17326,6.8,6,6,5,217,21.7,0,0,1,0,1,225,22.5,2,8,7,7,6.8,17247,16105,1610.5,-79,-112,1
6634,4577,3717,1882.2,18822,20135,7.2,10,10,10,253,25.3,1,0,1,0,1,192,19.2,1,2,2,2,6.6,16418,14245,1424.5,-3717,-4577,1
6635,5794,3899,1918.5,19185,18543,7.0,14,14,14,196,19.6,1,1,1,0,0,166,16.6,0,1,2,2,6.0,14644,13391,1339.1,-3899,-5794,1
6636,-3673,-2973,1422.0,14220,16333,6.4,3,3,3,203,20.3,0,0,1,0,1,234,23.4,1,9,9,9,7.4,19306,17893,1789.3,2973,3673,0
6637,3593,1136,1847.7,18477,19589,7.2,8,8,8,248,24.8,1,1,1,0,0,236,23.6,0,0,2,2,7.0,18453,14884,1488.4,-1136,-3593,1
6638,-330,55,1632.4,16324,18159,7.0,5,5,4,231,23.1,0,0,1,0,1,213,21.3,1,7,7,7,7.0,18104,16654,1665.4,-55,330,1
6639,-2720,-2473,1524.7,15247,17064,6.6,4,4,4,209,20.9,1,1,1,0,0,207,20.7,0,9,8,8,7.2,19537,17967,1796.7,2473,2720,0
6640,1670,1765,1736.1,17361,19308,7.2,6,6,4,208,20.8,1,1,1,0,0,217,21.7,0,6,4,4,6.8,17543,15691,1569.1,-1765,-1670,1
6641,1988,1552,1779.3,17793,19766,7.6,10,10,11,208,20.8,1,1,0,1,0,217,21.7,0,2,3,3,7.0,18214,15805,1580.5,-1552,-1988,1
6642,622,-1048,1461.9,14619,16874,6.6,2,2,3,244,24.4,0,0,1,0,1,198,19.8,1,1,2,2,6.8,17922,13997,1399.7,1048,-622,1
6643,726,-512,1555.2,15552,16960,7.0,5,5,5,211,21.1,0,0,0,1,1,192,19.2,1,3,5,5,6.8,17472,14826,1482.6,512,-726,1
6644,2695,1696,1717.0,17170,19662,7.2,5,5,5,258,25.8,1,0,1,0,1,233,23.3,1,2,1,1,6.8,17966,14475,1447.5,-1696,-2695,1
6645,1603,1389,1865.8,18658,19117,7.0,11,11,12,203,20.3,1,0,1,0,0,229,22.9,0,6,5,5,6.8,17728,17055,1705.5,-1389,-1603,0
6646,1879,-344,1785.7,17857,17155,6.8,10,10,14,211,21.1,1,0,1,0,0,227,22.7,0,5,5,5,6.8,17499,15978,1597.8,344,-1879,1
6647,-3238,-4114,1461.3,14613,16611,6.6,2,2,3,219,21.9,0,0,0,1,1,255,25.5,1,8,7,7,7.6,20725,17851,1785.1,4114,3238,0
6648,-2039,-484,1535.9,15359,17087,6.8,5,5,5,197,19.7,1,1,0,1,0,230,23.0,0,11,8,8,7.2,17571,17398,1739.8,484,2039,1
6649,773,1285,1675.6,16756,18790,7.0,7,7,2,239,23.9,1,0,1,0,1,190,19.0,1,6,6,6,6.8,17505,15983,1598.3,-1285,-773,0
6650,3140,3525,1998.4,19984,19327,7.0,14,14,14,207,20.7,2,1,1,0,0,201,20.1,0,9,7,7,6.4,15802,16844,1684.4,-3525,-3140,1
6651,-522,-577,1547.0,15470,17451,6.8,5,5,2,211,21.1,0,0,1,0,1,209,20.9,1,4,6,6,7.0,18028,15992,1599.2,577,522,0
6652,-1484,-1528,1649.4,16494,15865,6.2,9,9,15,156,15.6,0,0,1,0,1,196,19.6,1,14,12,12,6.6,17393,17978,1797.8,1528,1484,0
6653,-73,217,1590.4,15904,17623,6.8,6,6,6,201,20.1,0,0,0,1,1,228,22.8,2,6,5,5,6.6,17406,15977,1597.7,-217,73,0
6654,-4452,-3726,1442.3,14423,16642,6.8,3,3,4,190,19.0,1,0,0,1,1,238,23.8,1,8,11,11,7.4,20368,18875,1887.5,3726,4452,0
6655,-401,-995,1513.6,15136,17202,6.8,3,3,3,216,21.6,0,0,0,1,0,240,24.0,0,2,5,5,7.0,18197,15537,1553.7,995,401,0
6656,1650,1230,1668.1,16681,18901,7.2,8,8,9,216,21.6,0,0,0,1,1,224,22.4,2,1,3,3,7.0,17671,15031,1503.1,-1230,-1650,0
6657,-2681,-1941,1486.8,14868,18004,6.8,2,2,2,230,23.0,0,0,0,1,1,269,26.9,1,6,6,6,7.2,19945,17549,1754.9,1941,2681,0
6658,-511,303,1610.3,16103,17939,6.8,5,5,3,216,21.6,1,1,0,1,0,237,23.7,0,9,7,7,7.0,17636,16614,1661.4,-303,511,1
6659,-3878,-3868,1567.4,15674,15931,6.4,7,7,5,206,20.6,0,0,0,1,1,207,20.7,1,15,12,12,7.2,19799,19552,1955.2,3868,3878,0
6660,-4603,-3046,1410.0,14100,16543,6.4,3,3,1,189,18.9,0,0,0,1,1,241,24.1,2,8,9,9,7.2,19589,18703,1870.3,3046,4603,0
6661,3696,3558,2017.7,20177,21248,7.8,14,14,17,236,23.6,1,1,1,0,0,207,20.7,0,5,6,6,7.0,17690,16481,1648.1,-3558,-3696,1
6662,7,-685,1522.2,15222,16755,6.6,4,4,7,207,20.7,1,1,0,1,0,212,21.2,0,4,4,4,6.8,17440,15215,1521.5,685,-7,1
6663,-3354,-2698,1473.1,14731,16109,6.4,4,4,3,188,18.8,0,0,1,0,1,241,24.1,1,10,9,9,7.2,18807,18085,1808.5,2698,3354,0
6664,-2414,-959,1456.6,14566,16999,7.0,3,3,2,190,19.0,0,0,1,0,0,218,21.8,0,12,8,8,6.8,17958,16980,1698.0,959,2414,0
6665,-280,-752,1754.5,17545,17316,6.8,10,10,13,179,17.9,1,1,1,0,0,217,21.7,0,9,7,7,6.8,18068,17825,1782.5,752,280,0
6666,-2341,-2034,1515.9,15159,17161,6.6,3,3,6,221,22.1,1,1,0,1,0,214,21.4,0,12,8,8,7.2,19195,17500,1750.0,2034,2341,1
6667,-891,-768,1585.5,15855,17820,7.0,4,4,3,212,21.2,0,0,0,1,1,264,26.4,1,1,6,6,7.0,18588,16746,1674.6,768,891,0
6668,-355,-126,1702.3,17023,17635,7.0,6,6,6,224,22.4,1,1,0,1,0,209,20.9,0,11,9,9,6.8,17761,17378,1737.8,126,355,0
6669,515,1691,1716.3,17163,18565,7.2,8,8,9,221,22.1,1,1,0,1,0,211,21.1,0,14,7,7,6.6,16874,16648,1664.8,-1691,-515,0
6670,-1663,164,1587.5,15875,18236,7.0,5,5,3,224,22.4,1,1,0,1,0,173,17.3,0,14,9,9,7.0,18072,17538,1753.8,-164,1663,0
6671,-498,-2244,1488.7,14887,14486,6.4,6,6,6,159,15.9,1,1,1,0,0,227,22.7,1,1,3,3,6.6,16730,15385,1538.5,2244,498,1
6672,-2366,-3382,1533.0,15330,16197,6.6,4,4,3,203,20.3,1,1,1,0,0,229,22.9,0,12,8,8,7.2,19579,17696,1769.6,3382,2366,1
6673,-2514,-2762,1429.5,14295,16196,6.4,2,2,2,211,21.1,0,0,0,1,1,219,21.9,1,6,6,6,7.2,18958,16809,1680.9,2762,2514,0
6674,-247,-20,1645.4,16454,17910,6.8,6,6,6,209,20.9,1,1,0,1,0,227,22.7,0,6,5,5,7.0,17930,16701,1670.1,20,247,1
6675,-2847,-318,1395.1,13951,17688,7.0,1,1,2,211,21.1,0,0,0,1,1,239,23.9,1,7,5,5,7.2,18006,16798,1679.8,318,2847,0
6676,1180,1124,1630.7,16307,19846,7.2,3,3,4,255,25.5,0,0,1,0,1,240,24.0,1,2,2,2,7.2,18722,15127,1512.7,-1124,-1180,0
6677,-5540,-5343,1607.2,16072,15157,6.2,8,8,12,170,17.0,2,1,0,1,0,257,25.7,0,12,14,14,7.6,20500,21612,2161.2,5343,5540,0
6678,-2272,-2400,1551.5,15515,17838,6.8,4,4,2,231,23.1,0,0,0,1,1,225,22.5,1,7,11,11,7.6,20238,17787,1778.7,2400,2272,0
6679,-888,-975,1518.8,15188,17576,6.8,3,3,5,221,22.1,2,1,1,0,0,192,19.2,0,5,5,5,7.0,18551,16076,1607.6,975,888,1
6680,1090,342,1779.1,17791,18823,7.2,9,9,11,198,19.8,2,1,1,0,0,265,26.5,0,6,5,5,6.8,18481,16701,1670.1,-342,-1090,0
6681,-80,470,1581.3,15813,18788,7.2,4,4,7,248,24.8,0,0,0,1,1,219,21.9,1,2,4,4,7.2,18318,15893,1589.3,-470,80,0
6682,-541,-66,1442.4,14424,17499,6.6,3,3,3,201,20.1,1,0,1,0,0,234,23.4,0,2,2,2,6.8,17565,14965,1496.5,66,541,0
6683,1087,340,1930.6,19306,19792,7.4,12,12,13,218,21.8,0,0,0,1,1,222,22.2,2,8,8,8,7.4,19452,18219,1821.9,-340,-1087,0
6684,-3489,-2633,1434.8,14348,17150,7.0,2,2,3,196,19.6,0,0,0,1,1,239,23.9,1,12,8,8,7.4,19783,17837,1783.7,2633,3489,0
6685,-1510,-1756,1499.0,14990,17870,6.8,2,2,1,221,22.1,0,0,0,1,1,228,22.8,1,9,6,6,7.4,19626,16500,1650.0,1756,1510,0
6686,627,174,1612.9,16129,18291,7.0,5,5,7,222,22.2,0,0,0,1,1,219,21.9,1,5,4,4,7.2,18117,15502,1550.2,-174,-627,0
6687,2649,1251,1813.5,18135,18974,7.2,9,9,5,233,23.3,1,1,1,0,0,219,21.9,0,3,4,4,6.8,17723,15486,1548.6,-1251,-2649,1
6688,1008,372,1703.9,17039,18571,7.2,6,6,3,228,22.8,1,0,0,1,0,218,21.8,0,3,5,5,6.8,18199,16031,1603.1,-372,-1008,0
6689,-2553,-2532,1476.1,14761,16905,6.4,3,3,2,194,19.4,1,1,0,1,0,224,22.4,1,8,7,7,7.0,19437,17314,1731.4,2532,2553,0
6690,-6850,-6210,1297.1,12971,14675,6.4,0,0,0,181,18.1,0,0,0,1,1,236,23.6,1,16,15,15,7.6,20885,19821,1982.1,6210,6850,0
6691,-1297,-129,1522.0,15220,18562,6.8,4,4,3,234,23.4,0,0,0,1,0,241,24.1,0,4,3,3,7.0,18691,16517,1651.7,129,1297,1
6692,2894,2297,1822.8,18228,19302,7.2,12,12,14,196,19.6,1,1,0,1,0,192,19.2,0,5,6,6,6.6,17005,15334,1533.4,-2297,-2894,1
6693,480,-685,1749.0,17490,17883,6.8,6,6,12,226,22.6,0,0,1,0,0,220,22.0,0,12,7,7,7.0,18568,17010,1701.0,685,-480,1
6694,-849,-1172,1533.8,15338,17842,7.0,4,4,4,217,21.7,0,0,1,0,0,234,23.4,0,5,6,6,7.0,19014,16187,1618.7,1172,849,1
6695,2548,1873,1942.1,19421,19063,7.4,11,11,15,215,21.5,1,1,1,0,0,165,16.5,0,5,9,9,7.0,17190,16873,1687.3,-1873,-2548,1
6696,2091,2518,1732.1,17321,18397,7.2,7,7,11,233,23.3,0,0,0,1,1,204,20.4,1,6,4,4,6.6,15879,15230,1523.0,-2518,-2091,1
6697,2453,1802,1717.0,17170,18247,7.0,6,6,5,247,24.7,1,1,1,0,0,178,17.8,0,4,5,5,6.6,16445,14717,1471.7,-1802,-2453,0
6698,-810,123,1716.2,17162,18810,7.2,7,7,11,216,21.6,1,1,0,1,0,272,27.2,0,10,7,7,7.2,18687,17972,1797.2,-123,810,1
6699,2164,3151,1738.2,17382,19669,7.4,7,7,5,218,21.8,1,1,1,0,0,205,20.5,0,7,4,4,6.6,16518,15218,1521.8,-3151,-2164,1
6700,-1249,-3078,1631.3,16313,16697,6.8,7,7,6,201,20.1,0,0,1,0,0,228,22.8,0,5,7,7,7.4,19775,17562,1756.2,3078,1249,0
6701,-286,606,1526.4,15264,17806,7.0,2,2,2,217,21.7,0,0,0,1,1,235,23.5,2,6,4,4,6.8,17200,15550,1555.0,-606,286,1
6702,-4625,-1892,1500.1,15001,17600,6.8,3,3,2,228,22.8,0,0,0,1,1,247,24.7,1,16,12,12,7.2,19492,19626,1962.6,1892,4625,0
6703,-377,414,1693.8,16938,18931,7.2,4,4,4,248,24.8,1,0,0,1,1,224,22.4,1,11,7,7,7.2,18517,17315,1731.5,-414,377,0
6704,3966,2905,1963.4,19634,19705,7.2,10,10,4,242,24.2,1,0,1,0,1,203,20.3,1,8,5,5,6.6,16800,15668,1566.8,-2905,-3966,1
6705,299,874,1678.2,16782,19169,7.2,7,7,11,213,21.3,1,0,1,0,0,230,23.0,0,3,4,4,7.0,18295,16483,1648.3,-874,-299,0
6706,1844,-34,1872.3,18723,17268,6.8,11,11,13,188,18.8,0,0,1,0,1,210,21.0,1,6,8,8,6.6,17302,16879,1687.9,34,-1844,0
6707,-2896,-2725,1464.4,14644,16269,6.8,5,5,3,201,20.1,1,0,0,1,1,242,24.2,1,5,6,6,7.2,18994,17540,1754.0,2725,2896,0
6708,646,1756,1911.8,19118,19312,7.2,14,14,11,218,21.8,0,0,0,1,0,211,21.1,1,13,12,12,6.8,17556,18472,1847.2,-1756,-646,1
6709,-2831,-1725,1354.6,13546,16240,6.6,0,0,0,198,19.8,0,0,0,1,0,219,21.9,0,5,4,4,7.0,17965,16377,1637.7,1725,2831,0
6710,-3488,-2682,1643.1,16431,16968,6.6,5,5,2,219,21.9,2,1,1,0,0,240,24.0,0,18,14,14,7.4,19650,19919,1991.9,2682,3488,0
6711,1852,2435,1656.1,16561,19634,7.4,6,6,7,226,22.6,0,0,1,0,1,238,23.8,1,2,1,1,7.0,17199,14709,1470.9,-2435,-1852,1
6712,-2140,-1892,1486.6,14866,16219,6.6,3,3,3,208,20.8,0,0,0,1,1,224,22.4,2,9,7,7,6.8,18111,17006,1700.6,1892,2140,0
6713,1059,683,1862.5,18625,18941,7.2,11,11,11,234,23.4,0,0,1,0,0,191,19.1,0,4,7,7,6.8,18258,17566,1756.6,-683,-1059,1
6714,2410,1034,1719.4,17194,19161,7.4,9,9,8,221,22.1,1,1,1,0,0,235,23.5,0,0,2,2,6.8,18127,14784,1478.4,-1034,-2410,1
6715,-14,-19,1587.3,15873,18580,7.2,5,5,4,236,23.6,1,1,0,1,0,232,23.2,0,4,4,4,7.2,18599,15887,1588.7,19,14,1
6716,-940,-1019,1639.8,16398,17998,7.2,6,6,6,217,21.7,1,1,1,0,0,220,22.0,0,9,7,7,7.0,19017,17338,1733.8,1019,940,1
6717,2114,1904,1795.1,17951,18661,7.2,8,8,4,244,24.4,1,0,1,0,1,220,22.0,1,4,5,5,6.4,16757,15837,1583.7,-1904,-2114,0
6718,323,392,1524.0,15240,17591,6.6,3,3,4,234,23.4,1,1,0,1,0,231,23.1,0,3,2,2,6.6,17199,14917,1491.7,-392,-323,0
6719,287,568,1756.1,17561,18172,6.8,10,10,8,203,20.3,1,1,1,0,0,228,22.8,0,4,6,6,6.6,17604,17274,1727.4,-568,-287,0
6720,-3805,-2093,1420.0,14200,17304,6.6,2,2,2,191,19.1,0,0,0,1,1,230,23.0,1,9,8,8,7.0,19397,18005,1800.5,2093,3805,0
6721,6,1624,1605.5,16055,17800,6.8,5,5,2,226,22.6,0,0,0,1,1,160,16.0,1,15,9,9,6.6,16176,16049,1604.9,-1624,-6,1
6722,4525,4052,1945.6,19456,21097,7.8,7,7,6,230,23.0,0,0,1,0,0,247,24.7,0,2,2,2,6.6,17045,14931,1493.1,-4052,-4525,1
6723,-228,-387,1592.3,15923,17907,7.0,5,5,5,212,21.2,0,0,0,1,1,230,23.0,1,5,6,6,7.0,18294,16151,1615.1,387,228,0
6724,-1499,-1628,1387.9,13879,16393,6.6,2,2,2,194,19.4,1,1,0,1,0,226,22.6,0,1,3,3,7.0,18021,15378,1537.8,1628,1499,1
6725,2356,1297,1735.6,17356,19154,7.2,9,9,9,195,19.5,0,0,1,0,0,193,19.3,0,3,4,4,7.0,17857,15000,1500.0,-1297,-2356,1
6726,-1340,-228,1586.1,15861,17523,6.8,5,5,7,182,18.2,0,0,1,0,1,204,20.4,2,7,7,7,6.8,17751,17201,1720.1,228,1340,1
6727,2745,1800,1751.1,17511,19617,7.6,8,8,9,220,22.0,1,1,0,1,0,235,23.5,0,0,2,2,6.8,17817,14766,1476.6,-1800,-2745,1
6728,-2446,-1508,1552.8,15528,17590,6.8,4,4,4,230,23.0,0,0,0,1,1,248,24.8,1,4,6,6,7.0,19098,17974,1797.4,1508,2446,0
6729,1131,1370,1639.3,16393,18783,7.2,8,8,15,196,19.6,0,0,0,1,1,253,25.3,1,3,2,2,6.8,17413,15262,1526.2,-1370,-1131,0
6730,1668,-774,1743.3,17433,17284,6.8,9,9,16,198,19.8,0,0,1,0,1,210,21.0,2,4,5,5,7.0,18058,15765,1576.5,774,-1668,1
6731,1460,2108,1971.4,19714,18151,7.2,13,13,13,186,18.6,0,0,0,1,0,200,20.0,0,13,12,12,6.6,16043,18254,1825.4,-2108,-1460,1
6732,-4346,-2178,1556.9,15569,17357,6.8,6,6,9,167,16.7,0,0,0,1,1,239,23.9,1,11,10,10,7.4,19535,19915,1991.5,2178,4346,0
6733,-36,-641,1703.1,17031,16530,6.6,8,8,14,181,18.1,1,1,1,0,0,224,22.4,1,8,7,7,6.8,17171,17067,1706.7,641,36,1
6734,844,1636,1825.4,18254,18805,7.2,9,9,12,218,21.8,1,1,1,0,0,183,18.3,1,15,8,8,6.8,17169,17410,1741.0,-1636,-844,1
6735,-842,749,1612.6,16126,18226,7.0,6,6,4,201,20.1,0,0,0,1,1,230,23.0,1,6,8,8,6.6,17477,16968,1696.8,-749,842,0
6736,-1321,-1186,1593.7,15937,17560,7.0,5,5,8,212,21.2,0,0,1,0,1,241,24.1,1,5,5,5,7.2,18746,17258,1725.8,1186,1321,0
6737,-1780,-2942,1559.5,15595,16171,6.6,5,5,6,208,20.8,0,0,1,0,1,231,23.1,1,5,9,9,7.0,19113,17375,1737.5,2942,1780,0
6738,1319,556,1687.4,16874,17230,6.8,5,5,2,226,22.6,2,1,1,0,0,212,21.2,0,4,6,6,6.8,16674,15555,1555.5,-556,-1319,1
6739,2032,2833,1634.4,16344,19730,7.4,5,5,2,234,23.4,1,1,0,1,0,212,21.2,0,2,2,2,6.8,16897,14312,1431.2,-2833,-2032,1
6740,-27,114,1588.2,15882,18646,7.2,5,5,4,214,21.4,0,0,1,0,1,254,25.4,1,3,3,3,7.2,18532,15909,1590.9,-114,27,0
6741,-1384,-853,1549.8,15498,16711,6.6,6,6,2,201,20.1,0,0,1,0,1,190,19.0,1,9,9,9,6.6,17564,16882,1688.2,853,1384,0
6742,5935,2933,1969.9,19699,20307,7.4,10,10,5,251,25.1,0,0,1,0,1,184,18.4,1,1,1,1,7.0,17374,13764,1376.4,-2933,-5935,1
6743,689,-913,1732.0,17320,17894,6.8,9,9,12,215,21.5,2,1,1,0,0,226,22.6,0,6,6,6,7.2,18807,16631,1663.1,913,-689,1
6744,-2381,-1122,1472.0,14720,18456,7.2,2,2,2,246,24.6,0,0,0,1,0,237,23.7,1,3,6,6,7.0,19578,17101,1710.1,1122,2381,1
6745,51,140,1651.8,16518,19187,7.2,6,6,6,223,22.3,0,0,1,0,1,245,24.5,1,6,5,5,7.2,19047,16467,1646.7,-140,-51,0
6746,2664,2155,1792.6,17926,18959,7.2,8,8,9,245,24.5,0,0,1,0,1,158,15.8,1,9,6,6,6.8,16804,15262,1526.2,-2155,-2664,0
6747,999,482,1663.2,16632,17833,6.8,5,5,6,215,21.5,0,0,1,0,1,198,19.8,1,10,6,6,7.0,17351,15633,1563.3,-482,-999,1
6748,2757,970,1835.7,18357,18461,7.2,8,8,15,228,22.8,1,1,1,0,0,209,20.9,1,3,4,4,6.8,17491,15600,1560.0,-970,-2757,0
6749,4535,3490,1825.8,18258,19948,7.4,9,9,10,237,23.7,1,1,1,0,0,237,23.7,0,0,0,0,6.6,16458,13723,1372.3,-3490,-4535,1
6750,31,-741,1670.6,16706,17561,6.8,8,8,6,216,21.6,1,1,1,0,0,231,23.1,1,7,6,6,7.0,18302,16675,1667.5,741,-31,0
6751,4651,4293,1823.4,18234,19881,7.4,7,7,10,243,24.3,1,1,1,0,0,156,15.6,0,2,2,2,6.2,15588,13583,1358.3,-4293,-4651,1
6752,-4552,-2289,1420.2,14202,16159,6.4,3,3,3,200,20.0,0,0,0,1,1,223,22.3,1,16,12,12,7.2,18448,18754,1875.4,2289,4552,0
6753,3969,1119,1791.1,17911,18635,7.2,7,7,4,248,24.8,1,1,1,0,0,164,16.4,0,2,3,3,6.8,17516,13942,1394.2,-1119,-3969,1
6754,-3915,-4094,1309.4,13094,15865,6.4,0,0,0,205,20.5,0,0,0,1,1,259,25.9,1,2,5,5,7.4,19959,17009,1700.9,4094,3915,0
6755,1716,1970,1747.6,17476,19033,7.2,8,8,11,245,24.5,0,0,0,1,0,209,20.9,0,8,4,4,6.6,17063,15760,1576.0,-1970,-1716,0
6756,-988,-797,1697.9,16979,19193,7.2,5,5,6,247,24.7,0,0,1,0,1,219,21.9,1,6,8,8,7.4,19990,17967,1796.7,797,988,0
6757,-4221,-3570,1397.7,13977,15531,6.2,2,2,2,197,19.7,0,0,0,1,1,233,23.3,1,14,9,9,7.0,19101,18198,1819.8,3570,4221,0
6758,-2053,-2608,1434.5,14345,15396,6.4,4,4,8,172,17.2,1,1,1,0,0,208,20.8,0,10,6,6,6.8,18004,16398,1639.8,2608,2053,0
6759,415,14,1560.1,15601,17171,6.8,4,4,3,232,23.2,0,0,1,0,1,202,20.2,1,5,4,4,6.8,17157,15186,1518.6,-14,-415,0
6760,-1470,-1837,1496.6,14966,16483,6.4,5,5,8,177,17.7,0,0,1,0,1,220,22.0,1,10,5,5,7.0,18320,16436,1643.6,1837,1470,0
6761,1439,755,1612.7,16127,18510,7.2,4,4,2,225,22.5,0,0,1,0,1,210,21.0,1,1,2,2,6.8,17755,14688,1468.8,-755,-1439,1
6762,-1534,-1425,1715.6,17156,17559,6.8,8,8,5,195,19.5,0,0,0,1,1,204,20.4,1,16,11,11,7.2,18984,18690,1869.0,1425,1534,0
6763,-175,-624,1579.0,15790,16936,6.6,5,5,2,221,22.1,0,0,0,1,1,205,20.5,2,5,5,5,7.0,17560,15965,1596.5,624,175,0
6764,-1785,-940,1646.2,16462,18654,7.2,6,6,5,212,21.2,0,0,0,1,1,232,23.2,1,8,9,9,7.2,19594,18247,1824.7,940,1785,0
6765,-2289,-2259,1579.8,15798,17608,6.8,4,4,3,225,22.5,1,0,0,1,1,239,23.9,1,10,7,7,7.4,19867,18087,1808.7,2259,2289,0
6766,3749,3555,1766.6,17666,20014,7.2,6,6,7,264,26.4,0,0,0,1,0,214,21.4,0,1,1,1,6.4,16459,13917,1391.7,-3555,-3749,1
6767,4287,3536,1801.8,18018,19634,7.4,9,9,8,234,23.4,0,0,0,1,1,209,20.9,1,0,1,1,6.6,16098,13731,1373.1,-3536,-4287,1
6768,-177,-113,1602.7,16027,16856,6.6,6,6,10,212,21.2,1,0,0,1,1,183,18.3,1,8,7,7,6.4,16969,16204,1620.4,113,177,1
6769,5492,4505,1868.1,18681,20293,7.4,9,9,12,249,24.9,0,0,1,0,0,181,18.1,1,1,1,1,6.4,15788,13189,1318.9,-4505,-5492,1
6770,1726,1158,1767.1,17671,18386,7.0,10,10,7,231,23.1,1,1,1,0,0,199,19.9,0,3,5,5,6.6,17228,15945,1594.5,-1158,-1726,1
6771,-836,-839,1597.4,15974,17188,6.8,4,4,2,227,22.7,1,1,0,1,0,217,21.7,0,10,7,7,6.8,18027,16810,1681.0,839,836,0
6772,2082,1304,1665.6,16656,18706,7.4,6,6,4,230,23.0,0,0,1,0,1,213,21.3,1,3,1,1,6.8,17402,14574,1457.4,-1304,-2082,1
6773,-1325,-1348,1422.4,14224,16992,6.8,1,1,1,229,22.9,0,0,0,1,1,223,22.3,1,4,4,4,7.0,18340,15549,1554.9,1348,1325,0
6774,-36,-752,1652.6,16526,18314,7.0,4,4,4,237,23.7,1,1,0,1,0,225,22.5,0,8,7,7,7.2,19066,16562,1656.2,752,36,1
6775,-1647,-1443,1689.0,16890,17686,6.8,7,7,9,221,22.1,1,1,1,0,0,223,22.3,1,9,8,8,7.2,19129,18537,1853.7,1443,1647,1
6776,2336,2323,1687.9,16879,19019,7.4,7,7,11,237,23.7,0,0,1,0,0,194,19.4,0,3,3,3,6.8,16696,14543,1454.3,-2323,-2336,1
6777,1997,-800,1962.2,19622,18338,7.0,12,12,13,216,21.6,1,1,1,0,0,211,21.1,0,8,10,10,7.0,19138,17625,1762.5,800,-1997,1
6778,2333,1998,1686.7,16867,18880,7.2,7,7,7,226,22.6,0,0,0,1,1,224,22.4,1,3,2,2,6.6,16882,14534,1453.4,-1998,-2333,1
6779,-1024,940,1587.4,15874,18205,7.0,4,4,3,223,22.3,1,0,0,1,1,217,21.7,1,10,7,7,6.8,17265,16898,1689.8,-940,1024,0
6780,-898,-1077,1678.9,16789,17799,6.8,8,8,9,205,20.5,1,1,1,0,0,199,19.9,0,13,9,9,7.2,18876,17687,1768.7,1077,898,0
6781,1327,566,1731.5,17315,18205,7.0,8,8,9,231,23.1,2,1,1,0,0,232,23.2,0,5,4,4,6.8,17639,15988,1598.8,-566,-1327,1
6782,-2048,-29,1560.5,15605,19324,7.0,5,5,1,216,21.6,0,0,0,1,1,221,22.1,1,13,10,10,7.4,19353,17653,1765.3,29,2048,1
6783,-3606,-1971,1505.9,15059,17650,6.8,3,3,2,200,20.0,0,0,1,0,1,208,20.8,1,18,11,11,7.2,19621,18665,1866.5,1971,3606,0
6784,3807,1830,1813.7,18137,18171,7.0,10,10,9,231,23.1,2,1,1,0,0,204,20.4,0,3,2,2,6.6,16341,14330,1433.0,-1830,-3807,1
6785,-1341,-339,1469.8,14698,16713,6.6,4,4,2,192,19.2,0,0,1,0,1,197,19.7,2,9,6,6,7.0,17052,16039,1603.9,339,1341,1
6786,647,481,1578.8,15788,18069,6.8,5,5,5,200,20.0,0,0,1,0,1,228,22.8,2,2,4,4,7.0,17588,15141,1514.1,-481,-647,0
6787,209,250,1546.4,15464,17569,6.8,2,2,1,237,23.7,0,0,1,0,0,242,24.2,0,1,3,3,6.8,17319,15255,1525.5,-250,-209,1
6788,934,776,1704.2,17042,19460,7.4,7,7,6,207,20.7,1,0,0,1,0,248,24.8,0,4,5,5,7.4,18684,16108,1610.8,-776,-934,0
6789,-1707,-1600,1524.2,15242,16237,6.4,5,5,6,204,20.4,0,0,0,1,1,231,23.1,1,10,8,8,6.8,17837,16949,1694.9,1600,1707,0
6790,-624,1141,1612.5,16125,20079,7.2,3,3,4,246,24.6,0,0,1,0,1,271,27.1,1,6,4,4,7.0,18938,16749,1674.9,-1141,624,1
6791,3912,5044,1795.5,17955,20629,7.4,10,10,7,241,24.1,1,1,0,1,0,182,18.2,0,3,2,2,6.2,15585,14043,1404.3,-5044,-3912,1
6792,-387,795,1527.7,15277,17240,6.6,5,5,3,207,20.7,1,1,1,0,0,217,21.7,0,5,4,4,6.4,16445,15664,1566.4,-795,387,1
6793,-764,-120,1508.7,15087,16343,6.4,5,5,7,213,21.3,1,1,0,1,0,211,21.1,0,12,6,6,6.6,16463,15851,1585.1,120,764,1
6794,1313,1407,1688.0,16880,18007,7.2,8,8,9,217,21.7,0,0,0,1,0,181,18.1,0,6,6,6,6.4,16600,15567,1556.7,-1407,-1313,1
6795,4347,2472,1787.8,17878,18056,6.8,8,8,10,216,21.6,2,1,1,0,0,179,17.9,0,2,2,2,6.2,15584,13531,1353.1,-2472,-4347,1
6796,3855,1646,1927.0,19270,19668,7.6,12,12,10,229,22.9,0,0,1,0,1,213,21.3,2,1,5,5,7.0,18022,15415,1541.5,-1646,-3855,1
6797,1125,299,1531.8,15318,17999,7.0,6,6,6,191,19.1,1,1,1,0,0,251,25.1,0,0,0,0,7.0,17700,14193,1419.3,-299,-1125,1
6798,478,1166,1629.1,16291,16847,6.8,8,8,16,179,17.9,1,1,0,1,0,205,20.5,0,8,5,5,6.4,15681,15813,1581.3,-1166,-478,1
6799,1868,1432,1773.8,17738,18849,7.2,8,8,9,209,20.9,1,1,0,1,0,207,20.7,0,3,7,7,7.0,17417,15870,1587.0,-1432,-1868,1
6800,1711,1464,1676.5,16765,19056,7.0,6,6,6,201,20.1,0,0,1,0,1,240,24.0,1,2,4,4,6.6,17592,15054,1505.4,-1464,-1711,1
6801,1416,-211,1691.2,16912,17678,7.0,8,8,10,222,22.2,1,1,1,0,0,196,19.6,0,3,4,4,6.8,17889,15496,1549.6,211,-1416,1
6802,-2269,-1616,1453.4,14534,17364,7.0,2,2,1,224,22.4,1,0,1,0,1,250,25.0,1,7,5,5,7.0,18980,16803,1680.3,1616,2269,1
6803,69,-119,1728.9,17289,18113,6.8,8,8,10,201,20.1,1,1,1,0,0,237,23.7,1,5,7,7,7.0,18232,17220,1722.0,119,-69,1
6804,2435,894,1794.8,17948,18736,7.0,6,6,3,247,24.7,2,1,1,0,0,219,21.9,0,7,5,5,6.8,17842,15513,1551.3,-894,-2435,1
6805,-535,1397,1605.8,16058,17194,7.0,7,7,3,200,20.0,0,0,1,0,1,198,19.8,1,5,8,8,6.6,15797,16593,1659.3,-1397,535,1
6806,-975,-678,1711.2,17112,18050,7.0,7,7,8,215,21.5,1,1,1,0,0,225,22.5,1,10,8,8,7.0,18728,18087,1808.7,678,975,0
6807,-704,-1227,1608.9,16089,18217,7.0,5,5,3,227,22.7,2,1,0,1,0,237,23.7,0,4,6,6,7.2,19444,16793,1679.3,1227,704,0
6808,789,1620,1713.2,17132,19401,7.2,6,6,7,237,23.7,0,0,0,1,0,209,20.9,0,6,7,7,7.0,17781,16343,1634.3,-1620,-789,0
6809,1317,1480,1777.7,17777,18847,7.4,8,8,9,232,23.2,0,0,1,0,0,202,20.2,1,8,6,6,6.8,17367,16460,1646.0,-1480,-1317,1
6810,948,292,1880.8,18808,19323,7.2,9,9,13,244,24.4,0,0,0,1,1,234,23.4,1,10,8,8,7.0,19031,17860,1786.0,-292,-948,1
6811,270,679,1484.2,14842,17857,7.0,2,2,2,231,23.1,0,0,1,0,1,193,19.3,1,3,4,4,6.8,17178,14572,1457.2,-679,-270,0
6812,2741,868,1647.5,16475,18879,7.2,5,5,4,231,23.1,1,0,1,0,1,233,23.3,1,0,0,0,7.0,18011,13734,1373.4,-868,-2741,1
6813,3201,276,1791.7,17917,17502,7.0,8,8,10,239,23.9,0,0,0,1,1,197,19.7,1,3,2,2,6.8,17226,14716,1471.6,-276,-3201,1
6814,541,875,1632.4,16324,17601,6.8,6,6,11,197,19.7,0,0,1,0,0,240,24.0,0,3,4,4,6.8,16726,15783,1578.3,-875,-541,0
6815,-1055,-207,1630.8,16308,18876,7.2,5,5,5,245,24.5,1,1,0,1,0,259,25.9,1,5,6,6,7.2,19083,17363,1736.3,207,1055,1
6816,-4105,-2279,1475.6,14756,17655,6.8,4,4,3,184,18.4,0,0,0,1,1,229,22.9,1,8,8,8,7.4,19934,18861,1886.1,2279,4105,0
6817,-4156,-2933,1482.0,14820,15946,6.6,4,4,4,184,18.4,0,0,0,1,0,240,24.0,1,15,9,9,7.0,18879,18976,1897.6,2933,4156,1
6818,1579,893,1562.4,15624,17633,6.8,3,3,2,233,23.3,0,0,1,0,1,222,22.2,2,1,1,1,6.6,16740,14045,1404.5,-893,-1579,1
6819,-3779,-1537,1509.8,15098,18104,6.8,4,4,3,225,22.5,0,0,0,1,1,227,22.7,2,10,11,11,7.4,19641,18877,1887.7,1537,3779,0
6820,4064,3736,1731.5,17315,18903,7.2,8,8,6,232,23.2,1,1,0,1,0,181,18.1,0,1,2,2,6.2,15167,13251,1325.1,-3736,-4064,1
6821,-2494,-996,1398.1,13981,16753,6.6,1,1,2,220,22.0,0,0,1,0,0,250,25.0,0,3,6,6,6.8,17749,16475,1647.5,996,2494,0
6822,-1081,-2155,1560.2,15602,16235,6.6,6,6,9,195,19.5,1,1,1,0,0,214,21.4,0,4,6,6,7.0,18390,16683,1668.3,2155,1081,0
6823,2975,994,1756.9,17569,17425,6.8,9,9,9,191,19.1,0,0,1,0,0,180,18.0,0,4,3,3,6.8,16431,14594,1459.4,-994,-2975,1
6824,-1611,-1901,1538.1,15381,14805,6.2,7,7,15,167,16.7,1,1,1,0,0,201,20.1,0,8,8,8,6.6,16706,16992,1699.2,1901,1611,0
6825,-2579,-626,1484.0,14840,17620,6.8,3,3,3,226,22.6,1,0,0,1,0,245,24.5,0,9,6,6,7.0,18246,17419,1741.9,626,2579,0
6826,-2764,-2934,1534.6,15346,15646,6.4,5,5,2,187,18.7,0,0,0,1,1,202,20.2,1,13,11,11,7.2,18580,18110,1811.0,2934,2764,0
6827,837,1199,1653.0,16530,18713,7.0,4,4,8,243,24.3,0,0,1,0,1,233,23.3,1,3,4,4,6.6,17514,15693,1569.3,-1199,-837,1
6828,-6676,-3924,1437.9,14379,16423,6.6,2,2,3,203,20.3,0,0,1,0,1,223,22.3,1,14,12,12,7.2,20347,21055,2105.5,3924,6676,0
6829,-2787,-2662,1679.2,16792,16518,6.4,7,7,11,198,19.8,0,0,0,1,1,216,21.6,2,11,11,11,7.2,19180,19579,1957.9,2662,2787,0
6830,-2449,-3095,1524.3,15243,16159,6.4,5,5,4,193,19.3,0,0,0,1,1,257,25.7,1,8,8,8,7.2,19254,17692,1769.2,3095,2449,0
6831,1372,1668,1733.2,17332,19582,7.2,10,10,6,235,23.5,0,0,1,0,0,207,20.7,0,6,6,6,7.0,17914,15960,1596.0,-1668,-1372,1
6832,-576,-1269,1612.0,16120,18058,7.0,3,3,6,246,24.6,1,1,1,0,0,228,22.8,1,6,5,5,7.2,19327,16696,1669.6,1269,576,1
6833,447,1096,1701.3,17013,19131,7.4,7,7,10,230,23.0,0,0,1,0,1,228,22.8,1,5,6,6,7.0,18035,16566,1656.6,-1096,-447,1
6834,-1157,-573,1575.4,15754,16911,6.8,5,5,6,196,19.6,0,0,1,0,1,228,22.8,1,12,8,8,6.6,17484,16911,1691.1,573,1157,1
6835,3774,4377,2000.7,20007,19097,7.0,11,11,15,241,24.1,1,1,0,1,0,184,18.4,0,9,7,7,6.0,14720,16233,1623.3,-4377,-3774,0
6836,3702,3355,2006.3,20063,20273,7.4,14,14,14,244,24.4,1,1,0,1,0,175,17.5,1,8,7,7,6.8,16918,16361,1636.1,-3355,-3702,1
6837,2622,1080,1726.3,17263,18277,7.0,8,8,8,222,22.2,0,0,1,0,1,212,21.2,1,0,2,2,6.8,17197,14641,1464.1,-1080,-2622,1
6838,620,-226,1679.3,16793,17671,6.8,7,7,9,242,24.2,0,0,0,1,1,237,23.7,1,7,5,5,7.0,17897,16173,1617.3,226,-620,0
6839,-2690,-743,1498.2,14982,15862,6.6,5,5,5,171,17.1,1,0,0,1,0,187,18.7,0,14,10,10,6.6,16605,17672,1767.2,743,2690,1
6840,-219,-589,1638.5,16385,17327,6.6,6,6,4,215,21.5,2,1,1,0,0,199,19.9,0,15,8,8,6.8,17916,16604,1660.4,589,219,0
6841,754,159,1713.5,17135,18089,7.0,7,7,6,227,22.7,0,0,1,0,0,195,19.5,0,9,6,6,6.8,17930,16381,1638.1,-159,-754,1
6842,1077,1096,1689.4,16894,18333,7.2,8,8,15,219,21.9,0,0,0,1,0,208,20.8,0,4,4,4,6.8,17237,15817,1581.7,-1096,-1077,1
6843,840,2240,1686.9,16869,19165,7.2,6,6,8,232,23.2,1,1,0,1,0,210,21.0,1,5,4,4,6.8,16925,16029,1602.9,-2240,-840,1
6844,317,944,1720.1,17201,17805,7.0,7,7,10,221,22.1,1,1,1,0,0,174,17.4,0,9,8,8,6.8,16861,16884,1688.4,-944,-317,1
6845,1040,1194,1686.4,16864,18073,7.0,7,7,8,224,22.4,1,1,1,0,0,198,19.8,0,3,5,5,6.6,16879,15824,1582.4,-1194,-1040,1
6846,2495,3183,1843.2,18432,19560,7.2,12,12,8,224,22.4,1,1,1,0,0,193,19.3,0,8,6,6,6.8,16377,15937,1593.7,-3183,-2495,1
6847,672,411,1723.2,17232,18525,7.2,7,7,6,238,23.8,0,0,1,0,1,210,21.0,1,13,6,6,7.0,18114,16560,1656.0,-411,-672,1
6848,2765,2798,1870.4,18704,19748,7.4,12,12,13,223,22.3,1,1,1,0,0,233,23.3,0,5,6,6,6.8,16950,15939,1593.9,-2798,-2765,1
6849,1448,-664,1681.8,16818,16961,6.8,6,6,8,204,20.4,0,0,0,1,1,250,25.0,1,2,2,2,7.0,17625,15370,1537.0,664,-1448,1
6850,-997,-330,1659.5,16595,18645,7.2,7,7,8,231,23.1,0,0,0,1,0,225,22.5,0,11,9,9,7.2,18975,17592,1759.2,330,997,0
6851,3031,1196,1759.2,17592,19904,7.6,6,6,6,259,25.9,0,0,1,0,0,224,22.4,0,1,1,1,7.2,18708,14561,1456.1,-1196,-3031,1
6852,2009,2090,1777.5,17775,19408,7.2,8,8,10,256,25.6,1,1,0,1,0,248,24.8,0,2,3,3,6.6,17318,15766,1576.6,-2090,-2009,1
6853,-2378,-478,1581.7,15817,18561,7.2,5,5,3,212,21.2,0,0,0,1,1,226,22.6,1,10,8,8,7.2,19039,18195,1819.5,478,2378,0
6854,-3561,-1911,1622.2,16222,16170,6.6,7,7,10,184,18.4,1,0,0,1,1,237,23.7,1,17,12,12,6.8,18081,19783,1978.3,1911,3561,0
6855,-700,-1628,1645.1,16451,18027,6.8,3,3,2,234,23.4,1,1,1,0,0,222,22.2,0,12,8,8,7.2,19655,17151,1715.1,1628,700,0
6856,5305,4619,1990.4,19904,21324,7.6,10,10,3,272,27.2,2,1,1,0,0,210,21.0,0,3,3,3,6.6,16705,14599,1459.9,-4619,-5305,1
6857,-47,487,1690.7,16907,17497,6.8,8,8,14,185,18.5,0,0,0,1,0,219,21.9,0,8,8,8,6.6,17010,16954,1695.4,-487,47,1
6858,-5040,-1496,1372.8,13728,16556,6.6,0,0,0,211,21.1,0,0,0,1,0,239,23.9,0,8,8,8,6.6,18052,18768,1876.8,1496,5040,0
6859,-2808,-1555,1432.4,14324,16390,6.4,3,3,4,217,21.7,0,0,1,0,0,231,23.1,0,12,8,8,7.0,17945,17132,1713.2,1555,2808,0
6860,-1409,-16,1517.5,15175,17282,6.8,2,2,4,214,21.4,1,1,0,1,0,234,23.4,0,5,6,6,6.8,17298,16584,1658.4,16,1409,0
6861,-4316,-2717,1410.8,14108,16327,6.4,3,3,4,188,18.8,0,0,0,1,1,262,26.2,2,7,8,8,7.4,19044,18424,1842.4,2717,4316,0
6862,640,411,1823.9,18239,19135,7.2,9,9,8,228,22.8,1,1,1,0,0,240,24.0,0,8,8,8,7.2,18724,17599,1759.9,-411,-640,0
6863,5174,3105,1817.8,18178,18563,7.0,8,8,11,233,23.3,1,1,1,0,0,182,18.2,0,0,1,1,6.2,15458,13004,1300.4,-3105,-5174,1
6864,458,2243,1571.1,15711,18516,6.8,6,6,3,196,19.6,2,1,1,0,0,219,21.9,0,4,5,5,6.6,16273,15253,1525.3,-2243,-458,1
6865,5525,3383,2066.6,20666,19611,7.2,13,13,18,220,22.0,1,1,1,0,0,185,18.5,0,7,6,6,6.6,16228,15141,1514.1,-3383,-5525,1
6866,1900,1732,1572.1,15721,17894,6.8,6,6,6,203,20.3,1,1,0,1,0,187,18.7,0,0,2,2,6.4,16162,13821,1382.1,-1732,-1900,1
6867,-488,-1312,1610.0,16100,16520,6.6,7,7,9,189,18.9,1,1,1,0,0,240,24.0,0,7,5,5,7.0,17832,16588,1658.8,1312,488,1
6868,-2936,-2856,1501.7,15017,16114,6.6,4,4,3,203,20.3,0,0,1,0,1,232,23.2,1,12,11,11,7.2,18970,17953,1795.3,2856,2936,0
6869,-4907,-2874,1377.1,13771,16290,6.8,3,3,4,174,17.4,0,0,0,1,1,241,24.1,1,12,9,9,7.2,19164,18678,1867.8,2874,4907,1
6870,744,461,1706.1,17061,18530,7.0,9,9,7,197,19.7,0,0,0,1,0,178,17.8,0,14,8,8,7.0,18069,16317,1631.7,-461,-744,0
6871,422,-758,1699.3,16993,18935,7.2,6,6,10,262,26.2,1,1,1,0,0,254,25.4,0,6,4,4,7.4,19693,16571,1657.1,758,-422,1
6872,-1171,-1157,1412.7,14127,16566,6.6,3,3,6,186,18.6,0,0,0,1,1,233,23.3,1,4,3,3,6.6,17723,15298,1529.8,1157,1171,1
6873,-2907,-1376,1610.0,16100,17451,7.0,6,6,7,192,19.2,1,0,0,1,1,260,26.0,1,9,10,10,7.2,18827,19007,1900.7,1376,2907,1
6874,164,486,1622.9,16229,18988,7.2,6,6,5,200,20.0,1,1,1,0,0,230,23.0,0,4,4,4,7.2,18502,16065,1606.5,-486,-164,1
6875,81,1865,1572.4,15724,17512,6.8,6,6,5,217,21.7,0,0,0,1,1,219,21.9,1,7,4,4,6.4,15647,15643,1564.3,-1865,-81,1
6876,485,219,1722.2,17222,19032,7.2,7,7,4,216,21.6,1,1,1,0,0,202,20.2,0,7,8,8,7.0,18813,16737,1673.7,-219,-485,1
6877,609,-19,1902.0,19020,18128,6.8,10,10,14,216,21.6,1,1,1,0,0,221,22.1,1,14,11,11,6.8,18147,18411,1841.1,19,-609,0
6878,6658,6189,1984.7,19847,20768,7.2,10,10,10,250,25.0,2,1,1,0,0,166,16.6,0,2,1,1,6.2,14579,13189,1318.9,-6189,-6658,1
6879,-3082,-1694,1481.4,14814,16691,6.8,3,3,4,216,21.6,1,0,0,1,1,242,24.2,1,4,5,5,6.8,18385,17896,1789.6,1694,3082,0
6880,-3255,-1798,1500.2,15002,15784,6.4,7,7,4,170,17.0,0,0,0,1,1,240,24.0,1,10,9,9,7.0,17582,18257,1825.7,1798,3255,0
6881,2897,3195,1760.5,17605,19955,7.2,8,8,8,247,24.7,0,0,1,0,0,223,22.3,0,2,3,3,6.6,16760,14708,1470.8,-3195,-2897,1
6882,-3041,-1317,1450.2,14502,17558,6.8,3,3,0,213,21.3,0,0,0,1,1,223,22.3,2,7,9,9,7.0,18875,17543,1754.3,1317,3041,0
6883,-4196,-1649,1459.9,14599,17147,6.8,2,2,4,220,22.0,0,0,0,1,0,244,24.4,1,7,9,9,7.0,18796,18795,1879.5,1649,4196,0
6884,-2755,-2255,1368.6,13686,16575,6.8,1,1,3,213,21.3,0,0,0,1,1,230,23.0,2,4,5,5,7.2,18830,16441,1644.1,2255,2755,0
6885,973,825,1644.9,16449,17858,6.8,5,5,5,207,20.7,0,0,0,1,0,192,19.2,0,8,6,6,6.8,17033,15476,1547.6,-825,-973,0
6886,5638,3250,2178.3,21783,20533,7.6,13,13,12,244,24.4,1,0,1,0,0,167,16.7,0,7,7,7,6.8,17283,16145,1614.5,-3250,-5638,1
6887,-430,159,1586.7,15867,17569,7.0,6,6,7,210,21.0,0,0,0,1,0,203,20.3,1,5,6,6,6.8,17410,16297,1629.7,-159,430,0
6888,-2212,-1682,1588.9,15889,17078,6.8,8,8,5,177,17.7,2,1,0,1,0,212,21.2,0,8,9,9,7.2,18760,18101,1810.1,1682,2212,0
6889,1575,-516,1698.8,16988,18623,7.2,7,7,6,196,19.6,1,1,1,0,0,224,22.4,0,1,4,4,7.2,19139,15413,1541.3,516,-1575,1
6890,1067,1824,1607.6,16076,18917,7.2,5,5,5,245,24.5,0,0,0,1,0,235,23.5,0,2,3,3,6.8,17093,15009,1500.9,-1824,-1067,1
6891,6578,5388,2216.2,22162,21254,7.8,13,13,13,249,24.9,2,1,0,1,0,156,15.6,0,7,6,6,6.2,15866,15584,1558.4,-5388,-6578,1
6892,-767,-606,1517.8,15178,18172,7.0,3,3,4,209,20.9,1,1,0,1,0,229,22.9,1,4,4,4,7.0,18778,15945,1594.5,606,767,1
6893,-2560,-826,1519.6,15196,16925,6.6,6,6,6,188,18.8,0,0,0,1,1,211,21.1,1,18,9,9,7.0,17751,17756,1775.6,826,2560,0
6894,-226,-157,1560.0,15600,17354,6.8,4,4,3,229,22.9,0,0,1,0,0,191,19.1,0,6,5,5,6.6,17511,15826,1582.6,157,226,1
6895,1468,932,1674.2,16742,19145,7.4,7,7,5,215,21.5,2,1,1,0,0,247,24.7,0,2,3,3,7.2,18213,15274,1527.4,-932,-1468,1
6896,-502,-1113,1558.0,15580,17286,6.6,5,5,3,197,19.7,0,0,0,1,0,197,19.7,1,4,6,6,7.2,18399,16082,1608.2,1113,502,0
6897,-1090,555,1611.1,16111,17724,6.8,5,5,7,211,21.1,1,0,0,1,1,196,19.6,1,16,7,7,7.0,17169,17201,1720.1,-555,1090,1
6898,-1793,-1226,1540.4,15404,17893,7.0,3,3,3,244,24.4,0,0,0,1,1,254,25.4,1,7,5,5,7.0,19119,17197,1719.7,1226,1793,0
6899,-4470,-3848,1514.7,15147,15110,6.4,5,5,6,201,20.1,0,0,0,1,1,193,19.3,1,20,15,15,7.4,18958,19617,1961.7,3848,4470,0
6900,2107,2032,1705.8,17058,18736,7.2,11,11,11,178,17.8,2,1,1,0,0,211,21.1,0,1,5,5,6.6,16704,14951,1495.1,-2032,-2107,1
6901,-5489,-3743,1412.9,14129,16038,6.6,4,4,3,174,17.4,0,0,0,1,1,185,18.5,1,21,13,13,7.4,19781,19618,1961.8,3743,5489,0
6902,1079,1363,1636.8,16368,18622,7.0,5,5,4,250,25.0,0,0,0,1,1,206,20.6,1,7,5,5,7.0,17259,15289,1528.9,-1363,-1079,1
6903,-2268,-1851,1557.7,15577,16808,6.6,4,4,5,235,23.5,1,0,0,1,1,239,23.9,1,7,8,8,7.0,18659,17845,1784.5,1851,2268,0
6904,339,261,1710.2,17102,18327,7.2,9,9,10,207,20.7,1,1,1,0,0,252,25.2,1,10,7,7,6.8,18066,16763,1676.3,-261,-339,0
6905,-3016,-3479,1432.3,14323,15853,6.4,3,3,3,206,20.6,0,0,0,1,1,235,23.5,1,4,9,9,7.0,19332,17339,1733.9,3479,3016,0
6906,70,409,1580.7,15807,18131,7.0,5,5,5,219,21.9,1,1,1,0,0,221,22.1,0,8,4,4,7.0,17722,15737,1573.7,-409,-70,1
6907,-3562,-3319,1498.8,14988,15585,6.2,5,5,4,186,18.6,0,0,1,0,0,208,20.8,0,20,13,13,7.2,18904,18550,1855.0,3319,3562,0
6908,-2815,-1204,1505.1,15051,17519,6.8,2,2,1,220,22.0,1,0,0,1,0,236,23.6,0,8,7,7,7.2,18723,17866,1786.6,1204,2815,0
6909,-371,-444,1564.1,15641,18490,7.0,3,3,4,261,26.1,1,1,1,0,0,209,20.9,0,7,7,7,7.0,18934,16012,1601.2,444,371,1
6910,911,713,1671.5,16715,19011,7.0,9,9,4,227,22.7,0,0,1,0,1,191,19.1,1,5,4,4,6.8,18298,15804,1580.4,-713,-911,1
6911,2514,1424,1842.3,18423,18773,7.2,10,10,11,212,21.2,0,0,1,0,0,200,20.0,1,6,7,7,6.8,17349,15909,1590.9,-1424,-2514,1
6912,-282,-740,1528.9,15289,16346,6.4,4,4,4,193,19.3,1,1,1,0,0,197,19.7,0,6,6,6,6.8,17086,15571,1557.1,740,282,1
6913,-2287,-735,1446.7,14467,17728,7.0,3,3,0,220,22.0,0,0,0,1,1,218,21.8,1,6,7,7,7.0,18463,16754,1675.4,735,2287,0
6914,-590,558,1554.4,15544,18418,7.0,3,3,5,236,23.6,1,1,0,1,0,228,22.8,1,1,1,1,6.8,17860,16134,1613.4,-558,590,0
6915,-1625,-2061,1474.3,14743,17174,6.8,2,2,4,228,22.8,0,0,0,1,1,239,23.9,2,8,5,5,7.4,19235,16368,1636.8,2061,1625,0
6916,-3236,-2874,1459.1,14591,16795,6.8,3,3,3,224,22.4,1,1,0,1,0,252,25.2,1,8,8,8,7.4,19669,17827,1782.7,2874,3236,1
6917,2048,1050,1878.7,18787,18788,7.2,10,10,10,212,21.2,0,0,1,0,0,228,22.8,0,7,6,6,7.0,17738,16739,1673.9,-1050,-2048,1
6918,-1141,-630,1667.1,16671,17530,7.0,8,8,11,181,18.1,0,0,1,0,0,216,21.6,1,5,10,10,6.8,18160,17812,1781.2,630,1141,0
6919,1167,-814,1713.4,17134,17172,6.8,8,8,12,222,22.2,1,1,1,0,0,221,22.1,0,6,4,4,6.8,17986,15967,1596.7,814,-1167,0
6920,-1502,-959,1499.6,14996,16234,6.4,3,3,5,221,22.1,0,0,0,1,0,229,22.9,0,13,7,7,6.8,17193,16498,1649.8,959,1502,0
6921,3259,2282,1761.0,17610,17839,6.8,7,7,14,236,23.6,1,0,1,0,1,199,19.9,1,6,4,4,6.4,15557,14351,1435.1,-2282,-3259,1
6922,-1085,-1716,1730.2,17302,17065,6.8,9,9,5,197,19.7,1,1,0,1,0,208,20.8,0,9,10,10,7.2,18781,18387,1838.7,1716,1085,1
6923,-147,273,1687.7,16877,18403,7.0,6,6,6,203,20.3,1,1,0,1,0,214,21.4,0,7,8,8,6.8,18130,17024,1702.4,-273,147,0
6924,-3070,-3027,1621.8,16218,15119,6.0,9,9,9,154,15.4,1,1,0,1,0,194,19.4,1,12,12,12,7.0,18146,19288,1928.8,3027,3070,0
6925,-638,1771,1568.0,15680,17983,6.8,5,5,8,201,20.1,1,1,0,1,0,219,21.9,0,12,7,7,6.6,16212,16318,1631.8,-1771,638,0
6926,-1245,-971,1607.0,16070,17613,6.6,6,6,6,194,19.4,0,0,0,1,1,237,23.7,1,10,7,7,7.0,18584,17315,1731.5,971,1245,1
6927,-1002,-2319,1526.7,15267,17008,6.8,4,4,5,212,21.2,0,0,1,0,0,209,20.9,1,9,7,7,7.0,19327,16269,1626.9,2319,1002,0
6928,-2094,-2508,1489.4,14894,16548,6.6,1,1,0,244,24.4,1,1,1,0,0,230,23.0,0,7,4,4,7.0,19056,16988,1698.8,2508,2094,1
6929,-3892,-2725,1359.8,13598,15349,6.2,2,2,2,189,18.9,0,0,0,1,1,223,22.3,1,7,7,7,7.0,18074,17490,1749.0,2725,3892,0
6930,-991,-136,1537.3,15373,18554,7.2,3,3,3,225,22.5,0,0,0,1,1,220,22.0,1,8,6,6,7.2,18690,16364,1636.4,136,991,0
6931,-1791,-1671,1626.0,16260,16989,6.8,6,6,6,211,21.1,0,0,0,1,0,192,19.2,0,13,12,12,7.0,18660,18051,1805.1,1671,1791,1
6932,1797,1094,1689.4,16894,17731,7.0,8,8,7,205,20.5,0,0,0,1,1,190,19.0,1,5,6,6,6.6,16637,15097,1509.7,-1094,-1797,1
6933,680,-704,1795.1,17951,18517,6.8,8,8,9,219,21.9,0,0,1,0,1,216,21.6,1,9,8,8,7.2,19221,17271,1727.1,704,-680,0
6934,-2327,-2471,1505.4,15054,16739,6.8,4,4,5,204,20.4,0,0,0,1,0,209,20.9,0,8,9,9,7.2,19210,17381,1738.1,2471,2327,0
6935,-4379,-3811,1379.1,13791,16220,6.6,2,2,2,199,19.9,0,0,0,1,0,250,25.0,0,6,9,9,7.4,20031,18170,1817.0,3811,4379,0
6936,1528,-104,1734.8,17348,16417,6.6,9,9,16,191,19.1,0,0,1,0,1,191,19.1,1,7,6,6,6.6,16521,15820,1582.0,104,-1528,1
6937,-438,-634,1657.3,16573,17651,6.8,8,8,7,219,21.9,1,1,0,1,0,245,24.5,0,7,7,7,7.2,18285,17011,1701.1,634,438,1
6938,1547,611,1714.9,17149,17975,7.0,7,7,8,247,24.7,0,0,1,0,0,210,21.0,0,8,5,5,6.8,17364,15602,1560.2,-611,-1547,0
6939,-566,-1162,1602.4,16024,18727,7.0,5,5,3,228,22.8,1,1,1,0,0,229,22.9,0,8,6,6,7.2,19889,16590,1659.0,1162,566,0
6940,1418,1328,1636.8,16368,18776,7.2,6,6,6,204,20.4,0,0,1,0,1,194,19.4,1,4,4,4,6.8,17448,14950,1495.0,-1328,-1418,1
6941,2556,3518,1835.1,18351,19205,7.0,9,9,7,222,22.2,0,0,1,0,1,170,17.0,1,11,7,7,6.6,15687,15795,1579.5,-3518,-2556,1
6942,-4107,-3090,1404.4,14044,16385,6.8,1,1,1,231,23.1,1,0,0,1,1,234,23.4,1,12,8,8,7.4,19475,18151,1815.1,3090,4107,0
6943,-2536,-2343,1585.5,15855,17383,6.8,6,6,8,204,20.4,1,1,1,0,0,218,21.8,0,11,11,11,7.0,19726,18391,1839.1,2343,2536,1
6944,3471,2708,1930.1,19301,19342,7.2,10,10,8,212,21.2,1,1,1,0,0,197,19.7,0,5,7,7,6.6,16634,15830,1583.0,-2708,-3471,1
6945,196,-183,1553.0,15530,17181,6.8,3,3,2,221,22.1,1,1,1,0,0,202,20.2,1,4,5,5,7.0,17364,15334,1533.4,183,-196,1
6946,-2433,-1687,1463.7,14637,17706,6.8,3,3,1,193,19.3,0,0,1,0,0,223,22.3,0,3,8,8,7.2,19393,17070,1707.0,1687,2433,0
6947,-1352,-1180,1531.2,15312,15636,6.4,7,7,6,167,16.7,0,0,1,0,1,220,22.0,1,7,8,8,6.4,16816,16664,1666.4,1180,1352,0
6948,1715,1973,1767.7,17677,19493,7.2,8,8,7,233,23.3,1,1,0,1,0,198,19.8,0,8,5,5,7.2,17520,15962,1596.2,-1973,-1715,1
6949,3634,2422,1868.9,18689,19882,7.2,9,9,10,235,23.5,0,0,1,0,0,223,22.3,0,1,4,4,6.6,17460,15055,1505.5,-2422,-3634,1
6950,801,-1533,1700.8,17008,16636,6.8,8,8,18,206,20.6,0,0,1,0,0,223,22.3,0,6,6,6,7.0,18169,16207,1620.7,1533,-801,0
6951,-1047,-1618,1565.8,15658,17569,7.0,5,5,7,224,22.4,0,0,1,0,0,251,25.1,0,5,5,5,7.2,19187,16705,1670.5,1618,1047,0
6952,-1575,-1224,1431.8,14318,16916,6.6,5,5,2,180,18.0,0,0,0,1,1,193,19.3,1,5,7,7,7.0,18140,15893,1589.3,1224,1575,0
6953,-867,62,1626.2,16262,17436,6.8,8,8,10,186,18.6,1,1,0,1,0,212,21.2,0,11,9,9,7.0,17374,17129,1712.9,-62,867,0
6954,-6105,-4065,1565.3,15653,16813,6.4,6,6,8,158,15.8,0,0,0,1,0,223,22.3,0,13,15,15,7.8,20878,21758,2175.8,4065,6105,0
6955,-2080,-1117,1590.8,15908,16828,6.8,5,5,3,211,21.1,1,1,0,1,0,247,24.7,0,10,9,9,7.0,17945,17988,1798.8,1117,2080,0
6956,322,1377,1588.4,15884,19448,7.2,5,5,3,241,24.1,2,1,0,1,0,236,23.6,0,3,3,3,7.2,18071,15562,1556.2,-1377,-322,1
6957,2105,2310,1739.9,17399,20087,7.4,7,7,3,245,24.5,0,0,1,0,0,205,20.5,0,5,4,4,7.0,17777,15294,1529.4,-2310,-2105,1
6958,1873,883,1789.2,17892,18969,7.2,9,9,12,215,21.5,0,0,0,1,1,249,24.9,1,2,3,3,7.0,18086,16019,1601.9,-883,-1873,0
6959,3294,1808,1834.8,18348,19343,7.2,11,11,19,226,22.6,1,1,1,0,0,218,21.8,0,3,3,3,6.8,17535,15054,1505.4,-1808,-3294,1
6960,-3045,-1380,1428.7,14287,17457,6.6,2,2,3,225,22.5,0,0,0,1,1,261,26.1,2,7,6,6,7.2,18837,17332,1733.2,1380,3045,0
6961,-1307,-814,1602.4,16024,15686,6.4,6,6,7,202,20.2,1,1,0,1,0,201,20.1,0,21,10,10,6.6,16500,17331,1733.1,814,1307,0
6962,1116,1123,1703.9,17039,19626,7.4,5,5,4,261,26.1,0,0,0,1,1,221,22.1,1,3,4,4,7.0,18503,15923,1592.3,-1123,-1116,0
6963,24,983,1782.7,17827,18573,7.2,9,9,10,216,21.6,0,0,1,0,0,204,20.4,1,11,10,10,6.8,17590,17803,1780.3,-983,-24,1
6964,707,1960,1681.9,16819,18725,7.2,7,7,5,239,23.9,1,1,0,1,0,198,19.8,0,3,4,4,6.8,16765,16112,1611.2,-1960,-707,1
6965,-4681,-2497,1370.9,13709,15514,6.4,2,2,1,199,19.9,0,0,0,1,1,230,23.0,1,18,9,9,7.0,18011,18390,1839.0,2497,4681,0
6966,-3924,-3699,1544.2,15442,17142,6.8,4,4,2,204,20.4,0,0,0,1,1,254,25.4,2,6,8,8,7.6,20841,19366,1936.6,3699,3924,0
6967,-844,-1002,1499.6,14996,17555,6.8,1,1,2,232,23.2,0,0,0,1,1,230,23.0,1,5,4,4,7.2,18557,15840,1584.0,1002,844,0
6968,-2368,-250,1532.5,15325,17258,6.8,2,2,3,238,23.8,1,0,0,1,1,201,20.1,1,14,9,9,7.0,17508,17693,1769.3,250,2368,0
6969,-3789,-4083,1396.7,13967,15942,6.6,1,1,2,196,19.6,0,0,1,0,0,223,22.3,0,13,8,8,7.4,20025,17756,1775.6,4083,3789,0
6970,-2798,-2403,1503.2,15032,16226,6.8,3,3,4,221,22.1,0,0,1,0,1,215,21.5,2,5,8,8,7.0,18629,17830,1783.0,2403,2798,0
6971,3387,2782,1904.5,19045,20131,7.4,11,11,9,227,22.7,1,1,1,0,0,187,18.7,0,8,6,6,6.8,17349,15658,1565.8,-2782,-3387,1
6972,-758,-392,1582.0,15820,18001,7.0,4,4,7,242,24.2,0,0,0,1,1,229,22.9,2,4,5,5,7.2,18393,16578,1657.8,392,758,0
6973,-3203,-2199,1453.6,14536,15452,6.6,3,3,3,201,20.1,0,0,0,1,0,212,21.2,0,8,10,10,7.2,17651,17739,1773.9,2199,3203,0
6974,3246,1680,1683.3,16833,18765,7.0,5,5,5,244,24.4,2,1,1,0,0,219,21.9,0,0,1,1,6.6,17085,13587,1358.7,-1680,-3246,1
6975,-1412,-405,1648.3,16483,16652,6.8,8,8,8,186,18.6,0,0,0,1,1,208,20.8,1,18,11,11,6.8,17057,17895,1789.5,405,1412,1
6976,3502,3747,1748.3,17483,20101,7.8,9,9,8,239,23.9,0,0,1,0,0,214,21.4,0,2,1,1,6.6,16354,13981,1398.1,-3747,-3502,1
6977,-2884,-3321,1440.0,14400,16399,6.4,1,1,1,215,21.5,0,0,0,1,1,239,23.9,1,5,7,7,7.2,19720,17284,1728.4,3321,2884,0
6978,2479,1210,1866.1,18661,18012,6.8,12,12,12,197,19.7,2,1,1,0,0,203,20.3,0,6,6,6,6.6,16802,16182,1618.2,-1210,-2479,1
6979,1835,1172,1760.3,17603,18424,7.0,8,8,8,224,22.4,0,0,1,0,1,186,18.6,2,7,5,5,6.8,17252,15768,1576.8,-1172,-1835,1
6980,-5479,-3332,1364.3,13643,16564,6.6,1,1,0,199,19.9,0,0,0,1,0,226,22.6,0,12,11,11,7.2,19896,19122,1912.2,3332,5479,0
6981,-1957,-963,1622.8,16228,17098,6.6,5,5,5,232,23.2,0,0,0,1,1,188,18.8,2,14,11,11,7.0,18061,18185,1818.5,963,1957,0
6982,1949,214,1805.0,18050,19654,7.4,9,9,9,239,23.9,2,1,1,0,0,214,21.4,0,2,6,6,7.0,19440,16101,1610.1,-214,-1949,0
6983,-1729,-2105,1600.7,16007,17474,6.8,5,5,6,206,20.6,0,0,1,0,1,209,20.9,2,8,8,8,7.4,19579,17736,1773.6,2105,1729,0
6984,3112,535,1797.9,17979,17675,7.0,10,10,8,194,19.4,1,1,1,0,0,189,18.9,0,2,5,5,6.4,17140,14867,1486.7,-535,-3112,1
6985,-1462,-607,1555.2,15552,18535,7.0,3,3,3,240,24.0,1,0,0,1,1,245,24.5,1,7,6,6,7.0,19142,17014,1701.4,607,1462,0
6986,3293,987,1885.0,18850,17995,6.8,12,12,16,216,21.6,0,0,1,0,0,210,21.0,0,7,6,6,6.8,17008,15557,1555.7,-987,-3293,1
6987,-1723,-2525,1469.8,14698,16625,6.6,3,3,3,224,22.4,0,0,0,1,1,216,21.6,1,4,7,7,7.0,19150,16421,1642.1,2525,1723,0
6988,-5199,-3608,1345.6,13456,16144,6.6,2,2,1,164,16.4,0,0,0,1,1,245,24.5,1,8,10,10,7.4,19752,18655,1865.5,3608,5199,0
6989,441,-233,1677.7,16777,18671,6.8,4,4,4,243,24.3,1,0,1,0,1,251,25.1,1,5,4,4,7.2,18904,16336,1633.6,233,-441,0
6990,2994,2952,1914.6,19146,19236,7.4,12,12,13,214,21.4,0,0,1,0,1,175,17.5,1,7,7,7,6.6,16284,16152,1615.2,-2952,-2994,1
6991,850,2442,1802.7,18027,18601,6.8,10,10,7,212,21.2,0,0,1,0,1,174,17.4,1,16,11,11,6.4,16159,17177,1717.7,-2442,-850,0
6992,1227,1050,1761.2,17612,18342,6.8,11,11,9,212,21.2,1,0,0,1,0,169,16.9,0,5,6,6,6.8,17292,16385,1638.5,-1050,-1227,1
6993,-1936,-2432,1410.2,14102,16718,6.6,0,0,0,225,22.5,0,0,0,1,1,236,23.6,1,4,4,4,7.2,19150,16038,1603.8,2432,1936,0
6994,3330,3501,1800.0,18000,18718,7.0,13,13,11,214,21.4,1,1,0,1,0,209,20.9,0,3,3,3,6.2,15217,14670,1467.0,-3501,-3330,1
6995,-271,99,1661.3,16613,17888,6.8,8,8,7,229,22.9,1,1,1,0,0,232,23.2,0,4,8,8,6.8,17789,16884,1688.4,-99,271,1
6996,3249,1410,1790.3,17903,19614,7.4,8,8,11,216,21.6,2,1,1,0,0,231,23.1,0,1,2,2,7.0,18204,14654,1465.4,-1410,-3249,1
6997,1227,2404,1790.7,17907,19004,7.4,10,10,8,203,20.3,0,0,0,1,0,218,21.8,0,11,5,5,6.6,16600,16680,1668.0,-2404,-1227,1
6998,-1260,-1183,1600.2,16002,17397,6.8,8,8,6,177,17.7,1,1,0,1,0,209,20.9,0,13,8,8,7.0,18580,17262,1726.2,1183,1260,0
6999,-1631,-1140,1481.6,14816,17070,6.8,4,4,4,204,20.4,1,1,1,0,0,239,23.9,0,9,6,6,6.8,18210,16447,1644.7,1140,1631,0
7000,517,222,1609.3,16093,19191,7.2,5,5,4,245,24.5,1,1,0,1,0,213,21.3,0,1,3,3,7.0,18969,15576,1557.6,-222,-517,1
7001,2258,-819,1823.9,18239,17409,7.0,8,8,8,199,19.9,2,1,1,0,0,211,21.1,0,5,6,6,7.0,18228,15981,1598.1,819,-2258,1
7002,416,936,1696.9,16969,18552,7.0,9,9,8,181,18.1,0,0,1,0,1,231,23.1,1,4,7,7,6.8,17616,16553,1655.3,-936,-416,0
7003,4633,3451,1859.6,18596,19244,7.0,6,6,5,254,25.4,2,1,1,0,0,192,19.2,0,3,3,3,6.6,15793,13963,1396.3,-3451,-4633,1
7004,-816,-1189,1570.2,15702,17467,7.0,4,4,7,230,23.0,1,1,1,0,0,224,22.4,0,7,6,6,7.2,18656,16518,1651.8,1189,816,0
7005,-390,-52,1588.5,15885,18620,7.2,3,3,3,252,25.2,0,0,0,1,1,258,25.8,1,4,4,4,7.2,18672,16275,1627.5,52,390,0
7006,-2888,-1772,1529.2,15292,17766,6.8,6,6,4,190,19.0,1,0,0,1,1,231,23.1,1,11,10,10,7.2,19538,18180,1818.0,1772,2888,1
7007,1284,395,1584.3,15843,18349,7.2,4,4,4,236,23.6,0,0,1,0,1,204,20.4,1,1,2,2,7.0,17954,14559,1455.9,-395,-1284,1
7008,-1437,-770,1602.8,16028,18310,7.0,5,5,5,216,21.6,1,1,0,1,0,259,25.9,0,9,7,7,7.0,19080,17465,1746.5,770,1437,0
7009,-1012,-316,1571.8,15718,16225,6.6,7,7,9,159,15.9,1,1,0,1,0,192,19.2,0,13,8,8,6.6,16541,16730,1673.0,316,1012,0
7010,202,1030,1737.8,17378,17926,6.8,11,11,13,167,16.7,1,1,0,1,0,203,20.3,1,9,9,9,7.0,16896,17176,1717.6,-1030,-202,0
7011,2944,3092,1735.4,17354,19609,7.4,6,6,6,263,26.3,1,1,1,0,0,232,23.2,0,2,2,2,6.4,16517,14410,1441.0,-3092,-2944,1
7012,3614,3374,1971.8,19718,20453,7.6,13,13,13,215,21.5,1,1,0,1,0,192,19.2,1,3,7,7,6.6,17079,16104,1610.4,-3374,-3614,1
7013,4733,1669,2024.5,20245,18815,7.2,11,11,9,245,24.5,1,1,0,1,0,182,18.2,0,8,5,5,6.8,17146,15512,1551.2,-1669,-4733,1
7014,-4369,-3324,1586.9,15869,16808,6.8,7,7,2,162,16.2,0,0,0,1,1,242,24.2,1,23,12,12,7.6,20132,20238,2023.8,3324,4369,0
7015,-4562,-2816,1532.1,15321,16450,6.2,4,4,3,198,19.8,0,0,0,1,0,222,22.2,1,12,13,13,7.2,19266,19883,1988.3,2816,4562,0
7016,-176,351,1629.3,16293,18611,7.2,8,8,5,218,21.8,0,0,1,0,0,203,20.3,0,5,6,6,7.0,18260,16469,1646.9,-351,176,0
7017,4456,2338,1966.9,19669,19333,7.4,10,10,12,220,22.0,2,1,1,0,0,196,19.6,0,3,6,6,6.6,16995,15213,1521.3,-2338,-4456,1
7018,-492,175,1709.3,17093,18200,7.0,7,7,2,217,21.7,1,1,0,1,0,214,21.4,0,10,10,10,7.0,18025,17585,1758.5,-175,492,0
7019,4612,3848,1743.4,17434,18954,7.2,5,5,4,257,25.7,1,1,1,0,0,203,20.3,0,0,0,0,6.4,15106,12822,1282.2,-3848,-4612,1
7020,-1461,241,1425.0,14250,17406,6.8,1,1,0,238,23.8,0,0,0,1,1,228,22.8,2,5,5,5,6.6,17165,15711,1571.1,-241,1461,1
7021,2241,1077,1910.4,19104,17733,7.0,12,12,13,204,20.4,1,0,1,0,1,200,20.0,1,11,9,9,6.8,16656,16863,1686.3,-1077,-2241,1
7022,2986,2450,1770.0,17700,18269,6.8,9,9,9,216,21.6,0,0,1,0,0,154,15.4,0,8,5,5,6.4,15819,14714,1471.4,-2450,-2986,0
7023,-423,716,1568.7,15687,18199,6.6,6,6,5,206,20.6,0,0,0,1,0,219,21.9,0,6,5,5,7.0,17483,16110,1611.0,-716,423,1
7024,218,-598,1586.6,15866,18127,7.0,4,4,6,221,22.1,0,0,1,0,1,219,21.9,1,4,4,4,7.2,18725,15648,1564.8,598,-218,1
7025,-1289,918,1607.9,16079,19081,7.0,6,6,7,203,20.3,2,1,0,1,0,264,26.4,0,8,7,7,6.8,18163,17368,1736.8,-918,1289,1
7026,4491,5575,1961.0,19610,20901,7.6,13,13,14,220,22.0,0,0,1,0,1,186,18.6,1,4,5,5,6.2,15326,15119,1511.9,-5575,-4491,1
7027,2296,773,1659.7,16597,17747,6.8,7,7,10,232,23.2,0,0,1,0,0,153,15.3,0,4,4,4,6.8,16974,14301,1430.1,-773,-2296,1
7028,-1807,-2118,1421.1,14211,17253,6.8,2,2,2,215,21.5,0,0,0,1,1,252,25.2,1,1,3,3,7.2,19371,16018,1601.8,2118,1807,0
7029,188,1159,1589.7,15897,19077,7.0,4,4,2,235,23.5,2,1,1,0,0,255,25.5,0,3,2,2,6.6,17918,15709,1570.9,-1159,-188,1
7030,-5057,-3921,1574.0,15740,14844,6.0,6,6,6,178,17.8,1,1,0,1,0,238,23.8,0,16,12,12,7.2,18765,20797,2079.7,3921,5057,0
7031,-815,-699,1717.0,17170,18831,7.4,6,6,8,237,23.7,1,1,0,1,0,244,24.4,0,9,9,9,7.2,19530,17985,1798.5,699,815,0
7032,-365,-434,1595.0,15950,17900,6.8,4,4,2,235,23.5,0,0,1,0,0,225,22.5,0,7,7,7,6.8,18334,16315,1631.5,434,365,1
7033,2964,2253,1799.0,17990,19289,7.0,9,9,7,226,22.6,0,0,1,0,1,232,23.2,1,4,3,3,6.4,17036,15026,1502.6,-2253,-2964,1
7034,362,889,1574.9,15749,19614,7.4,4,4,4,235,23.5,1,0,1,0,1,226,22.6,1,2,4,4,7.2,18725,15387,1538.7,-889,-362,0
7035,-1300,-120,1531.7,15317,16907,6.6,4,4,9,226,22.6,1,1,1,0,0,211,21.1,1,7,4,4,6.8,17027,16617,1661.7,120,1300,0
7036,1447,2623,1689.6,16896,19116,7.4,8,8,8,225,22.5,0,0,0,1,1,190,19.0,1,2,3,3,6.4,16493,15449,1544.9,-2623,-1447,1
7037,-2695,-152,1508.5,15085,17193,6.8,3,3,2,231,23.1,0,0,0,1,0,218,21.8,0,12,8,8,6.6,17345,17780,1778.0,152,2695,0
7038,1477,691,1779.0,17790,18908,7.0,9,9,8,203,20.3,1,0,1,0,0,208,20.8,0,4,6,6,7.0,18217,16313,1631.3,-691,-1477,1
7039,-2220,-1492,1524.5,15245,17542,6.8,4,4,6,210,21.0,1,1,0,1,0,218,21.8,0,5,7,7,7.2,19034,17465,1746.5,1492,2220,1
7040,3054,439,1865.4,18654,17865,7.0,9,9,10,226,22.6,2,1,1,0,0,221,22.1,0,5,4,4,6.8,17426,15600,1560.0,-439,-3054,0
7041,-1659,-874,1426.6,14266,18401,7.2,1,1,0,223,22.3,0,0,0,1,1,236,23.6,1,4,6,6,7.2,19275,15925,1592.5,874,1659,0
7042,1311,557,1774.2,17742,18190,6.8,9,9,10,185,18.5,0,0,1,0,1,232,23.2,1,6,6,6,7.0,17633,16431,1643.1,-557,-1311,1
7043,1677,809,1761.0,17610,18827,7.4,8,8,8,221,22.1,1,1,1,0,0,212,21.2,0,5,5,5,7.2,18018,15933,1593.3,-809,-1677,1
7044,-1110,-721,1592.1,15921,17466,6.8,5,5,4,203,20.3,0,0,0,1,0,215,21.5,0,6,8,8,7.2,18187,17031,1703.1,721,1110,0
7045,1293,-262,1686.0,16860,17641,7.0,7,7,9,218,21.8,0,0,0,1,0,219,21.9,0,2,4,4,6.8,17903,15567,1556.7,262,-1293,0
7046,-4256,-3319,1384.2,13842,15669,6.4,3,3,4,181,18.1,0,0,0,1,1,240,24.0,1,11,9,9,7.0,18988,18098,1809.8,3319,4256,0
7047,3268,2650,1737.8,17378,19405,7.4,9,9,8,253,25.3,1,1,0,1,0,212,21.2,0,3,2,2,6.4,16755,14110,1411.0,-2650,-3268,1
7048,1027,615,1597.9,15979,18795,7.2,5,5,4,260,26.0,1,1,0,1,0,219,21.9,0,4,3,3,7.0,18180,14952,1495.2,-615,-1027,1
7049,-1892,-2127,1547.5,15475,17551,7.0,4,4,3,216,21.6,0,0,1,0,1,211,21.1,1,9,8,8,7.4,19678,17367,1736.7,2127,1892,0
7050,2537,1396,1707.7,17077,16964,7.0,6,6,6,228,22.8,0,0,1,0,0,208,20.8,0,3,3,3,6.0,15568,14540,1454.0,-1396,-2537,1
7051,-3738,-1260,1429.4,14294,17770,7.0,3,3,1,206,20.6,0,0,0,1,1,229,22.9,2,8,8,8,7.2,19030,18032,1803.2,1260,3738,0
7052,-3966,-3112,1450.4,14504,16668,6.6,2,2,1,203,20.3,0,0,0,1,1,192,19.2,1,14,13,13,7.4,19780,18470,1847.0,3112,3966,0
7053,1382,2107,1802.2,18022,19347,7.4,10,10,7,202,20.2,0,0,0,1,0,186,18.6,1,11,10,10,6.6,17240,16640,1664.0,-2107,-1382,1
7054,-544,154,1539.0,15390,17555,7.0,3,3,5,230,23.0,2,1,1,0,0,216,21.6,0,4,6,6,6.8,17401,15934,1593.4,-154,544,0
7055,339,876,1725.1,17251,17267,6.6,8,8,8,192,19.2,0,0,0,1,0,203,20.3,0,7,6,6,6.4,16391,16912,1691.2,-876,-339,0
7056,-2284,-3219,1533.7,15337,17008,6.8,4,4,4,186,18.6,0,0,1,0,1,230,23.0,1,4,8,8,7.6,20227,17621,1762.1,3219,2284,0
7057,468,2091,1649.8,16498,18955,7.2,7,7,7,219,21.9,1,0,0,1,0,237,23.7,0,4,3,3,6.6,16864,16030,1603.0,-2091,-468,1
7058,3098,1882,1735.9,17359,18203,7.0,7,7,8,219,21.9,1,1,1,0,0,213,21.3,1,1,2,2,6.4,16321,14261,1426.1,-1882,-3098,1
7059,5797,4364,2034.6,20346,19902,7.4,12,12,14,228,22.8,0,0,1,0,1,203,20.3,1,3,3,3,6.2,15538,14549,1454.9,-4364,-5797,1
7060,1127,628,1771.1,17711,18722,7.0,7,7,8,238,23.8,1,1,0,1,0,246,24.6,0,8,5,5,7.0,18094,16584,1658.4,-628,-1127,0
7061,-494,-817,1508.9,15089,17046,6.8,4,4,6,213,21.3,0,0,0,1,1,216,21.6,2,4,4,4,6.8,17863,15583,1558.3,817,494,0
7062,-7278,-6021,1507.7,15077,15707,6.4,5,5,4,138,13.8,0,0,0,1,0,229,22.9,0,12,22,22,8.0,21728,22355,2235.5,6021,7278,0
7063,-859,-1502,1551.9,15519,17775,6.8,4,4,4,236,23.6,1,1,1,0,0,237,23.7,0,5,5,5,7.2,19277,16378,1637.8,1502,859,1
7064,-1761,-1446,1600.3,16003,17857,6.8,6,6,5,214,21.4,0,0,1,0,0,238,23.8,0,9,10,10,7.2,19303,17764,1776.4,1446,1761,1
7065,454,333,1627.0,16270,18684,7.0,4,4,5,248,24.8,0,0,1,0,1,257,25.7,1,2,2,2,7.0,18351,15816,1581.6,-333,-454,0
7066,39,-27,1791.7,17917,19033,7.2,8,8,7,234,23.4,0,0,0,1,1,180,18.0,1,13,11,11,7.2,19060,17878,1787.8,27,-39,0
7067,2420,2272,1809.9,18099,18989,7.0,9,9,9,238,23.8,0,0,0,1,1,218,21.8,1,4,4,4,6.6,16717,15679,1567.9,-2272,-2420,1
7068,-570,467,1607.3,16073,18021,7.0,6,6,8,196,19.6,1,1,1,0,0,215,21.5,0,10,6,6,6.8,17554,16643,1664.3,-467,570,1
7069,1323,46,1588.7,15887,17744,6.8,5,5,4,240,24.0,1,0,1,0,1,208,20.8,1,3,2,2,7.0,17698,14564,1456.4,-46,-1323,1
7070,-3299,-2719,1448.6,14486,15962,6.6,5,5,7,170,17.0,0,0,0,1,1,256,25.6,2,4,5,5,7.0,18681,17785,1778.5,2719,3299,0
7071,-1478,-1388,1463.5,14635,17734,7.0,2,2,4,235,23.5,0,0,1,0,0,246,24.6,0,2,5,5,7.2,19122,16113,1611.3,1388,1478,0
7072,4165,2230,1892.8,18928,18365,7.2,10,10,15,210,21.0,1,1,1,0,0,197,19.7,1,6,4,4,6.6,16135,14763,1476.3,-2230,-4165,1
7073,-2558,-828,1564.9,15649,17358,6.8,6,6,4,185,18.5,1,0,0,1,0,229,22.9,0,16,10,10,7.2,18186,18207,1820.7,828,2558,1
7074,473,1581,1629.1,16291,18127,7.2,7,7,7,227,22.7,0,0,0,1,0,220,22.0,0,7,5,5,6.6,16546,15818,1581.8,-1581,-473,1
7075,1284,1445,1652.3,16523,18465,7.0,6,6,5,238,23.8,1,1,1,0,0,239,23.9,0,2,3,3,6.8,17020,15239,1523.9,-1445,-1284,1
7076,-3847,-933,1508.4,15084,17618,6.8,3,3,1,188,18.8,1,0,0,1,1,232,23.2,1,11,10,10,6.8,18551,18931,1893.1,933,3847,0
7077,1136,376,1614.6,16146,17725,6.8,6,6,5,210,21.0,0,0,0,1,1,198,19.8,1,0,5,5,6.8,17349,15010,1501.0,-376,-1136,1
7078,2136,-50,1694.5,16945,17981,6.8,7,7,8,223,22.3,1,1,1,0,0,238,23.8,0,3,3,3,7.0,18031,14809,1480.9,50,-2136,1
7079,735,161,1660.0,16600,18970,7.0,6,6,5,208,20.8,0,0,1,0,1,252,25.2,1,0,4,4,7.2,18809,15865,1586.5,-161,-735,1
7080,-441,390,1694.1,16941,19352,7.0,5,5,5,228,22.8,1,1,0,1,0,233,23.3,0,8,6,6,7.2,18962,17382,1738.2,-390,441,1
7081,-152,-430,1586.2,15862,17707,6.8,6,6,6,227,22.7,1,1,0,1,0,210,21.0,1,11,6,6,6.8,18137,16014,1601.4,430,152,1
7082,1924,1992,1852.6,18526,19693,7.4,10,10,11,222,22.2,2,1,0,1,0,240,24.0,0,7,5,5,7.0,17701,16602,1660.2,-1992,-1924,1
7083,-621,319,1439.9,14399,18382,6.8,1,1,1,229,22.9,0,0,0,1,0,228,22.8,0,2,2,2,6.8,18063,15020,1502.0,-319,621,1
7084,615,12,1649.6,16496,17575,7.0,6,6,6,213,21.3,1,1,1,0,0,227,22.7,0,4,4,4,6.8,17563,15881,1588.1,-12,-615,1
7085,2101,1400,1652.1,16521,18785,7.2,4,4,3,261,26.1,1,1,1,0,0,215,21.5,0,2,2,2,6.6,17385,14420,1442.0,-1400,-2101,1
7086,-1079,-2292,1697.2,16972,18035,7.0,6,6,6,210,21.0,1,1,0,1,0,209,20.9,0,6,10,10,7.4,20327,18051,1805.1,2292,1079,0
7087,-1189,-1074,1637.5,16375,18609,7.0,5,5,5,231,23.1,0,0,0,1,1,217,21.7,1,7,11,11,7.4,19683,17564,1756.4,1074,1189,0
7088,-1258,-725,1714.9,17149,18495,7.0,8,8,11,218,21.8,0,0,0,1,1,214,21.4,1,8,9,9,7.4,19220,18407,1840.7,725,1258,0
7089,-2416,-2808,1531.9,15319,16582,6.6,6,6,8,158,15.8,0,0,1,0,1,209,20.9,1,9,8,8,7.2,19390,17735,1773.5,2808,2416,0
7090,4519,2852,1947.5,19475,18495,7.0,13,13,15,218,21.8,0,0,1,0,0,189,18.9,0,3,5,5,6.4,15643,14956,1495.6,-2852,-4519,1
7091,2276,1971,1857.6,18576,20102,7.2,11,11,7,227,22.7,2,1,1,0,0,213,21.3,0,6,5,5,7.0,18131,16300,1630.0,-1971,-2276,1
7092,4266,2910,2021.8,20218,18749,7.0,16,16,16,207,20.7,2,1,1,0,0,226,22.6,0,6,5,5,6.4,15839,15952,1595.2,-2910,-4266,1
7093,378,321,1539.8,15398,17861,7.2,4,4,5,200,20.0,1,1,0,1,0,227,22.7,1,2,3,3,7.0,17540,15020,1502.0,-321,-378,0
7094,879,1795,1968.3,19683,19202,7.2,15,15,15,195,19.5,1,1,0,1,0,179,17.9,0,18,13,13,6.6,17407,18804,1880.4,-1795,-879,1
7095,550,-371,1728.4,17284,15506,6.2,9,9,18,182,18.2,0,0,1,0,0,192,19.2,0,15,9,9,6.6,15877,16734,1673.4,371,-550,1
7096,2064,2124,1828.1,18281,17603,6.8,10,10,13,224,22.4,0,0,0,1,0,191,19.1,0,9,7,7,6.4,15479,16217,1621.7,-2124,-2064,1
7097,831,8,1690.5,16905,17224,6.8,7,7,8,214,21.4,0,0,0,1,1,218,21.8,1,8,5,5,6.8,17216,16074,1607.4,-8,-831,1
7098,2590,682,1687.5,16875,17964,6.6,7,7,9,222,22.2,0,0,1,0,1,225,22.5,1,1,2,2,6.8,17282,14285,1428.5,-682,-2590,1
7099,1434,1040,1627.7,16277,17277,6.8,6,6,8,210,21.0,0,0,0,1,0,215,21.5,0,4,3,3,6.6,16237,14843,1484.3,-1040,-1434,1
7100,1938,1013,1838.0,18380,18318,7.2,10,10,7,220,22.0,0,0,1,0,0,189,18.9,0,9,8,8,6.8,17305,16442,1644.2,-1013,-1938,1
7101,-1129,-1742,1662.2,16622,16799,6.6,8,8,8,170,17.0,0,0,0,1,1,211,21.1,1,10,10,10,7.2,18541,17751,1775.1,1742,1129,1
7102,-1182,-2730,1638.8,16388,16720,6.8,7,7,9,212,21.2,0,0,0,1,1,229,22.9,1,5,5,5,7.0,19450,17570,1757.0,2730,1182,0
7103,2947,2247,1744.1,17441,19668,7.4,7,7,6,214,21.4,0,0,1,0,0,190,19.0,1,1,4,4,7.0,17421,14494,1449.4,-2247,-2947,1
7104,1625,121,1746.9,17469,18265,7.0,8,8,12,242,24.2,0,0,1,0,0,236,23.6,0,4,5,5,6.8,18144,15844,1584.4,-121,-1625,1
7105,-934,-732,1564.9,15649,17079,7.0,5,5,5,201,20.1,0,0,0,1,1,216,21.6,1,11,8,8,6.8,17811,16583,1658.3,732,934,0
7106,3154,1720,1813.0,18130,19017,7.2,9,9,5,206,20.6,1,1,1,0,0,194,19.4,1,1,4,4,6.6,17297,14976,1497.6,-1720,-3154,1
7107,30,-249,1785.0,17850,19495,7.4,8,8,10,256,25.6,0,0,1,0,1,234,23.4,1,7,8,8,7.2,19744,17820,1782.0,249,-30,0
7108,-1050,88,1616.4,16164,18803,6.8,7,7,8,239,23.9,0,0,0,1,1,237,23.7,1,8,7,7,7.2,18715,17214,1721.4,-88,1050,0
7109,-1885,-1025,1592.8,15928,16033,6.4,6,6,7,173,17.3,2,1,1,0,0,233,23.3,0,10,9,9,6.8,17058,17813,1781.3,1025,1885,0
7110,925,-400,1535.6,15356,16499,6.4,4,4,5,233,23.3,0,0,1,0,0,206,20.6,0,3,2,2,6.8,16899,14431,1443.1,400,-925,1
7111,-1370,-1220,1613.5,16135,16582,6.6,6,6,9,181,18.1,0,0,1,0,0,235,23.5,0,8,6,6,6.8,17802,17505,1750.5,1220,1370,0
7112,1577,2582,1601.9,16019,20401,7.4,3,3,2,262,26.2,0,0,1,0,1,232,23.2,1,1,1,1,7.0,17819,14442,1444.2,-2582,-1577,1
7113,1769,1175,1607.9,16079,17138,6.6,6,6,7,225,22.5,1,1,0,1,0,185,18.5,0,5,3,3,6.2,15963,14310,1431.0,-1175,-1769,1
7114,3619,3192,1827.2,18272,20304,7.4,10,10,10,219,21.9,1,1,1,0,0,222,22.2,0,2,3,3,6.6,17112,14653,1465.3,-3192,-3619,1
7115,65,-273,1559.5,15595,17779,6.8,3,3,1,241,24.1,0,0,1,0,1,228,22.8,1,4,4,4,6.8,18052,15530,1553.0,273,-65,1
7116,4311,2572,2001.0,20010,20053,7.2,12,12,17,208,20.8,1,1,1,0,0,214,21.4,0,5,6,6,6.8,17481,15699,1569.9,-2572,-4311,1
7117,45,-351,1687.9,16879,18288,7.0,8,8,12,199,19.9,1,1,0,1,0,254,25.4,0,5,6,6,7.0,18639,16834,1683.4,351,-45,0
7118,-313,-701,1557.8,15578,18183,7.0,3,3,5,243,24.3,1,0,1,0,1,253,25.3,1,3,3,3,7.2,18884,15891,1589.1,701,313,0
7119,3094,1999,1887.7,18877,20418,7.6,9,9,7,244,24.4,0,0,1,0,0,205,20.5,0,6,7,7,7.2,18419,15783,1578.3,-1999,-3094,1
7120,4879,3774,1890.4,18904,18979,7.4,10,10,12,236,23.6,0,0,0,1,0,162,16.2,0,7,3,3,6.2,15205,14025,1402.5,-3774,-4879,1
7121,182,-159,1739.4,17394,16652,6.6,9,9,12,175,17.5,1,1,1,0,0,192,19.2,0,7,8,8,6.4,16811,17212,1721.2,159,-182,0
7122,-1212,972,1682.9,16829,19002,7.0,5,5,13,251,25.1,2,1,0,1,0,236,23.6,0,10,7,7,7.0,18030,18041,1804.1,-972,1212,0
7123,-365,-267,1700.2,17002,18865,7.2,7,7,8,209,20.9,2,1,1,0,0,229,22.9,0,5,6,6,7.4,19132,17367,1736.7,267,365,0
7124,-24,-1070,1572.1,15721,17191,6.8,6,6,7,180,18.0,0,0,1,0,0,238,23.8,0,4,3,3,7.0,18261,15745,1574.5,1070,24,0
7125,-1190,-1443,1626.3,16263,16904,6.6,4,4,4,220,22.0,1,1,0,1,0,208,20.8,0,9,9,9,7.0,18347,17453,1745.3,1443,1190,1
7126,-1800,-2200,1583.3,15833,16967,6.8,7,7,8,208,20.8,0,0,1,0,1,245,24.5,1,8,6,6,7.0,19167,17633,1763.3,2200,1800,1
7127,-2442,-1427,1491.8,14918,17605,6.8,2,2,1,221,22.1,0,0,0,1,1,262,26.2,1,10,7,7,7.2,19032,17360,1736.0,1427,2442,0
7128,-2816,-2760,1504.3,15043,16533,6.6,4,4,3,207,20.7,0,0,1,0,1,232,23.2,1,10,8,8,7.2,19293,17859,1785.9,2760,2816,0
7129,3629,5111,1777.5,17775,18094,6.8,9,9,6,222,22.2,1,1,1,0,0,123,12.3,0,5,5,5,5.6,12983,14146,1414.6,-5111,-3629,1
7130,4093,1925,2001.2,20012,19043,7.2,11,11,12,231,23.1,0,0,1,0,1,215,21.5,1,6,6,6,6.6,17118,15919,1591.9,-1925,-4093,1
7131,26,693,1595.4,15954,18014,7.0,5,5,4,228,22.8,1,1,0,1,0,190,19.0,0,4,6,6,6.8,17321,15928,1592.8,-693,-26,0
7132,-1949,-18,1419.4,14194,17765,6.8,2,2,1,192,19.2,2,1,0,1,0,190,19.0,0,9,8,8,7.0,17783,16143,1614.3,18,1949,1
7133,-3860,-1719,1468.9,14689,16546,6.6,4,4,5,174,17.4,0,0,0,1,1,253,25.3,2,4,8,8,7.2,18265,18549,1854.9,1719,3860,1
7134,-921,-1198,1815.2,18152,18229,7.0,10,10,6,245,24.5,0,0,1,0,1,206,20.6,1,16,13,13,7.2,19427,19073,1907.3,1198,921,0
7135,-348,-611,1664.2,16642,18251,7.0,6,6,7,218,21.8,1,1,0,1,0,237,23.7,1,4,6,6,7.0,18862,16990,1699.0,611,348,0
7136,-4079,-2994,1338.3,13383,15553,6.4,1,1,2,193,19.3,0,0,0,1,1,245,24.5,1,5,5,5,7.0,18547,17462,1746.2,2994,4079,0
7137,936,704,1681.8,16818,18786,7.4,6,6,7,232,23.2,0,0,0,1,1,221,22.1,2,2,5,5,7.2,18082,15882,1588.2,-704,-936,0
7138,-2115,-456,1662.1,16621,17456,6.6,3,3,6,244,24.4,0,0,0,1,1,222,22.2,2,15,8,8,6.8,17912,18736,1873.6,456,2115,0
7139,1204,349,1672.9,16729,17848,6.8,8,8,9,220,22.0,1,1,1,0,0,214,21.4,0,5,5,5,7.0,17499,15525,1552.5,-349,-1204,1
7140,-1309,-1408,1463.0,14630,16137,6.6,3,3,6,181,18.1,0,0,1,0,1,212,21.2,1,6,6,6,6.6,17545,15939,1593.9,1408,1309,0
7141,1212,1107,1648.9,16489,17669,6.6,6,6,5,237,23.7,0,0,1,0,1,196,19.6,1,6,5,5,6.6,16562,15277,1527.7,-1107,-1212,0
7142,-5040,-6118,1360.8,13608,15291,6.6,2,2,4,178,17.8,0,0,0,1,0,202,20.2,0,9,11,11,7.6,21409,18648,1864.8,6118,5040,0
7143,2532,1722,1658.3,16583,18572,7.0,6,6,8,244,24.4,1,1,1,0,0,223,22.3,0,0,0,0,6.6,16850,14051,1405.1,-1722,-2532,1
7144,3863,2639,1943.9,19439,19736,7.4,10,10,9,244,24.4,2,1,1,0,0,197,19.7,0,5,5,5,6.6,17097,15576,1557.6,-2639,-3863,1
7145,-2545,-1541,1597.4,15974,18618,6.8,5,5,2,226,22.6,1,0,0,1,1,247,24.7,1,9,10,10,7.6,20159,18519,1851.9,1541,2545,0
7146,-517,-425,1586.5,15865,18037,7.0,4,4,3,225,22.5,0,0,1,0,1,244,24.4,1,8,6,6,6.8,18462,16382,1638.2,425,517,1
7147,-3288,-2511,1591.9,15919,16708,6.6,6,6,4,205,20.5,0,0,0,1,1,229,22.9,2,10,7,7,7.2,19219,19207,1920.7,2511,3288,0
7148,818,1913,1536.0,15360,18594,7.2,5,5,5,207,20.7,1,0,1,0,1,224,22.4,1,3,2,2,6.6,16681,14542,1454.2,-1913,-818,1
7149,312,-613,1683.6,16836,17688,6.6,9,9,10,186,18.6,1,1,1,0,0,215,21.5,0,4,6,6,6.8,18301,16524,1652.4,613,-312,0
7150,1496,1758,1628.4,16284,18617,7.2,7,7,5,216,21.6,0,0,1,0,0,225,22.5,0,3,2,2,6.8,16859,14788,1478.8,-1758,-1496,1
7151,3586,2697,1830.3,18303,19093,7.2,11,11,7,214,21.4,1,1,1,0,0,180,18.0,0,2,4,4,6.4,16396,14717,1471.7,-2697,-3586,1
7152,-33,1233,1620.6,16206,17906,7.0,5,5,3,229,22.9,0,0,0,1,1,200,20.0,1,8,7,7,6.6,16673,16239,1623.9,-1233,33,0
7153,390,-300,1731.0,17310,18101,7.0,8,8,9,202,20.2,0,0,1,0,1,193,19.3,1,8,9,9,7.0,18401,16920,1692.0,300,-390,1
7154,-1295,-1230,1456.2,14562,15925,6.6,4,4,4,164,16.4,0,0,0,1,1,213,21.3,1,5,6,6,6.6,17155,15857,1585.7,1230,1295,1
7155,534,89,1595.4,15954,17647,6.8,6,6,10,203,20.3,0,0,1,0,1,248,24.8,1,4,3,3,6.8,17558,15420,1542.0,-89,-534,0
7156,-4780,-3425,1407.9,14079,16131,6.6,2,2,4,215,21.5,1,1,0,1,0,214,21.4,0,13,11,11,7.4,19556,18859,1885.9,3425,4780,0
7157,668,-462,1663.6,16636,18650,7.2,4,4,7,243,24.3,0,0,1,0,1,223,22.3,1,5,6,6,7.4,19112,15968,1596.8,462,-668,0
7158,-2954,-2865,1604.8,16048,16740,6.6,6,6,4,209,20.9,0,0,0,1,0,206,20.6,0,15,12,12,7.2,19605,19002,1900.2,2865,2954,0
7159,-3903,-2090,1495.3,14953,17005,6.6,3,3,3,221,22.1,0,0,1,0,1,239,23.9,1,18,11,11,7.2,19095,18856,1885.6,2090,3903,0
7160,2004,385,1627.9,16279,18714,7.0,5,5,4,255,25.5,0,0,1,0,1,213,21.3,1,1,1,1,7.0,18329,14275,1427.5,-385,-2004,1
7161,-5048,-4145,1384.1,13841,16368,6.8,1,1,2,216,21.6,0,0,0,1,1,268,26.8,1,6,8,8,7.4,20513,18889,1888.9,4145,5048,0
7162,597,1596,1531.1,15311,17731,7.0,3,3,1,187,18.7,0,0,0,1,1,212,21.2,1,7,3,3,6.4,16135,14714,1471.4,-1596,-597,0
7163,-503,-790,1667.7,16677,15835,6.6,10,10,12,168,16.8,2,1,1,0,0,191,19.1,0,10,7,7,6.6,16625,17180,1718.0,790,503,0
7164,-376,1005,1622.4,16224,18263,7.0,7,7,8,189,18.9,0,0,0,1,1,220,22.0,1,7,6,6,6.6,17258,16600,1660.0,-1005,376,0
7165,1162,2078,1637.2,16372,19294,7.2,7,7,4,208,20.8,2,1,0,1,0,193,19.3,0,5,5,5,7.0,17216,15210,1521.0,-2078,-1162,1
7166,5831,4588,1930.6,19306,19450,7.4,12,12,13,206,20.6,1,1,1,0,0,197,19.7,0,0,2,2,6.4,14862,13475,1347.5,-4588,-5831,1
7167,1917,1322,1880.1,18801,19438,7.2,8,8,6,215,21.5,0,0,1,0,1,202,20.2,1,6,8,8,7.0,18116,16884,1688.4,-1322,-1917,1
7168,3222,2205,1698.8,16988,18314,7.0,9,9,10,209,20.9,1,1,1,0,0,218,21.8,0,0,1,1,6.6,16109,13766,1376.6,-2205,-3222,1
7169,-3148,-2107,1502.7,15027,16491,6.6,4,4,3,216,21.6,0,0,0,1,1,220,22.0,1,9,9,9,7.0,18598,18175,1817.5,2107,3148,0
7170,-2399,-1527,1551.2,15512,17704,6.6,6,6,3,198,19.8,1,1,0,1,0,222,22.2,0,5,9,9,7.2,19231,17911,1791.1,1527,2399,0
7171,946,-439,1714.7,17147,17894,6.8,4,4,4,213,21.3,1,0,0,1,1,222,22.2,1,9,7,7,7.0,18333,16201,1620.1,439,-946,0
7172,2533,1524,1674.8,16748,17820,7.0,3,3,3,221,22.1,1,0,0,1,1,198,19.8,1,4,3,3,6.4,16296,14215,1421.5,-1524,-2533,1
7173,-4680,-3190,1445.6,14456,17039,6.6,4,4,3,212,21.2,0,0,0,1,1,220,22.0,2,14,12,12,7.6,20229,19136,1913.6,3190,4680,0
7174,1348,1158,1824.7,18247,18886,7.0,10,10,16,225,22.5,1,1,1,0,0,224,22.4,1,10,7,7,6.6,17728,16899,1689.9,-1158,-1348,1
7175,2763,1667,1819.6,18196,19070,7.2,9,9,7,230,23.0,0,0,1,0,1,194,19.4,1,6,5,5,6.8,17403,15433,1543.3,-1667,-2763,1
7176,-808,-1078,1686.6,16866,18028,6.8,7,7,10,220,22.0,1,1,1,0,0,234,23.4,0,8,7,7,7.2,19106,17674,1767.4,1078,808,1
7177,-2791,-2142,1396.0,13960,16218,6.4,4,4,2,184,18.4,1,1,0,1,0,238,23.8,0,7,7,7,7.0,18360,16751,1675.1,2142,2791,0
7178,-1199,-752,1454.5,14545,16581,6.6,3,3,4,190,19.0,0,0,0,1,1,203,20.3,1,6,6,6,6.8,17333,15744,1574.4,752,1199,0
7179,2712,1181,1889.4,18894,18656,7.2,12,12,7,195,19.5,1,1,1,0,0,195,19.5,0,5,5,5,6.6,17475,16182,1618.2,-1181,-2712,1
7180,-4266,-4094,1459.5,14595,15889,6.4,4,4,7,181,18.1,0,0,0,1,1,245,24.5,1,7,10,10,7.6,19983,18861,1886.1,4094,4266,0
7181,3380,1666,1967.0,19670,19683,7.4,11,11,15,239,23.9,1,0,1,0,0,197,19.7,0,10,6,6,7.0,18017,16290,1629.0,-1666,-3380,1
7182,3648,1867,1911.6,19116,19542,7.6,11,11,15,223,22.3,1,1,1,0,0,209,20.9,0,2,3,3,7.0,17675,15468,1546.8,-1867,-3648,1
7183,2320,2234,1718.6,17186,18505,7.0,6,6,6,234,23.4,0,0,1,0,0,207,20.7,0,6,3,3,6.6,16271,14866,1486.6,-2234,-2320,1
7184,-1754,-1471,1449.8,14498,17488,7.0,2,2,2,223,22.3,0,0,0,1,0,228,22.8,0,4,6,6,7.2,18959,16252,1625.2,1471,1754,0
7185,411,-493,1708.5,17085,18329,7.2,6,6,2,229,22.9,2,1,1,0,0,213,21.3,0,9,6,6,7.2,18822,16674,1667.4,493,-411,1
7186,3965,3505,1903.2,19032,19015,7.2,12,12,14,191,19.1,1,1,1,0,0,182,18.2,0,3,3,3,6.4,15510,15067,1506.7,-3505,-3965,1
7187,-3441,-1825,1440.1,14401,17502,6.8,1,1,0,212,21.2,0,0,0,1,1,229,22.9,1,10,10,10,7.2,19327,17842,1784.2,1825,3441,0
7188,-1864,-1069,1574.1,15741,17468,6.8,6,6,5,198,19.8,1,1,0,1,0,205,20.5,0,7,10,10,7.2,18537,17605,1760.5,1069,1864,1
7189,3653,1553,1913.8,19138,18317,6.8,9,9,12,239,23.9,0,0,1,0,0,193,19.3,1,4,3,3,6.6,16764,15485,1548.5,-1553,-3653,1
7190,1449,521,1736.3,17363,18387,7.0,7,7,10,233,23.3,1,0,1,0,1,206,20.6,1,6,6,6,7.0,17866,15914,1591.4,-521,-1449,1
7191,-1782,-754,1519.0,15190,18432,7.0,2,2,2,241,24.1,0,0,0,1,1,251,25.1,1,3,5,5,7.2,19186,16972,1697.2,754,1782,0
7192,-1711,-303,1559.2,15592,18837,7.0,5,5,3,205,20.5,2,1,1,0,0,241,24.1,0,8,7,7,7.2,19140,17303,1730.3,303,1711,0
7193,322,1046,1595.1,15951,17680,6.8,5,5,5,221,22.1,0,0,0,1,0,203,20.3,0,8,6,6,6.8,16634,15629,1562.9,-1046,-322,1
7194,-2277,-2919,1593.4,15934,16140,6.4,5,5,9,199,19.9,0,0,1,0,1,257,25.7,1,8,8,8,7.0,19059,18211,1821.1,2919,2277,0
7195,310,536,1589.4,15894,18853,7.0,4,4,5,223,22.3,0,0,0,1,1,223,22.3,1,4,4,4,7.0,18317,15584,1558.4,-536,-310,1
7196,-404,-1058,1614.8,16148,18119,6.8,5,5,3,237,23.7,0,0,0,1,1,215,21.5,2,6,7,7,7.0,19177,16552,1655.2,1058,404,0
7197,-706,-1460,1645.6,16456,16502,6.8,7,7,5,209,20.9,0,0,0,1,1,200,20.0,1,8,8,8,6.8,17962,17162,1716.2,1460,706,0
7198,651,748,1790.3,17903,18746,7.0,7,7,10,239,23.9,2,1,1,0,0,217,21.7,0,12,8,8,7.0,17998,17252,1725.2,-748,-651,0
7199,784,-2929,1692.5,16925,17065,6.6,6,6,12,212,21.2,0,0,1,0,0,224,22.4,0,2,3,3,7.2,19994,16141,1614.1,2929,-784,1
7200,-1966,-1549,1496.6,14966,17656,7.0,3,3,7,227,22.7,1,1,1,0,0,247,24.7,1,4,5,5,7.2,19205,16932,1693.2,1549,1966,0
7201,-2651,-1289,1601.4,16014,18062,7.2,6,6,7,211,21.1,1,0,0,1,1,240,24.0,1,13,10,10,7.2,19351,18665,1866.5,1289,2651,1
7202,-1731,-1553,1531.1,15311,18263,6.8,3,3,1,229,22.9,0,0,0,1,1,238,23.8,1,4,7,7,7.4,19816,17042,1704.2,1553,1731,0
7203,1255,277,1617.7,16177,18367,7.0,4,4,3,226,22.6,0,0,1,0,0,253,25.3,0,1,2,2,6.8,18090,14922,1492.2,-277,-1255,0
7204,569,304,1612.3,16123,17612,6.8,5,5,7,203,20.3,0,0,0,1,1,181,18.1,1,4,6,6,6.8,17308,15554,1555.4,-304,-569,1
7205,2326,987,1834.4,18344,18470,7.2,10,10,9,222,22.2,0,0,1,0,0,188,18.8,0,5,6,6,7.0,17483,16018,1601.8,-987,-2326,0
7206,1369,1440,1756.4,17564,20203,7.4,5,5,5,257,25.7,1,0,1,0,1,233,23.3,1,5,4,4,7.2,18763,16195,1619.5,-1440,-1369,0
7207,-261,443,1567.6,15676,19069,7.0,4,4,5,231,23.1,1,1,0,1,0,231,23.1,1,8,4,4,6.8,18626,15937,1593.7,-443,261,1
7208,11,-139,1565.2,15652,18830,7.0,1,1,0,258,25.8,0,0,0,1,1,227,22.7,2,4,4,4,7.0,18969,15641,1564.1,139,-11,0
7209,1120,10,1807.9,18079,18997,7.2,10,10,11,215,21.5,1,1,0,1,0,226,22.6,0,3,6,6,7.0,18987,16959,1695.9,-10,-1120,1
7210,-1887,-587,1432.5,14325,17432,6.8,1,1,1,235,23.5,0,0,0,1,1,228,22.8,1,10,6,6,7.2,18019,16212,1621.2,587,1887,0
7211,-155,-51,1613.2,16132,17519,6.8,5,5,6,210,21.0,0,0,0,1,0,191,19.1,0,11,7,7,7.0,17570,16287,1628.7,51,155,0
7212,1931,1567,1713.0,17130,18124,7.0,7,7,10,226,22.6,0,0,1,0,0,219,21.9,0,4,2,2,6.8,16557,15199,1519.9,-1567,-1931,1
7213,1896,-423,1945.9,19459,17657,7.0,9,9,16,206,20.6,1,1,1,0,0,215,21.5,0,6,7,7,7.0,18080,17563,1756.3,423,-1896,1
7214,501,642,1574.2,15742,17504,6.8,5,5,4,219,21.9,0,0,1,0,1,196,19.6,1,5,4,4,6.6,16862,15241,1524.1,-642,-501,0
7215,-1271,101,1541.2,15412,17498,6.8,4,4,6,192,19.2,1,0,0,1,0,233,23.3,0,8,7,7,7.0,17397,16683,1668.3,-101,1271,0
7216,-2811,-2298,1533.7,15337,16778,6.6,4,4,4,217,21.7,0,0,0,1,1,224,22.4,1,7,8,8,7.2,19076,18148,1814.8,2298,2811,1
7217,-1070,-893,1596.9,15969,17823,7.0,6,6,4,217,21.7,1,1,1,0,0,254,25.4,0,4,6,6,7.0,18716,17039,1703.9,893,1070,0
7218,-559,-794,1634.7,16347,16992,6.8,8,8,10,185,18.5,0,0,0,1,0,215,21.5,1,4,7,7,7.0,17786,16906,1690.6,794,559,1
7219,3202,2467,2034.1,20341,19192,7.4,13,13,11,235,23.5,0,0,1,0,1,189,18.9,1,10,8,8,6.6,16725,17139,1713.9,-2467,-3202,1
7220,731,44,1650.7,16507,18410,7.2,5,5,3,228,22.8,0,0,1,0,0,203,20.3,1,8,6,6,7.2,18366,15776,1577.6,-44,-731,0
7221,-2497,-1239,1364.9,13649,17258,6.8,2,2,0,199,19.9,1,1,0,1,0,211,21.1,0,4,5,5,7.0,18497,16146,1614.6,1239,2497,0
7222,-4853,-3538,1537.7,15377,15779,6.4,6,6,9,191,19.1,0,0,1,0,0,230,23.0,0,7,11,11,7.0,19317,20230,2023.0,3538,4853,0
7223,-164,1358,1534.5,15345,18848,7.2,2,2,3,230,23.0,1,0,1,0,1,236,23.6,1,7,3,3,6.6,17490,15509,1550.9,-1358,164,0
7224,-3954,-1940,1442.6,14426,16666,6.6,3,3,3,205,20.5,0,0,1,0,1,254,25.4,1,7,9,9,7.2,18606,18380,1838.0,1940,3954,0
7225,176,943,1651.8,16518,18036,7.0,7,7,4,229,22.9,1,1,0,1,0,200,20.0,0,9,7,7,6.6,17093,16342,1634.2,-943,-176,0
7226,-2720,-2419,1411.2,14112,17265,6.8,1,1,0,232,23.2,1,1,0,1,0,247,24.7,1,4,6,6,7.4,19684,16832,1683.2,2419,2720,0
7227,226,557,1680.9,16809,19023,7.4,6,6,8,225,22.5,0,0,0,1,1,239,23.9,2,7,5,5,7.2,18466,16583,1658.3,-557,-226,0
7228,-2215,-138,1701.1,17011,18754,7.2,7,7,6,231,23.1,1,1,1,0,0,206,20.6,1,13,8,8,7.0,18892,19226,1922.6,138,2215,0
7229,1071,-35,1692.8,16928,18438,7.2,6,6,6,236,23.6,1,1,1,0,0,254,25.4,0,0,3,3,7.2,18473,15857,1585.7,35,-1071,0
7230,-4534,-2709,1401.6,14016,16299,6.6,3,3,2,190,19.0,0,0,0,1,1,228,22.8,1,13,11,11,7.2,19008,18550,1855.0,2709,4534,0
7231,287,289,1608.2,16082,17134,6.8,7,7,10,199,19.9,0,0,0,1,0,209,20.9,0,4,4,4,6.6,16845,15795,1579.5,-289,-287,1
7232,4064,2564,1885.1,18851,19537,7.4,10,10,12,230,23.0,2,1,1,0,0,195,19.5,0,5,3,3,6.8,16973,14787,1478.7,-2564,-4064,1
7233,5475,3713,1999.4,19994,20865,7.6,10,10,6,248,24.8,2,1,1,0,0,217,21.7,0,2,3,3,7.0,17152,14519,1451.9,-3713,-5475,1
7234,2070,1331,1793.5,17935,18860,7.0,8,8,9,226,22.6,0,0,0,1,0,214,21.4,0,5,5,5,6.8,17529,15865,1586.5,-1331,-2070,0
7235,-5293,-3777,1353.9,13539,15736,6.6,3,3,4,163,16.3,0,0,0,1,0,236,23.6,0,13,10,10,7.4,19513,18832,1883.2,3777,5293,0
7236,-4231,-3158,1387.4,13874,17105,6.6,2,2,1,203,20.3,0,0,0,1,1,248,24.8,1,7,8,8,7.6,20263,18105,1810.5,3158,4231,0
7237,1563,901,1692.0,16920,17906,7.0,7,7,7,204,20.4,0,0,1,0,0,178,17.8,0,8,6,6,6.8,17005,15357,1535.7,-901,-1563,1
7238,-978,-535,1748.4,17484,18682,7.2,9,9,5,222,22.2,0,0,0,1,1,213,21.3,1,13,12,12,7.0,19217,18462,1846.2,535,978,1
7239,-1625,-442,1673.1,16731,17994,7.0,9,9,9,191,19.1,0,0,0,1,0,229,22.9,0,12,10,10,7.0,18436,18356,1835.6,442,1625,0
7240,-255,1128,1637.4,16374,17432,6.6,7,7,5,194,19.4,0,0,0,1,1,194,19.4,1,7,7,7,6.8,16304,16629,1662.9,-1128,255,0
7241,-578,-1149,1570.6,15706,18183,6.8,5,5,4,219,21.9,1,1,1,0,0,240,24.0,0,2,5,5,7.2,19332,16284,1628.4,1149,578,0
7242,-5683,-5256,1436.8,14368,16711,6.8,2,2,2,201,20.1,1,1,1,0,0,270,27.0,0,13,13,13,8.0,21967,20051,2005.1,5256,5683,0
7243,-1492,-1219,1508.1,15081,15753,6.2,5,5,5,195,19.5,0,0,1,0,0,218,21.8,0,14,9,9,6.6,16972,16573,1657.3,1219,1492,0
7244,-3056,-2462,1607.7,16077,16712,6.8,8,8,5,180,18.0,0,0,0,1,0,223,22.3,0,12,13,13,7.2,19174,19133,1913.3,2462,3056,0
7245,-1857,-699,1509.2,15092,18501,7.0,3,3,3,204,20.4,0,0,0,1,1,252,25.2,2,6,6,6,7.2,19200,16949,1694.9,699,1857,0
7246,-2042,-436,1498.6,14986,17946,6.8,3,3,2,220,22.0,1,1,0,1,0,232,23.2,1,6,5,5,7.0,18382,17028,1702.8,436,2042,1
7247,2647,1140,1689.4,16894,19048,7.2,6,6,7,234,23.4,1,1,1,0,0,217,21.7,0,1,1,1,6.8,17908,14247,1424.7,-1140,-2647,1
7248,-5011,-2444,1452.5,14525,16786,6.6,3,3,3,201,20.1,0,0,0,1,0,244,24.4,0,5,7,7,7.2,19230,19536,1953.6,2444,5011,0
7249,4343,2636,1861.8,18618,19304,7.2,8,8,6,223,22.3,1,0,1,0,0,190,19.0,0,1,1,1,6.8,16668,14275,1427.5,-2636,-4343,1
7250,-192,-287,1534.5,15345,17067,6.6,3,3,3,226,22.6,0,0,0,1,1,191,19.1,2,8,6,6,6.8,17354,15537,1553.7,287,192,0
7251,3066,2798,1796.7,17967,18521,7.0,9,9,10,209,20.9,1,1,0,1,0,177,17.7,0,4,5,5,6.4,15723,14901,1490.1,-2798,-3066,1
7252,4694,2781,1948.4,19484,19688,7.2,13,13,15,235,23.5,0,0,1,0,1,196,19.6,2,3,3,3,6.6,16907,14790,1479.0,-2781,-4694,1
7253,-3968,-2461,1450.8,14508,17217,6.8,3,3,3,200,20.0,0,0,0,1,1,243,24.3,2,7,6,6,7.2,19678,18476,1847.6,2461,3968,0
7254,786,1888,1750.5,17505,19310,7.2,8,8,8,223,22.3,1,1,1,0,0,220,22.0,0,7,6,6,6.6,17422,16719,1671.9,-1888,-786,1
7255,2444,561,1742.8,17428,18741,7.4,7,7,9,219,21.9,0,0,1,0,1,242,24.2,1,1,2,2,6.8,18180,14984,1498.4,-561,-2444,1
7256,691,696,1733.6,17336,19025,7.2,8,8,7,218,21.8,0,0,1,0,0,192,19.2,0,7,9,9,7.0,18329,16645,1664.5,-696,-691,1
7257,-2820,-1143,1538.6,15386,17872,7.0,4,4,3,209,20.9,1,1,0,1,0,229,22.9,0,11,9,9,7.4,19015,18206,1820.6,1143,2820,1
7258,246,217,1635.3,16353,18091,6.8,4,4,6,240,24.0,1,1,0,1,0,227,22.7,0,7,5,5,6.8,17874,16107,1610.7,-217,-246,1
7259,-864,-865,1669.7,16697,18511,7.0,7,7,7,211,21.1,0,0,0,1,0,226,22.6,0,8,8,8,7.2,19376,17561,1756.1,865,864,1
7260,-858,847,1485.0,14850,17967,6.8,3,3,3,226,22.6,1,1,0,1,0,239,23.9,0,5,4,4,6.8,17120,15708,1570.8,-847,858,1
7261,-1775,-722,1487.9,14879,16931,6.6,3,3,4,217,21.7,0,0,0,1,0,215,21.5,0,4,6,6,6.8,17653,16654,1665.4,722,1775,0
7262,1455,602,1845.4,18454,19370,7.2,10,10,11,230,23.0,1,1,1,0,0,247,24.7,0,5,7,7,7.0,18768,16999,1699.9,-602,-1455,0
7263,-1878,-178,1433.4,14334,18293,7.0,1,1,0,242,24.2,0,0,0,1,1,262,26.2,1,6,4,4,7.0,18471,16212,1621.2,178,1878,1
7264,2755,1492,1749.0,17490,18903,7.0,4,4,4,233,23.3,1,1,0,1,0,197,19.7,1,3,3,3,7.0,17411,14735,1473.5,-1492,-2755,1
7265,3003,3063,1952.6,19526,19551,7.4,13,13,14,225,22.5,1,1,1,0,0,200,20.0,0,9,7,7,6.6,16488,16523,1652.3,-3063,-3003,1
7266,1894,99,1843.9,18439,18689,7.2,10,10,12,223,22.3,1,1,1,0,0,203,20.3,0,5,6,6,7.0,18590,16545,1654.5,-99,-1894,1
7267,-522,269,1737.5,17375,18906,7.2,9,9,9,210,21.0,1,1,1,0,0,190,19.0,1,7,8,8,7.0,18637,17897,1789.7,-269,522,0
7268,1992,2096,1736.7,17367,19496,7.0,8,8,9,215,21.5,1,1,0,1,0,211,21.1,0,4,5,5,6.6,17400,15375,1537.5,-2096,-1992,1
7269,-1256,-559,1635.4,16354,18198,6.8,7,7,5,213,21.3,0,0,0,1,1,226,22.6,2,5,7,7,7.0,18757,17610,1761.0,559,1256,1
7270,-1127,-2006,1570.8,15708,17420,6.8,5,5,5,220,22.0,0,0,0,1,0,226,22.6,0,4,7,7,7.0,19426,16835,1683.5,2006,1127,0
7271,-1186,-1760,1542.7,15427,16873,6.8,3,3,5,209,20.9,2,1,1,0,0,230,23.0,0,2,6,6,7.2,18633,16613,1661.3,1760,1186,0
7272,-1328,-1142,1685.1,16851,17153,6.6,9,9,10,190,19.0,2,1,1,0,0,227,22.7,0,6,6,6,7.0,18295,18179,1817.9,1142,1328,0
7273,-1818,-2061,1578.6,15786,16824,6.8,6,6,6,193,19.3,0,0,1,0,1,246,24.6,1,4,7,7,7.2,18885,17604,1760.4,2061,1818,0
7274,-1228,11,1631.9,16319,17715,6.8,8,8,5,217,21.7,0,0,1,0,0,191,19.1,0,9,9,9,6.8,17704,17547,1754.7,-11,1228,0
7275,-2638,-1671,1432.4,14324,16757,6.6,2,2,1,211,21.1,1,1,1,0,0,244,24.4,0,6,7,7,6.8,18428,16962,1696.2,1671,2638,0
7276,41,178,1606.4,16064,17943,7.0,7,7,7,181,18.1,0,0,0,1,1,206,20.6,2,5,6,6,6.8,17765,16023,1602.3,-178,-41,1
7277,1446,-143,1801.3,18013,18223,7.2,10,10,10,228,22.8,1,1,1,0,0,216,21.6,0,5,6,6,7.0,18366,16567,1656.7,143,-1446,1
7278,-2782,-1742,1589.0,15890,17797,7.0,4,4,4,229,22.9,0,0,0,1,1,235,23.5,1,10,9,9,7.0,19539,18672,1867.2,1742,2782,0
7279,-310,-392,1549.2,15492,17869,6.6,4,4,3,218,21.8,0,0,0,1,1,192,19.2,1,7,6,6,7.2,18261,15802,1580.2,392,310,0
7280,699,-254,1628.1,16281,18349,7.2,4,4,3,219,21.9,0,0,1,0,1,200,20.0,1,7,5,5,7.2,18603,15582,1558.2,254,-699,0
7281,-2785,-453,1503.2,15032,18462,7.0,2,2,4,232,23.2,1,1,0,1,0,228,22.8,1,7,7,7,7.2,18915,17817,1781.7,453,2785,0
7282,-1681,41,1677.7,16777,19056,7.2,6,6,7,219,21.9,0,0,0,1,0,241,24.1,0,9,9,9,7.4,19015,18458,1845.8,-41,1681,0
7283,-189,-211,1570.8,15708,16783,6.8,6,6,8,197,19.7,0,0,1,0,0,244,24.4,1,3,4,4,6.8,16994,15897,1589.7,211,189,0
7284,791,1138,1750.5,17505,18661,7.2,6,6,8,240,24.0,1,1,0,1,0,234,23.4,0,5,4,4,6.6,17523,16714,1671.4,-1138,-791,1
7285,-1248,503,1588.9,15889,16752,6.8,6,6,5,220,22.0,1,1,0,1,0,191,19.1,0,12,7,7,6.4,16249,17137,1713.7,-503,1248,0
7286,4188,2399,1903.1,19031,18999,7.4,12,12,14,234,23.4,1,1,1,0,0,207,20.7,1,2,3,3,6.6,16600,14843,1484.3,-2399,-4188,0
7287,3301,3347,1858.1,18581,19769,7.6,10,10,4,249,24.9,0,0,0,1,1,213,21.3,1,4,4,4,6.6,16422,15280,1528.0,-3347,-3301,1
7288,-2944,-2835,1479.6,14796,16514,6.4,2,2,4,225,22.5,0,0,1,0,1,231,23.1,1,7,6,6,7.2,19349,17740,1774.0,2835,2944,0
7289,2800,2474,1742.9,17429,19044,7.4,8,8,8,239,23.9,1,1,0,1,0,197,19.7,0,1,3,3,6.6,16570,14629,1462.9,-2474,-2800,0
7290,1178,2223,1768.6,17686,19734,7.0,9,9,7,236,23.6,1,1,0,1,0,187,18.7,1,5,7,7,6.8,17511,16508,1650.8,-2223,-1178,0
7291,-900,267,1615.8,16158,18018,7.2,6,6,5,213,21.3,0,0,0,1,1,177,17.7,2,12,9,9,6.8,17751,17058,1705.8,-267,900,0
7292,-4204,-2138,1447.1,14471,16470,6.6,4,4,2,169,16.9,0,0,0,1,1,227,22.7,2,11,10,10,7.2,18608,18675,1867.5,2138,4204,0
7293,2196,1245,1741.9,17419,18137,7.0,9,9,10,209,20.9,1,1,1,0,0,192,19.2,0,5,6,6,6.6,16892,15223,1522.3,-1245,-2196,1
7294,1711,264,1785.9,17859,17682,7.0,10,10,17,221,22.1,1,0,0,1,0,209,20.9,0,6,6,6,6.8,17418,16148,1614.8,-264,-1711,1
7295,-2560,-1275,1454.6,14546,16662,6.6,3,3,3,200,20.0,0,0,0,1,1,203,20.3,1,6,7,7,7.0,17937,17106,1710.6,1275,2560,1
7296,-1768,-2230,1737.3,17373,16452,6.6,11,11,8,178,17.8,1,1,0,1,0,198,19.8,0,8,11,11,7.2,18682,19141,1914.1,2230,1768,0
7297,1436,1824,1723.9,17239,18395,7.2,8,8,9,209,20.9,0,0,0,1,0,225,22.5,0,2,4,4,6.6,16571,15803,1580.3,-1824,-1436,1
7298,342,-646,1817.8,18178,17725,7.0,10,10,14,213,21.3,0,0,1,0,1,222,22.2,1,8,9,9,7.0,18371,17836,1783.6,646,-342,0
7299,170,1174,1669.0,16690,17356,6.6,9,9,8,215,21.5,1,1,0,1,0,189,18.9,0,8,10,10,6.4,16182,16520,1652.0,-1174,-170,0
7300,-5373,-4474,1350.8,13508,15474,6.6,1,1,1,186,18.6,0,0,0,1,1,241,24.1,2,11,9,9,7.2,19948,18881,1888.1,4474,5373,0
7301,360,1102,1712.2,17122,19090,7.0,7,7,7,236,23.6,0,0,0,1,1,187,18.7,1,7,7,7,7.0,17988,16762,1676.2,-1102,-360,0
7302,-448,-1140,1642.9,16429,17419,6.6,5,5,11,226,22.6,0,0,1,0,1,233,23.3,1,7,6,6,7.2,18559,16877,1687.7,1140,448,0
7303,-2089,-835,1755.6,17556,17097,6.6,8,8,7,192,19.2,0,0,0,1,0,186,18.6,0,16,17,17,6.8,17932,19645,1964.5,835,2089,1
7304,-3709,-1017,1463.5,14635,16718,6.6,3,3,3,202,20.2,0,0,0,1,1,231,23.1,1,10,10,10,6.8,17735,18344,1834.4,1017,3709,0
7305,2961,2627,1789.0,17890,18682,7.2,10,10,6,226,22.6,0,0,1,0,0,207,20.7,0,6,4,4,6.6,16055,14929,1492.9,-2627,-2961,1
7306,-2825,-3105,1288.4,12884,15586,6.4,1,1,2,174,17.4,0,0,0,1,1,239,23.9,1,4,2,2,7.0,18691,15709,1570.9,3105,2825,0
7307,2841,1484,1716.0,17160,17725,7.0,8,8,14,191,19.1,1,1,1,0,0,208,20.8,0,1,3,3,6.6,16241,14319,1431.9,-1484,-2841,0
7308,-3253,-3049,1441.6,14416,16951,6.8,3,3,3,185,18.5,0,0,0,1,1,229,22.9,1,9,8,8,7.6,20000,17669,1766.9,3049,3253,0
7309,2746,999,1816.5,18165,18510,7.0,10,10,8,219,21.9,0,0,0,1,0,206,20.6,0,3,6,6,6.8,17511,15419,1541.9,-999,-2746,1
7310,-2502,-1811,1443.8,14438,17107,6.6,3,3,3,199,19.9,0,0,0,1,1,232,23.2,1,6,8,8,7.0,18918,16940,1694.0,1811,2502,0
7311,-1270,1023,1678.4,16784,19211,7.4,7,7,6,196,19.6,0,0,0,1,0,210,21.0,0,10,9,9,7.2,18188,18054,1805.4,-1023,1270,0
7312,-1495,-801,1538.4,15384,17040,6.6,6,6,5,189,18.9,0,0,0,1,1,211,21.1,2,7,6,6,6.8,17841,16879,1687.9,801,1495,0
7313,-2432,-1788,1498.0,14980,16246,6.4,2,2,1,232,23.2,0,0,1,0,1,219,21.9,1,17,9,9,7.0,18034,17412,1741.2,1788,2432,0
7314,3884,2224,1831.4,18314,17903,7.0,10,10,11,219,21.9,0,0,1,0,1,167,16.7,1,6,4,4,6.6,15679,14430,1443.0,-2224,-3884,1
7315,-2133,-256,1654.8,16548,17735,6.8,7,7,6,224,22.4,0,0,0,1,1,215,21.5,1,19,11,11,7.0,17991,18681,1868.1,256,2133,0
7316,4973,3174,1832.9,18329,20471,7.6,9,9,12,225,22.5,1,1,1,0,0,199,19.9,0,0,1,1,6.8,17297,13356,1335.6,-3174,-4973,1
7317,338,-272,1687.7,16877,17631,6.8,7,7,8,216,21.6,0,0,1,0,1,230,23.0,1,9,6,6,7.0,17903,16539,1653.9,272,-338,1
7318,-3099,-1695,1489.9,14899,17420,6.8,4,4,5,232,23.2,0,0,0,1,1,227,22.7,1,10,9,9,7.2,19115,17998,1799.8,1695,3099,0
7319,-1655,-881,1563.0,15630,18026,7.2,3,3,2,236,23.6,1,1,0,1,0,257,25.7,0,6,5,5,7.0,18907,17285,1728.5,881,1655,0
7320,2788,558,1832.1,18321,18428,6.8,9,9,8,230,23.0,1,0,1,0,0,183,18.3,0,5,8,8,6.6,17870,15533,1553.3,-558,-2788,1
7321,508,1164,1779.3,17793,19322,7.2,10,10,7,215,21.5,2,1,0,1,0,193,19.3,0,10,9,9,7.0,18158,17285,1728.5,-1164,-508,1
7322,-2955,-3054,1429.7,14297,16721,6.6,1,1,2,235,23.5,0,0,0,1,1,257,25.7,1,4,5,5,7.2,19775,17252,1725.2,3054,2955,0
7323,-2082,-527,1560.2,15602,17116,6.6,4,4,2,216,21.6,0,0,0,1,1,199,19.9,1,13,11,11,6.8,17643,17684,1768.4,527,2082,1
7324,3117,1580,1793.8,17938,18626,7.0,8,8,10,239,23.9,1,0,1,0,1,196,19.6,1,1,4,4,6.8,17046,14821,1482.1,-1580,-3117,0
7325,2153,799,1755.6,17556,17943,6.8,10,10,11,206,20.6,1,1,1,0,0,202,20.2,0,7,5,5,6.8,17144,15403,1540.3,-799,-2153,1
7326,-625,-945,1523.2,15232,17793,7.0,4,4,4,209,20.9,0,0,1,0,0,215,21.5,0,6,5,5,7.2,18738,15857,1585.7,945,625,1
7327,-1657,-1200,1576.8,15768,17528,6.8,4,4,5,233,23.3,1,0,0,1,0,253,25.3,0,7,8,8,7.0,18728,17425,1742.5,1200,1657,0
7328,-893,-670,1466.3,14663,16086,6.4,3,3,6,206,20.6,0,0,0,1,0,212,21.2,0,4,4,4,6.8,16756,15556,1555.6,670,893,0
7329,1618,934,1718.0,17180,17511,7.0,7,7,9,219,21.9,0,0,1,0,1,195,19.5,1,5,4,4,6.8,16577,15562,1556.2,-934,-1618,1
7330,958,2603,1661.6,16616,19895,7.2,7,7,4,246,24.6,1,1,0,1,0,229,22.9,0,5,3,3,6.8,17292,15658,1565.8,-2603,-958,1
7331,-2459,-2110,1455.5,14555,16722,6.6,2,2,1,232,23.2,1,1,0,1,0,243,24.3,0,10,6,6,7.2,18832,17014,1701.4,2110,2459,0
7332,-816,172,1561.4,15614,17578,7.0,4,4,5,241,24.1,0,0,0,1,1,234,23.4,1,9,7,7,6.8,17406,16430,1643.0,-172,816,0
7333,3560,2311,1695.6,16956,18863,7.0,3,3,3,270,27.0,0,0,1,0,0,198,19.8,0,0,1,1,6.6,16552,13396,1339.6,-2311,-3560,1
7334,2763,2232,1710.2,17102,19068,7.2,7,7,8,219,21.9,0,0,0,1,0,229,22.9,0,1,2,2,6.8,16836,14339,1433.9,-2232,-2763,1
7335,-4659,-3884,1486.9,14869,16447,6.6,4,4,4,188,18.8,0,0,1,0,1,255,25.5,2,14,10,10,7.4,20331,19528,1952.8,3884,4659,0
7336,98,976,1529.5,15295,17054,6.8,3,3,3,210,21.0,1,1,1,0,0,213,21.3,0,6,5,5,6.4,16078,15197,1519.7,-976,-98,1
7337,1922,1355,1650.6,16506,17581,6.8,5,5,2,233,23.3,0,0,1,0,0,218,21.8,0,4,3,3,6.2,16226,14584,1458.4,-1355,-1922,1
7338,4783,2851,1874.5,18745,18917,7.0,7,7,9,259,25.9,1,1,1,0,0,217,21.7,1,0,0,0,6.4,16066,13962,1396.2,-2851,-4783,1
7339,2393,675,1880.2,18802,18463,6.8,14,14,13,213,21.3,1,0,1,0,1,206,20.6,1,6,7,7,6.8,17788,16409,1640.9,-675,-2393,1
7340,1334,-236,1867.7,18677,18208,7.0,9,9,11,220,22.0,1,0,1,0,1,206,20.6,1,10,8,8,6.8,18444,17343,1734.3,236,-1334,1
7341,3193,1212,2090.9,20909,19188,7.4,14,14,18,210,21.0,1,1,1,0,0,183,18.3,0,9,9,9,7.0,17976,17716,1771.6,-1212,-3193,1
7342,-992,-490,1701.2,17012,17394,6.8,8,8,8,204,20.4,0,0,1,0,1,240,24.0,1,8,7,7,6.8,17884,18004,1800.4,490,992,1
7343,715,545,1655.9,16559,18604,7.0,7,7,7,205,20.5,0,0,0,1,1,235,23.5,1,4,4,4,6.8,18059,15844,1584.4,-545,-715,0
7344,1136,2782,1988.4,19884,19673,7.4,12,12,13,226,22.6,0,0,1,0,0,211,21.1,0,12,10,10,6.8,16891,18748,1874.8,-2782,-1136,1
7345,-3133,-3803,1464.2,14642,15759,6.4,5,5,8,189,18.9,0,0,0,1,0,213,21.3,0,8,8,8,7.4,19562,17775,1777.5,3803,3133,0
7346,-1443,-36,1412.0,14120,16943,6.4,2,2,3,217,21.7,1,1,0,1,0,214,21.4,1,5,4,4,6.8,16979,15563,1556.3,36,1443,0
7347,-5634,-3787,1548.4,15484,17528,7.0,6,6,4,188,18.8,0,0,0,1,1,243,24.3,1,9,14,14,7.8,21315,21118,2111.8,3787,5634,0
7348,1232,114,1539.2,15392,17891,7.0,3,3,3,232,23.2,0,0,1,0,1,223,22.3,1,2,1,1,6.8,17777,14160,1416.0,-114,-1232,0
7349,-1163,-1130,1656.8,16568,18504,7.0,5,5,4,239,23.9,0,0,1,0,1,223,22.3,1,11,8,8,7.4,19634,17731,1773.1,1130,1163,0
7350,-791,-961,1714.0,17140,16531,6.6,9,9,12,167,16.7,0,0,1,0,0,214,21.4,0,11,11,11,7.0,17492,17931,1793.1,961,791,1
7351,-771,483,1669.5,16695,19057,7.2,7,7,8,189,18.9,1,1,0,1,0,244,24.4,0,6,9,9,7.0,18574,17466,1746.6,-483,771,0
7352,-773,-734,1751.3,17513,17486,6.8,12,12,13,193,19.3,0,0,0,1,1,208,20.8,1,11,10,10,6.8,18220,18286,1828.6,734,773,0
7353,-1143,-1447,1729.9,17299,18331,7.0,8,8,7,218,21.8,2,1,0,1,0,233,23.3,0,6,9,9,7.2,19778,18442,1844.2,1447,1143,0
7354,1103,1356,1658.1,16581,19116,7.0,4,4,3,254,25.4,0,0,0,1,0,205,20.5,0,3,5,5,6.8,17760,15478,1547.8,-1356,-1103,1
7355,1482,41,1713.7,17137,19582,7.4,4,4,4,261,26.1,0,0,1,0,1,230,23.0,2,2,3,3,7.4,19541,15655,1565.5,-41,-1482,1
7356,591,192,1626.2,16262,18196,7.2,6,6,6,207,20.7,0,0,0,1,1,217,21.7,1,5,5,5,7.0,18004,15671,1567.1,-192,-591,0
7357,-3558,-2346,1571.9,15719,17678,6.8,4,4,2,211,21.1,0,0,0,1,1,212,21.2,2,9,14,14,7.4,20024,19277,1927.7,2346,3558,0
7358,225,1404,1582.4,15824,19141,7.2,5,5,5,221,22.1,1,0,0,1,1,248,24.8,1,6,3,3,6.8,17737,15599,1559.9,-1404,-225,0
7359,3613,3509,1723.5,17235,19304,7.4,8,8,5,227,22.7,1,0,0,1,0,182,18.2,0,1,2,2,6.4,15795,13622,1362.2,-3509,-3613,1
7360,1545,1417,1719.9,17199,19299,7.0,7,7,12,229,22.9,1,1,1,0,0,226,22.6,0,5,4,4,7.2,17882,15654,1565.4,-1417,-1545,0
7361,-411,-2213,1571.6,15716,17405,7.0,3,3,4,241,24.1,0,0,1,0,1,246,24.6,1,1,3,3,7.2,19618,16127,1612.7,2213,411,0
7362,2177,1584,1783.5,17835,19830,7.4,9,9,9,246,24.6,1,1,0,1,0,213,21.3,0,4,6,6,6.8,18246,15658,1565.8,-1584,-2177,1
7363,-10830,-9333,1073.0,10730,10826,4.8,1,1,0,140,14.0,0,0,0,1,0,241,24.1,0,14,12,12,7.4,20159,21560,2156.0,9333,10830,0
7364,2312,1079,1843.6,18436,18190,6.8,10,10,13,250,25.0,1,1,1,0,0,181,18.1,0,8,6,6,6.8,17111,16124,1612.4,-1079,-2312,1
7365,-2309,-2673,1401.7,14017,15335,6.2,3,3,4,185,18.5,1,1,0,1,0,214,21.4,0,5,4,4,7.2,18008,16326,1632.6,2673,2309,0
7366,-1696,-2535,1588.8,15888,15944,6.6,7,7,9,195,19.5,0,0,1,0,0,186,18.6,0,7,9,9,7.2,18479,17584,1758.4,2535,1696,0
7367,-246,-870,1718.5,17185,16790,6.8,8,8,11,193,19.3,1,0,1,0,0,208,20.8,0,8,8,8,6.8,17660,17431,1743.1,870,246,1
7368,543,-624,1535.8,15358,17220,6.6,5,5,2,223,22.3,1,0,1,0,1,199,19.9,1,3,3,3,7.0,17844,14815,1481.5,624,-543,0
7369,58,203,1544.8,15448,16856,6.8,6,6,9,180,18.0,0,0,1,0,1,201,20.1,1,6,5,5,6.6,16653,15390,1539.0,-203,-58,1
7370,2185,1440,1791.3,17913,19123,7.0,9,9,9,249,24.9,1,1,1,0,0,231,23.1,0,5,3,3,6.6,17683,15728,1572.8,-1440,-2185,1
7371,124,-2259,1623.1,16231,17392,6.8,6,6,9,222,22.2,1,1,1,0,0,239,23.9,0,2,4,4,7.4,19651,16107,1610.7,2259,-124,1
7372,-4657,-4000,1487.8,14878,16786,6.4,3,3,4,213,21.3,1,1,0,1,0,244,24.4,0,11,10,10,7.6,20786,19535,1953.5,4000,4657,0
7373,511,-29,1522.9,15229,18526,7.0,3,3,1,242,24.2,1,0,0,1,1,209,20.9,1,0,3,3,7.0,18555,14718,1471.8,29,-511,0
7374,4171,3497,1993.3,19933,19756,7.2,12,12,19,248,24.8,0,0,0,1,1,202,20.2,1,7,5,5,6.4,16259,15762,1576.2,-3497,-4171,1
7375,-3368,-2587,1463.7,14637,17059,6.6,3,3,1,210,21.0,0,0,0,1,1,236,23.6,1,10,10,10,7.4,19646,18005,1800.5,2587,3368,0
7376,-2368,618,1663.7,16637,17846,6.8,5,5,3,219,21.9,0,0,0,1,1,224,22.4,1,14,10,10,7.0,17228,19005,1900.5,-618,2368,1
7377,-144,-157,1684.0,16840,19004,7.2,8,8,7,193,19.3,1,1,1,0,0,218,21.8,0,7,7,7,7.2,19161,16984,1698.4,157,144,1
7378,-2128,264,1435.8,14358,18106,6.8,4,4,1,190,19.0,1,1,0,1,0,227,22.7,0,5,6,6,7.0,17842,16486,1648.6,-264,2128,0
7379,-2613,-1974,1540.3,15403,17392,6.6,4,4,5,242,24.2,1,1,1,0,0,230,23.0,1,15,10,10,7.0,19366,18016,1801.6,1974,2613,0
7380,-1325,-959,1632.8,16328,17459,6.8,6,6,8,221,22.1,0,0,0,1,1,234,23.4,1,8,9,9,7.2,18418,17653,1765.3,959,1325,0
7381,-209,-353,1616.6,16166,17100,6.8,8,8,6,188,18.8,1,1,1,0,0,215,21.5,0,9,6,6,7.0,17453,16375,1637.5,353,209,1
7382,-4232,-2456,1345.8,13458,16195,6.6,1,1,0,221,22.1,0,0,0,1,0,225,22.5,0,8,9,9,7.2,18651,17690,1769.0,2456,4232,0
7383,-716,637,1561.3,15613,17643,7.0,4,4,4,229,22.9,1,1,0,1,0,213,21.3,0,3,6,6,6.8,17006,16329,1632.9,-637,716,1
7384,1621,128,1681.9,16819,18039,7.0,6,6,5,244,24.4,0,0,0,1,1,219,21.9,1,2,4,4,6.8,17911,15198,1519.8,-128,-1621,0
7385,-2541,-1921,1481.5,14815,16969,6.4,3,3,4,221,22.1,0,0,0,1,1,237,23.7,2,3,5,5,7.0,18890,17356,1735.6,1921,2541,0
7386,-2072,-1355,1618.6,16186,17103,6.6,6,6,7,207,20.7,0,0,0,1,1,211,21.1,2,10,10,10,7.0,18458,18258,1825.8,1355,2072,0
7387,239,-305,1653.8,16538,18285,6.8,4,4,7,253,25.3,0,0,0,1,1,243,24.3,2,6,4,4,7.2,18590,16299,1629.9,305,-239,0
7388,-3378,-2082,1429.1,14291,16706,6.8,4,4,6,178,17.8,0,0,0,1,1,233,23.3,1,10,8,8,7.2,18788,17669,1766.9,2082,3378,0
7389,-1589,-575,1539.9,15399,17209,7.0,4,4,7,217,21.7,0,0,1,0,1,210,21.0,1,11,6,6,7.0,17784,16988,1698.8,575,1589,0
7390,-4474,-5216,1372.6,13726,16098,6.2,2,2,1,184,18.4,1,0,0,1,1,236,23.6,1,8,10,10,7.6,21314,18200,1820.0,5216,4474,0
7391,90,-540,1777.6,17776,17464,6.8,9,9,9,211,21.1,0,0,0,1,0,203,20.3,0,10,10,10,6.8,18004,17686,1768.6,540,-90,1
7392,1051,12,1891.3,18913,19076,7.2,12,12,10,183,18.3,1,1,1,0,0,209,20.9,0,7,10,10,7.2,19064,17862,1786.2,-12,-1051,1
7393,2022,970,1731.7,17317,18842,7.0,11,11,12,226,22.6,1,1,1,0,0,242,24.2,0,2,3,3,6.8,17872,15295,1529.5,-970,-2022,1
7394,2278,2211,1780.9,17809,18479,7.0,8,8,7,238,23.8,0,0,1,0,0,189,18.9,0,8,6,6,6.4,16268,15531,1553.1,-2211,-2278,0
7395,2402,2440,1647.4,16474,18843,7.0,7,7,6,225,22.5,1,1,1,0,0,206,20.6,0,1,1,1,6.4,16403,14072,1407.2,-2440,-2402,1
7396,-1716,-1094,1691.5,16915,19035,7.0,10,10,7,214,21.4,0,0,0,1,1,238,23.8,2,11,11,11,7.6,20129,18631,1863.1,1094,1716,1
7397,-973,-1732,1496.4,14964,17928,7.0,3,3,2,235,23.5,1,1,0,1,0,251,25.1,0,1,3,3,7.2,19660,15937,1593.7,1732,973,0
7398,3044,1261,1925.3,19253,19378,7.2,13,13,11,212,21.2,0,0,0,1,1,212,21.2,1,5,7,7,7.2,18117,16209,1620.9,-1261,-3044,1
7399,-4265,-3190,1479.7,14797,16690,6.8,2,2,3,213,21.3,0,0,0,1,1,244,24.4,2,7,9,9,7.2,19880,19062,1906.2,3190,4265,0
7400,1794,2548,1764.2,17642,18820,7.2,9,9,8,227,22.7,0,0,0,1,0,179,17.9,0,3,8,8,6.4,16272,15848,1584.8,-2548,-1794,1
7401,-2247,-1501,1446.2,14462,16255,6.4,3,3,4,210,21.0,0,0,0,1,1,213,21.3,1,7,8,8,6.8,17756,16709,1670.9,1501,2247,0
7402,-1019,699,1699.3,16993,19167,7.2,10,10,3,195,19.5,0,0,0,1,0,202,20.2,0,10,10,10,7.2,18468,18012,1801.2,-699,1019,1
7403,-3960,-2533,1414.9,14149,17085,6.6,3,3,0,189,18.9,0,0,0,1,0,220,22.0,0,9,9,9,7.2,19618,18109,1810.9,2533,3960,0
7404,4235,3554,1863.3,18633,18488,6.8,10,10,8,231,23.1,1,1,1,0,0,164,16.4,0,4,5,5,6.2,14934,14398,1439.8,-3554,-4235,1
7405,-108,1254,1742.1,17421,19535,7.4,8,8,5,244,24.4,1,1,0,1,0,212,21.2,0,9,8,8,7.0,18281,17529,1752.9,-1254,108,1
7406,-1309,351,1411.2,14112,17417,6.8,1,1,0,202,20.2,1,0,0,1,1,205,20.5,1,7,4,4,6.6,17066,15421,1542.1,-351,1309,0
7407,2999,2184,1909.5,19095,19444,7.2,10,10,10,219,21.9,0,0,1,0,0,204,20.4,0,2,4,4,6.6,17260,16096,1609.6,-2184,-2999,0
7408,402,1641,1677.0,16770,19515,7.4,8,8,7,212,21.2,1,1,0,1,0,222,22.2,0,6,5,5,6.8,17874,16368,1636.8,-1641,-402,1
7409,421,-755,1743.0,17430,17345,6.8,8,8,9,210,21.0,0,0,0,1,1,216,21.6,1,7,7,7,7.0,18100,17009,1700.9,755,-421,0
7410,-1071,-1810,1501.1,15011,15341,6.4,5,5,9,173,17.3,1,1,0,1,0,226,22.6,0,3,6,6,6.6,17151,16082,1608.2,1810,1071,0
7411,-5840,-2412,1347.5,13475,15686,6.2,0,0,0,206,20.6,1,0,0,1,1,262,26.2,1,16,11,11,7.0,18098,19315,1931.5,2412,5840,0
7412,-1885,-366,1358.1,13581,17687,7.0,2,2,1,201,20.1,0,0,0,1,1,246,24.6,1,5,3,3,7.2,18053,15466,1546.6,366,1885,0
7413,52,221,1674.3,16743,17531,6.6,10,10,11,189,18.9,2,1,1,0,0,208,20.8,0,5,7,7,6.8,17310,16691,1669.1,-221,-52,1
7414,-377,-1234,1633.1,16331,17720,7.0,5,5,5,231,23.1,1,1,1,0,0,229,22.9,0,7,6,6,7.2,18954,16708,1670.8,1234,377,1
7415,-361,-1022,1594.8,15948,16134,6.6,7,7,10,185,18.5,1,0,0,1,0,196,19.6,0,7,6,6,6.8,17156,16309,1630.9,1022,361,0
7416,4526,2759,1915.5,19155,20750,7.6,9,9,6,251,25.1,2,1,1,0,0,192,19.2,0,3,3,3,7.0,17991,14629,1462.9,-2759,-4526,1
7417,1139,-885,1731.2,17312,16818,6.6,6,6,7,209,20.9,1,0,1,0,1,208,20.8,1,8,6,6,6.8,17703,16173,1617.3,885,-1139,1
7418,2565,1235,1699.0,16990,17608,6.8,7,7,8,187,18.7,0,0,1,0,0,212,21.2,0,2,3,3,6.4,16373,14425,1442.5,-1235,-2565,1
7419,376,-470,1778.5,17785,17490,7.0,12,12,14,183,18.3,1,1,0,1,0,207,20.7,0,7,7,7,6.8,17960,17409,1740.9,470,-376,1
7420,-322,-716,1570.4,15704,16968,6.6,4,4,0,210,21.0,0,0,1,0,0,179,17.9,0,14,8,8,7.0,17684,16026,1602.6,716,322,0
7421,1400,488,1705.5,17055,19132,7.2,4,4,4,228,22.8,1,1,0,1,0,235,23.5,0,3,4,4,7.2,18644,15655,1565.5,-488,-1400,1
7422,34,145,1753.8,17538,19111,7.0,10,10,11,219,21.9,1,1,1,0,0,225,22.5,0,6,6,6,7.2,18966,17504,1750.4,-145,-34,0
7423,-885,-1554,1534.0,15340,16902,6.6,4,4,7,213,21.3,0,0,1,0,1,240,24.0,2,5,5,5,7.2,18456,16225,1622.5,1554,885,1
7424,-3209,-2726,1567.9,15679,16997,6.4,6,6,4,188,18.8,0,0,0,1,0,233,23.3,0,8,10,10,7.2,19723,18888,1888.8,2726,3209,0
7425,129,230,1639.1,16391,17955,7.0,7,7,9,209,20.9,0,0,0,1,1,199,19.9,1,5,7,7,6.6,17725,16262,1626.2,-230,-129,1
7426,870,130,1936.2,19362,18101,7.2,12,12,15,221,22.1,1,1,0,1,0,216,21.6,1,8,8,8,7.0,17971,18492,1849.2,-130,-870,1
7427,-2798,-3625,1404.9,14049,16350,6.6,1,1,1,194,19.4,0,0,0,1,1,248,24.8,2,5,4,4,7.4,19975,16847,1684.7,3625,2798,0
7428,482,466,1790.5,17905,18292,7.2,12,12,9,195,19.5,1,1,0,1,0,159,15.9,0,10,9,9,7.0,17826,17423,1742.3,-466,-482,1
7429,1257,1123,1732.9,17329,19569,7.4,7,7,6,239,23.9,1,1,0,1,0,242,24.2,0,3,4,4,7.2,18446,16072,1607.2,-1123,-1257,1
7430,-967,-263,1669.9,16699,17566,7.0,7,7,11,195,19.5,0,0,0,1,0,208,20.8,0,8,10,10,7.2,17829,17666,1766.6,263,967,0
7431,-2416,-2252,1685.9,16859,17173,7.0,7,7,7,198,19.8,1,0,1,0,1,221,22.1,1,12,10,10,7.4,19425,19275,1927.5,2252,2416,0
7432,-1808,-259,1480.0,14800,18190,7.0,4,4,7,207,20.7,0,0,0,1,1,231,23.1,1,9,6,6,7.2,18449,16608,1660.8,259,1808,0
7433,926,-849,1545.2,15452,16236,6.6,5,5,5,195,19.5,0,0,1,0,1,186,18.6,1,4,4,4,6.8,17085,14526,1452.6,849,-926,1
7434,1621,1793,1698.1,16981,19169,7.2,7,7,6,232,23.2,1,1,0,1,0,236,23.6,0,4,3,3,6.8,17376,15360,1536.0,-1793,-1621,0
7435,1558,1567,1573.5,15735,17967,7.0,5,5,5,219,21.9,0,0,1,0,0,202,20.2,1,1,1,1,6.6,16400,14177,1417.7,-1567,-1558,1
7436,98,984,1545.8,15458,19132,7.2,3,3,3,219,21.9,1,1,0,1,0,240,24.0,0,2,4,4,7.0,18148,15360,1536.0,-984,-98,1
7437,1547,1218,1651.5,16515,16954,6.6,9,9,10,198,19.8,0,0,1,0,1,193,19.3,1,4,5,5,6.4,15736,14968,1496.8,-1218,-1547,0
7438,-2001,-2536,1627.5,16275,16965,6.8,5,5,4,221,22.1,0,0,1,0,1,193,19.3,1,13,11,11,7.2,19501,18276,1827.6,2536,2001,0
7439,-1166,-988,1615.0,16150,16981,6.8,5,5,6,207,20.7,0,0,0,1,1,218,21.8,1,12,7,7,7.0,17969,17316,1731.6,988,1166,1
7440,785,1373,1791.3,17913,18248,6.8,9,9,6,217,21.7,2,1,0,1,0,191,19.1,0,15,9,9,6.8,16875,17128,1712.8,-1373,-785,1
7441,-1160,-592,1562.3,15623,17536,7.0,3,3,3,224,22.4,0,0,0,1,1,194,19.4,1,13,7,7,7.2,18128,16783,1678.3,592,1160,0
7442,1410,1243,1640.5,16405,18231,7.2,6,6,9,233,23.3,1,1,0,1,0,235,23.5,0,3,2,2,6.6,16988,14995,1499.5,-1243,-1410,1
7443,750,1293,1691.2,16912,19261,7.0,6,6,3,253,25.3,1,1,0,1,0,233,23.3,0,3,5,5,7.0,17968,16162,1616.2,-1293,-750,1
7444,2788,1325,1709.2,17092,19011,7.2,5,5,5,242,24.2,1,1,1,0,0,215,21.5,0,2,2,2,6.8,17686,14304,1430.4,-1325,-2788,1
7445,739,711,1705.6,17056,18811,7.2,6,6,5,234,23.4,1,1,1,0,0,231,23.1,0,6,5,5,6.8,18100,16317,1631.7,-711,-739,1
7446,-960,-1743,1503.9,15039,17278,6.8,4,4,2,221,22.1,0,0,0,1,1,232,23.2,1,2,5,5,7.0,19021,15999,1599.9,1743,960,1
7447,1428,463,1746.5,17465,17968,6.8,10,10,8,218,21.8,0,0,1,0,1,222,22.2,1,9,5,5,6.8,17505,16037,1603.7,-463,-1428,1
7448,2545,1695,1898.9,18989,19584,7.2,10,10,16,201,20.1,2,1,1,0,0,212,21.2,0,11,7,7,7.0,17889,16444,1644.4,-1695,-2545,1
7449,-2405,-2654,1466.3,14663,16512,6.6,4,4,4,242,24.2,0,0,1,0,1,235,23.5,1,5,7,7,7.2,19166,17068,1706.8,2654,2405,0
7450,-1318,406,1520.8,15208,17411,6.8,3,3,4,224,22.4,1,1,0,1,0,211,21.1,1,12,6,6,7.0,17005,16526,1652.6,-406,1318,1
7451,-1501,-3119,1803.6,18036,17340,6.8,9,9,11,213,21.3,1,1,1,0,0,221,22.1,1,10,9,9,7.6,20459,19537,1953.7,3119,1501,0
7452,984,1142,1787.5,17875,18665,7.2,8,8,10,205,20.5,2,1,1,0,0,227,22.7,0,8,8,8,7.0,17523,16891,1689.1,-1142,-984,0
7453,-974,-1978,1598.5,15985,17576,6.8,5,5,4,223,22.3,0,0,1,0,1,188,18.8,1,11,10,10,7.2,19554,16959,1695.9,1978,974,0
7454,1385,-827,1703.5,17035,16379,6.6,6,6,10,187,18.7,1,1,1,0,0,179,17.9,1,6,7,7,6.6,17206,15650,1565.0,827,-1385,0
7455,2956,2140,1760.2,17602,18119,6.8,7,7,8,254,25.4,0,0,1,0,0,205,20.5,0,4,3,3,6.4,15979,14646,1464.6,-2140,-2956,1
7456,-583,360,1597.9,15979,17379,6.8,5,5,10,195,19.5,0,0,0,1,1,200,20.0,1,9,8,8,6.6,17019,16562,1656.2,-360,583,0
7457,2845,2164,1828.7,18287,18535,7.2,9,9,9,242,24.2,0,0,1,0,0,233,23.3,0,6,5,5,6.6,16371,15442,1544.2,-2164,-2845,0
7458,-5010,-4509,1488.8,14888,15213,6.4,5,5,8,153,15.3,0,0,0,1,1,218,21.8,1,10,12,12,7.6,19722,19898,1989.8,4509,5010,0
7459,-877,-813,1604.0,16040,18690,7.0,3,3,3,248,24.8,1,1,0,1,0,264,26.4,0,6,5,5,7.2,19503,16917,1691.7,813,877,1
7460,365,-719,1538.8,15388,17788,6.8,4,4,6,220,22.0,1,1,1,0,0,252,25.2,0,0,0,0,6.8,18507,15023,1502.3,719,-365,1
7461,278,-343,1672.6,16726,18339,7.0,7,7,7,217,21.7,0,0,0,1,1,206,20.6,1,5,6,6,7.0,18682,16448,1644.8,343,-278,0
7462,1291,2116,1724.2,17242,18478,7.0,6,6,6,230,23.0,1,1,0,1,0,171,17.1,0,8,7,7,6.6,16362,15951,1595.1,-2116,-1291,1
7463,2518,2382,1765.0,17650,18670,7.0,7,7,11,243,24.3,1,1,1,0,0,196,19.6,0,8,5,5,6.6,16288,15132,1513.2,-2382,-2518,1
7464,364,1705,1733.5,17335,19512,7.4,10,10,8,208,20.8,0,0,0,1,0,218,21.8,0,6,6,6,7.0,17807,16971,1697.1,-1705,-364,0
7465,206,-460,1693.8,16938,17857,7.0,7,7,7,222,22.2,1,1,1,0,0,215,21.5,0,6,8,8,7.0,18317,16732,1673.2,460,-206,0
7466,-5221,-4220,1365.5,13655,15392,6.4,3,3,2,179,17.9,0,0,1,0,1,239,23.9,1,12,10,10,7.6,19612,18876,1887.6,4220,5221,0
7467,151,806,1682.3,16823,18727,7.0,6,6,4,213,21.3,1,0,0,1,1,226,22.6,1,8,7,7,6.8,17921,16672,1667.2,-806,-151,1
7468,782,1642,1583.4,15834,19029,7.0,4,4,2,258,25.8,1,1,1,0,0,238,23.8,0,3,3,3,6.6,17387,15052,1505.2,-1642,-782,1
7469,-2366,-340,1497.0,14970,17809,6.8,2,2,2,235,23.5,1,0,0,1,0,226,22.6,0,14,8,8,6.8,18149,17336,1733.6,340,2366,0
7470,386,-200,1717.3,17173,18789,7.2,6,6,10,232,23.2,1,1,0,1,0,202,20.2,0,8,6,6,7.2,18989,16787,1678.7,200,-386,0
7471,-3559,-3320,1340.9,13409,15601,6.6,1,1,1,203,20.3,0,0,0,1,1,236,23.6,2,4,6,6,7.0,18921,16968,1696.8,3320,3559,0
7472,-900,1475,1702.2,17022,19318,7.0,8,8,8,237,23.7,1,0,1,0,1,203,20.3,1,12,8,8,7.0,17843,17922,1792.2,-1475,900,1
7473,606,820,1580.4,15804,18509,7.2,4,4,5,228,22.8,1,0,0,1,1,210,21.0,1,5,3,3,6.8,17689,15198,1519.8,-820,-606,0
7474,2939,993,1707.3,17073,16988,6.8,8,8,9,195,19.5,1,1,1,0,0,197,19.7,0,3,3,3,6.6,15995,14134,1413.4,-993,-2939,0
7475,1216,2889,1655.3,16553,19304,7.2,7,7,7,205,20.5,1,1,0,1,0,173,17.3,0,7,6,6,6.6,16415,15337,1533.7,-2889,-1216,1
7476,2488,2453,1767.9,17679,19757,7.4,9,9,10,237,23.7,1,1,1,0,0,222,22.2,0,5,3,3,7.0,17304,15191,1519.1,-2453,-2488,0
7477,-6259,-5376,1400.7,14007,14101,6.2,4,4,7,197,19.7,1,1,0,1,0,247,24.7,0,14,13,13,7.2,19477,20266,2026.6,5376,6259,0
7478,-3246,-1980,1398.6,13986,16124,6.4,2,2,3,189,18.9,1,1,0,1,0,209,20.9,0,10,9,9,7.0,18104,17232,1723.2,1980,3246,0
7479,572,-233,1648.1,16481,18136,7.0,7,7,8,190,19.0,0,0,1,0,1,224,22.4,1,7,5,5,7.0,18369,15909,1590.9,233,-572,0
7480,1260,1141,1783.4,17834,19107,7.2,10,10,12,208,20.8,1,1,0,1,0,226,22.6,0,4,5,5,7.0,17966,16574,1657.4,-1141,-1260,1
7481,528,-805,1720.0,17200,17501,6.6,8,8,8,226,22.6,1,1,1,0,0,199,19.9,0,7,7,7,7.2,18306,16672,1667.2,805,-528,1
7482,-206,-363,1712.5,17125,16776,6.8,9,9,13,191,19.1,2,1,1,0,0,204,20.4,0,7,9,9,6.6,17139,17331,1733.1,363,206,1
7483,375,-566,1693.7,16937,18017,7.0,7,7,9,214,21.4,1,1,0,1,0,194,19.4,0,7,7,7,7.0,18583,16562,1656.2,566,-375,1
7484,306,-936,1580.2,15802,17365,7.0,4,4,4,237,23.7,2,1,1,0,0,209,20.9,0,5,4,4,7.0,18301,15496,1549.6,936,-306,1
7485,4680,2780,1933.6,19336,19593,7.4,12,12,18,221,22.1,0,0,0,1,0,214,21.4,0,2,2,2,6.8,16813,14656,1465.6,-2780,-4680,1
7486,2702,1047,1852.4,18524,18193,7.0,8,8,11,241,24.1,1,1,1,0,0,228,22.8,0,5,3,3,6.8,17146,15822,1582.2,-1047,-2702,1
7487,-1938,-1173,1534.6,15346,17250,6.6,4,4,5,212,21.2,0,0,1,0,1,225,22.5,1,7,7,7,7.0,18423,17284,1728.4,1173,1938,0
7488,1051,797,1691.2,16912,17195,6.8,8,8,10,205,20.5,1,1,1,0,0,212,21.2,0,8,6,6,6.6,16398,15861,1586.1,-797,-1051,1
7489,-620,-147,1484.3,14843,18146,7.0,2,2,2,236,23.6,0,0,0,1,0,236,23.6,0,5,4,4,7.0,18293,15463,1546.3,147,620,1
7490,987,-377,1703.7,17037,17825,7.0,7,7,10,237,23.7,0,0,1,0,1,219,21.9,2,5,5,5,7.0,18202,16050,1605.0,377,-987,0
7491,-437,-1284,1752.5,17525,16972,7.0,9,9,4,202,20.2,0,0,0,1,1,190,19.0,1,12,11,11,6.8,18256,17962,1796.2,1284,437,1
7492,-2031,-2540,1410.2,14102,16463,6.8,1,1,1,211,21.1,1,0,0,1,0,221,22.1,0,6,5,5,7.0,19003,16133,1613.3,2540,2031,0
7493,-1932,-930,1553.0,15530,18389,7.0,6,6,7,222,22.2,0,0,0,1,1,232,23.2,1,6,10,10,7.4,19319,17462,1746.2,930,1932,0
7494,-2626,-1992,1516.8,15168,17149,6.8,4,4,5,201,20.1,0,0,1,0,0,254,25.4,0,7,8,8,7.2,19141,17794,1779.4,1992,2626,0
7495,-2631,-1358,1490.0,14900,18274,6.8,3,3,1,211,21.1,1,1,0,1,0,221,22.1,0,11,5,5,7.4,19632,17531,1753.1,1358,2631,1
7496,1899,2690,1763.9,17639,19606,7.2,8,8,5,228,22.8,2,1,1,0,0,208,20.8,0,9,5,5,6.8,16916,15740,1574.0,-2690,-1899,1
7497,-2607,-2125,1495.8,14958,16560,6.6,3,3,3,239,23.9,1,1,1,0,0,253,25.3,0,8,7,7,7.0,18685,17565,1756.5,2125,2607,1
7498,-676,-864,1456.9,14569,16559,6.6,2,2,1,227,22.7,1,1,0,1,0,236,23.6,0,3,2,2,6.8,17423,15245,1524.5,864,676,0
7499,1968,1923,1682.0,16820,18804,7.2,7,7,5,222,22.2,2,1,1,0,0,205,20.5,0,4,3,3,6.8,16881,14852,1485.2,-1923,-1968,0
7500,-4035,-2639,1489.1,14891,17683,6.8,4,4,0,218,21.8,0,0,0,1,1,246,24.6,1,11,11,11,7.4,20322,18926,1892.6,2639,4035,0
7501,-2349,-2678,1508.9,15089,16002,6.4,5,5,7,182,18.2,0,0,0,1,1,201,20.1,1,7,9,9,7.0,18680,17438,1743.8,2678,2349,0
7502,-3175,-1845,1342.7,13427,16472,6.8,1,1,1,211,21.1,0,0,0,1,1,217,21.7,1,5,6,6,7.0,18317,16602,1660.2,1845,3175,0
7503,2450,2233,1784.8,17848,19823,7.4,8,8,6,253,25.3,2,1,1,0,0,227,22.7,0,3,3,3,7.0,17590,15398,1539.8,-2233,-2450,1
7504,1373,1766,1802.1,18021,18556,7.2,12,12,16,202,20.2,2,1,1,0,0,200,20.0,0,10,6,6,6.4,16790,16648,1664.8,-1766,-1373,1
7505,1504,2057,1637.0,16370,18289,7.0,4,4,5,257,25.7,2,1,1,0,0,191,19.1,0,6,4,4,6.8,16232,14866,1486.6,-2057,-1504,1
7506,-765,-492,1609.1,16091,16748,6.8,8,8,11,200,20.0,1,1,1,0,0,185,18.5,0,11,6,6,7.0,17240,16856,1685.6,492,765,1
7507,-2921,-3196,1512.9,15129,15915,6.4,5,5,5,176,17.6,0,0,0,1,0,203,20.3,0,12,10,10,7.0,19111,18050,1805.0,3196,2921,0
7508,2283,830,1681.7,16817,17790,6.8,7,7,9,228,22.8,0,0,1,0,1,202,20.2,1,6,3,3,6.8,16960,14534,1453.4,-830,-2283,1
7509,2297,392,1820.3,18203,17893,6.8,8,8,7,248,24.8,1,0,1,0,1,193,19.3,1,6,6,6,6.8,17501,15906,1590.6,-392,-2297,1
7510,578,144,1770.6,17706,17870,6.8,10,10,10,212,21.2,0,0,0,1,0,204,20.4,0,6,9,9,7.0,17726,17128,1712.8,-144,-578,1
7511,1794,2647,1666.8,16668,18055,7.0,10,10,6,192,19.2,1,1,0,1,0,203,20.3,0,3,4,4,6.4,15408,14874,1487.4,-2647,-1794,1
7512,-971,-1588,1586.2,15862,16175,6.6,5,5,10,229,22.9,0,0,1,0,0,195,19.5,1,6,6,6,6.8,17763,16833,1683.3,1588,971,0
7513,1269,-422,1747.9,17479,17898,6.8,9,9,10,209,20.9,0,0,1,0,1,207,20.7,1,8,7,7,6.8,18320,16210,1621.0,422,-1269,1
7514,-34,-122,1678.2,16782,18450,7.0,9,9,6,218,21.8,1,0,1,0,1,234,23.4,1,3,5,5,7.0,18572,16816,1681.6,122,34,0
7515,1171,918,1794.2,17942,18724,7.2,8,8,7,213,21.3,1,1,0,1,0,189,18.9,0,12,8,8,7.0,17806,16771,1677.1,-918,-1171,0
7516,-2298,-1255,1741.8,17418,18495,7.0,10,10,8,202,20.2,0,0,0,1,1,171,17.1,1,10,15,15,7.2,19750,19716,1971.6,1255,2298,0
7517,-2807,-2956,1618.0,16180,16639,6.6,8,8,7,185,18.5,0,0,1,0,0,236,23.6,0,17,10,10,7.4,19595,18987,1898.7,2956,2807,0
7518,-1155,-638,1412.4,14124,15978,6.4,2,2,2,229,22.9,0,0,1,0,0,215,21.5,0,7,4,4,6.6,16616,15279,1527.9,638,1155,1
7519,-69,-634,1845.2,18452,17864,7.0,8,8,10,241,24.1,0,0,0,1,1,180,18.0,2,10,11,11,7.0,18498,18521,1852.1,634,69,0
7520,576,-1839,1714.2,17142,18300,7.2,6,6,8,227,22.7,1,1,1,0,0,222,22.2,1,7,4,4,7.4,20139,16566,1656.6,1839,-576,0
7521,-1694,-468,1614.3,16143,17196,6.8,7,7,9,181,18.1,1,0,1,0,1,200,20.0,1,16,10,10,6.8,17664,17837,1783.7,468,1694,0
7522,-2600,-1587,1594.4,15944,17805,7.0,4,4,4,201,20.1,0,0,0,1,1,251,25.1,1,13,9,9,7.2,19392,18544,1854.4,1587,2600,0
7523,-2160,-88,1405.9,14059,17446,6.8,1,1,0,213,21.3,1,0,0,1,1,204,20.4,1,10,6,6,6.8,17534,16219,1621.9,88,2160,0
7524,4013,2137,1946.5,19465,17819,7.0,11,11,14,214,21.4,1,1,1,0,0,182,18.2,0,8,7,7,6.4,15682,15452,1545.2,-2137,-4013,1
7525,1338,46,1715.1,17151,18082,7.0,8,8,14,227,22.7,1,1,1,0,0,204,20.4,0,5,6,6,7.0,18036,15813,1581.3,-46,-1338,0
7526,5019,3765,1948.3,19483,19290,7.2,14,14,16,227,22.7,1,0,0,1,0,203,20.3,0,1,3,3,6.4,15525,14464,1446.4,-3765,-5019,1
7527,258,762,1571.6,15716,16324,6.4,8,8,9,190,19.0,0,0,0,1,1,183,18.3,1,8,6,6,6.2,15562,15458,1545.8,-762,-258,0
7528,-2327,-2301,1501.5,15015,17386,6.8,3,3,3,216,21.6,0,0,0,1,0,230,23.0,1,8,8,8,7.2,19687,17342,1734.2,2301,2327,0
7529,1843,3584,1684.7,16847,19212,7.0,9,9,7,211,21.1,0,0,0,1,0,194,19.4,0,4,4,4,6.2,15628,15004,1500.4,-3584,-1843,0
7530,-1021,-2152,1490.7,14907,16847,6.6,3,3,3,205,20.5,0,0,1,0,1,238,23.8,1,5,3,3,7.2,18999,15928,1592.8,2152,1021,0
7531,-450,-1721,1576.8,15768,17401,6.8,5,5,6,200,20.0,0,0,1,0,1,225,22.5,1,5,6,6,7.4,19122,16218,1621.8,1721,450,0
7532,-790,-1172,1672.2,16722,17229,6.8,10,10,10,163,16.3,1,1,1,0,0,207,20.7,1,8,10,10,7.0,18401,17512,1751.2,1172,790,0
7533,-989,-1102,1538.5,15385,17822,7.0,3,3,2,227,22.7,1,0,0,1,1,224,22.4,1,3,5,5,7.4,18924,16374,1637.4,1102,989,0
7534,-1412,-768,1610.2,16102,17077,6.6,6,6,8,200,20.0,0,0,1,0,0,227,22.7,0,9,8,8,6.8,17845,17514,1751.4,768,1412,0
7535,1926,3774,1697.7,16977,19637,7.2,7,7,6,209,20.9,0,0,0,1,1,235,23.5,1,3,2,2,6.4,15863,15051,1505.1,-3774,-1926,1
7536,-3022,-613,1603.3,16033,17402,6.8,8,8,12,188,18.8,0,0,1,0,0,221,22.1,1,6,8,8,7.2,18015,19055,1905.5,613,3022,0
7537,-716,573,1527.2,15272,18442,7.0,4,4,2,205,20.5,1,1,0,1,0,207,20.7,0,5,6,6,6.8,17869,15988,1598.8,-573,716,1
7538,3522,1996,1895.9,18959,19305,7.0,10,10,13,220,22.0,0,0,0,1,1,206,20.6,1,5,4,4,6.6,17309,15437,1543.7,-1996,-3522,0
7539,148,-543,1563.3,15633,17562,6.8,5,5,9,222,22.2,0,0,1,0,0,210,21.0,0,4,4,4,7.0,18105,15485,1548.5,543,-148,0
7540,-2987,-2017,1449.0,14490,17638,7.0,1,1,2,222,22.2,0,0,0,1,1,235,23.5,1,10,7,7,7.4,19655,17477,1747.7,2017,2987,0
7541,2303,2950,1781.2,17812,19411,7.2,6,6,9,263,26.3,0,0,1,0,1,191,19.1,1,9,5,5,6.6,16461,15509,1550.9,-2950,-2303,1
7542,288,-339,1560.3,15603,18354,6.8,3,3,3,239,23.9,0,0,0,1,0,232,23.2,0,2,3,3,7.0,18693,15315,1531.5,339,-288,0
7543,1692,373,1666.7,16667,18290,7.2,4,4,8,239,23.9,1,1,1,0,0,209,20.9,1,3,4,4,6.8,17917,14975,1497.5,-373,-1692,1
7544,-1546,-710,1617.7,16177,18425,7.0,5,5,8,224,22.4,0,0,0,1,1,183,18.3,1,12,11,11,7.4,19135,17723,1772.3,710,1546,0
7545,-1226,48,1678.0,16780,17484,6.8,8,8,8,209,20.9,0,0,0,1,1,225,22.5,1,12,10,10,6.8,17436,18006,1800.6,-48,1226,0
7546,-1985,-3666,1593.8,15938,14724,6.2,7,7,9,194,19.4,0,0,1,0,1,187,18.7,1,13,12,12,7.2,18390,17923,1792.3,3666,1985,0
7547,-2005,-1736,1615.4,16154,16080,6.6,7,7,9,199,19.9,0,0,1,0,0,229,22.9,0,10,10,10,6.8,17816,18159,1815.9,1736,2005,1
7548,-1530,-146,1497.5,14975,18139,7.0,4,4,2,201,20.1,2,1,0,1,0,220,22.0,0,8,6,6,7.2,18285,16505,1650.5,146,1530,0
7549,-4600,-3906,1468.3,14683,16048,6.6,3,3,2,215,21.5,1,0,1,0,0,209,20.9,0,11,12,12,7.4,19954,19283,1928.3,3906,4600,0
7550,75,-123,1583.6,15836,18034,6.8,6,6,6,216,21.6,1,1,0,1,0,254,25.4,0,1,4,4,6.8,18157,15761,1576.1,123,-75,1
7551,-185,-1442,1646.3,16463,16852,6.8,8,8,7,207,20.7,0,0,1,0,1,228,22.8,2,3,5,5,7.0,18294,16648,1664.8,1442,185,1
7552,-418,15,1571.2,15712,17100,6.8,4,4,4,213,21.3,1,1,1,0,0,166,16.6,0,11,7,7,6.8,17085,16130,1613.0,-15,418,1
7553,3642,2198,1766.5,17665,19246,7.4,9,9,9,232,23.2,1,0,1,0,1,199,19.9,1,1,2,2,7.0,17048,14023,1402.3,-2198,-3642,1
7554,5397,2928,1968.0,19680,18528,7.2,13,13,21,204,20.4,1,1,1,0,0,175,17.5,0,5,5,5,6.4,15600,14283,1428.3,-2928,-5397,1
7555,2247,1439,1640.0,16400,18900,7.4,5,5,3,255,25.5,0,0,1,0,1,202,20.2,1,1,3,3,7.0,17461,14153,1415.3,-1439,-2247,1
7556,-944,-2050,1465.9,14659,15944,6.2,3,3,3,193,19.3,1,1,0,1,0,213,21.3,0,6,7,7,6.8,17994,15603,1560.3,2050,944,1
7557,46,99,1874.2,18742,18884,7.0,9,9,14,232,23.2,0,0,0,1,0,236,23.6,0,16,10,10,7.0,18785,18696,1869.6,-99,-46,0
7558,1530,2305,1663.7,16637,19339,7.0,6,6,5,245,24.5,0,0,0,1,1,216,21.6,1,5,4,4,6.6,17034,15107,1510.7,-2305,-1530,1
7559,3854,2379,1807.9,18079,19818,7.2,9,9,5,272,27.2,1,1,1,0,0,230,23.0,0,1,2,2,6.8,17439,14225,1422.5,-2379,-3854,1
7560,-450,127,1640.7,16407,18597,6.8,5,5,6,217,21.7,1,0,1,0,1,223,22.3,1,7,7,7,7.0,18470,16857,1685.7,-127,450,1
7561,-1962,-684,1614.5,16145,17448,6.8,6,6,9,215,21.5,0,0,0,1,0,223,22.3,0,12,8,8,7.0,18132,18107,1810.7,684,1962,0
7562,4238,1418,1955.7,19557,18126,6.8,11,11,14,193,19.3,1,0,1,0,1,206,20.6,1,4,5,5,6.8,16708,15319,1531.9,-1418,-4238,1
7563,1037,922,1649.5,16495,18530,7.2,6,6,5,232,23.2,0,0,0,1,0,238,23.8,0,2,3,3,6.6,17608,15458,1545.8,-922,-1037,1
7564,-366,-923,1748.0,17480,17096,6.6,11,11,10,203,20.3,1,1,0,1,0,217,21.7,0,10,9,9,6.6,18019,17846,1784.6,923,366,0
7565,-1673,-1730,1507.4,15074,16329,6.8,2,2,4,225,22.5,0,0,0,1,1,215,21.5,1,10,9,9,7.0,18059,16747,1674.7,1730,1673,1
7566,-6047,-3060,1496.3,14963,15662,6.2,4,4,2,170,17.0,0,0,1,0,1,203,20.3,2,20,14,14,7.0,18722,21010,2101.0,3060,6047,0
7567,-677,-1382,1605.8,16058,17515,7.0,6,6,7,217,21.7,1,1,1,0,0,214,21.4,1,6,8,8,7.2,18897,16735,1673.5,1382,677,1
7568,-2465,-911,1482.4,14824,17975,7.0,2,2,1,214,21.4,0,0,1,0,0,243,24.3,1,6,6,6,7.2,18886,17289,1728.9,911,2465,0
7569,-365,855,1707.9,17079,17964,7.0,7,7,9,212,21.2,1,1,1,0,0,238,23.8,0,10,6,6,6.8,17109,17444,1744.4,-855,365,1
7570,5057,3423,2035.1,20351,19996,7.4,14,14,11,225,22.5,1,1,1,0,0,197,19.7,0,3,4,4,6.6,16573,15294,1529.4,-3423,-5057,1
7571,2292,1022,1873.2,18732,18910,7.2,12,12,11,222,22.2,1,0,1,0,0,213,21.3,0,8,5,5,7.0,17888,16440,1644.0,-1022,-2292,1
7572,5117,4126,1901.7,19017,19432,7.2,10,10,12,240,24.0,1,1,1,0,0,193,19.3,0,4,4,4,6.4,15306,13900,1390.0,-4126,-5117,1
7573,-304,-1023,1707.8,17078,17751,7.0,6,6,7,224,22.4,0,0,1,0,1,240,24.0,1,6,6,6,7.0,18774,17382,1738.2,1023,304,1
7574,390,-828,1535.1,15351,18539,7.0,2,2,2,245,24.5,0,0,0,1,1,235,23.5,2,1,3,3,7.2,19367,14961,1496.1,828,-390,0
7575,-257,-883,1588.5,15885,18531,7.0,3,3,2,243,24.3,1,0,0,1,0,232,23.2,0,6,3,3,7.2,19414,16142,1614.2,883,257,0
7576,3737,1796,1885.1,18851,19227,7.4,10,10,11,252,25.2,0,0,1,0,0,203,20.3,0,4,4,4,7.0,17431,15114,1511.4,-1796,-3737,1
7577,2167,538,1642.5,16425,17611,7.0,4,4,5,227,22.7,0,0,1,0,1,208,20.8,1,4,3,3,6.8,17073,14258,1425.8,-538,-2167,1
7578,-2870,-2023,1564.9,15649,17686,7.0,5,5,4,199,19.9,0,0,0,1,1,229,22.9,1,14,10,10,7.2,19709,18519,1851.9,2023,2870,0
7579,-1962,-2464,1465.9,14659,16241,6.6,4,4,3,192,19.2,0,0,1,0,0,244,24.4,0,6,6,6,7.0,18705,16621,1662.1,2464,1962,1
7580,-704,-531,1598.3,15983,18335,7.2,5,5,7,229,22.9,1,1,0,1,0,205,20.5,0,10,7,7,7.2,18866,16687,1668.7,531,704,0
7581,946,594,1586.8,15868,18299,6.8,4,4,3,222,22.2,1,0,1,0,1,213,21.3,1,4,4,4,6.8,17705,14922,1492.2,-594,-946,1
7582,-496,-1184,1673.2,16732,16963,6.8,9,9,8,208,20.8,1,1,0,1,0,186,18.6,0,9,8,8,7.0,18147,17228,1722.8,1184,496,0
7583,-5395,-5287,1436.6,14366,14866,6.0,4,4,5,171,17.1,0,0,1,0,1,217,21.7,2,18,16,16,7.4,20153,19761,1976.1,5287,5395,0
7584,59,-107,1603.7,16037,18383,7.2,6,6,5,207,20.7,0,0,0,1,1,229,22.9,1,7,6,6,7.0,18490,15978,1597.8,107,-59,1
7585,1550,1042,1764.3,17643,17908,6.8,9,9,9,218,21.8,0,0,0,1,1,183,18.3,2,8,6,6,6.6,16866,16093,1609.3,-1042,-1550,1
7586,-2160,85,1426.1,14261,17724,7.0,1,1,3,198,19.8,1,1,0,1,0,207,20.7,0,11,6,6,6.8,17639,16421,1642.1,-85,2160,0
7587,-1874,-1182,1593.9,15939,17619,6.8,4,4,3,253,25.3,0,0,0,1,0,221,22.1,1,7,11,11,7.0,18801,17813,1781.3,1182,1874,0
7588,-1854,-817,1548.7,15487,18816,7.0,3,3,3,238,23.8,0,0,0,1,1,232,23.2,2,6,6,6,7.2,19633,17341,1734.1,817,1854,0
7589,103,63,1660.1,16601,16246,6.2,8,8,8,196,19.6,1,1,0,1,0,194,19.4,0,6,8,8,6.4,16183,16498,1649.8,-63,-103,0
7590,2575,997,1704.8,17048,17678,6.6,4,4,3,206,20.6,1,0,1,0,1,214,21.4,1,4,3,3,6.8,16681,14473,1447.3,-997,-2575,1
7591,3048,2219,1832.8,18328,18180,7.0,7,7,12,223,22.3,2,1,0,1,0,195,19.5,0,5,5,5,6.6,15961,15280,1528.0,-2219,-3048,1
7592,-2049,-1230,1737.5,17375,18610,6.8,7,7,7,222,22.2,0,0,1,0,1,236,23.6,2,10,11,11,7.4,19840,19424,1942.4,1230,2049,0
7593,2139,850,1655.6,16556,16868,6.6,7,7,9,215,21.5,0,0,0,1,1,176,17.6,1,4,4,4,6.4,16018,14417,1441.7,-850,-2139,1
7594,7980,4916,2188.3,21883,20941,7.8,15,15,17,252,25.2,1,1,1,0,0,193,19.3,0,0,2,2,6.4,16025,13903,1390.3,-4916,-7980,1
7595,1103,1117,1738.2,17382,19283,7.2,9,9,11,220,22.0,0,0,1,0,0,209,20.9,0,10,7,7,7.2,18166,16279,1627.9,-1117,-1103,0
7596,6547,2553,2079.5,20795,18944,7.2,13,13,15,249,24.9,2,1,0,1,0,179,17.9,0,1,3,3,6.6,16391,14248,1424.8,-2553,-6547,1
7597,-2472,-554,1546.9,15469,17314,6.6,4,4,3,234,23.4,0,0,0,1,1,227,22.7,2,8,9,9,6.8,17868,17941,1794.1,554,2472,0
7598,1464,179,1795.1,17951,18755,7.2,9,9,10,228,22.8,1,1,1,0,0,233,23.3,1,7,6,6,6.8,18576,16487,1648.7,-179,-1464,1
7599,-4683,-3444,1520.5,15205,15267,6.4,6,6,6,166,16.6,0,0,0,1,1,220,22.0,1,15,15,15,7.2,18711,19888,1988.8,3444,4683,0
7600,4277,3340,1783.5,17835,18812,7.2,9,9,9,231,23.1,1,1,1,0,0,207,20.7,1,0,0,0,6.2,15472,13558,1355.8,-3340,-4277,1
7601,1870,1791,1732.9,17329,19681,7.4,7,7,8,224,22.4,0,0,1,0,1,243,24.3,1,3,4,4,6.8,17890,15459,1545.9,-1791,-1870,1
7602,499,-2,1499.2,14992,17212,6.8,3,3,3,217,21.7,2,1,1,0,0,230,23.0,0,3,2,2,7.0,17214,14493,1449.3,2,-499,1
7603,832,903,1703.3,17033,17938,7.0,8,8,7,232,23.2,0,0,1,0,1,228,22.8,2,8,5,5,6.8,17035,16201,1620.1,-903,-832,1
7604,1782,2856,1753.5,17535,19338,7.2,9,9,4,236,23.6,1,0,0,1,1,207,20.7,1,6,5,5,6.8,16482,15753,1575.3,-2856,-1782,0
7605,-177,-308,1764.5,17645,18506,7.0,9,9,10,201,20.1,0,0,1,0,1,206,20.6,1,11,11,11,7.4,18814,17822,1782.2,308,177,0
7606,-2692,-2753,1652.3,16523,17836,7.0,7,7,6,219,21.9,0,0,0,1,1,176,17.6,1,12,15,15,7.6,20589,19215,1921.5,2753,2692,0
7607,-1976,-2992,1463.0,14630,16426,6.4,4,4,4,188,18.8,0,0,0,1,1,230,23.0,1,7,7,7,7.4,19418,16606,1660.6,2992,1976,0
7608,-642,311,1761.7,17617,18621,7.0,9,9,9,245,24.5,1,1,0,1,0,236,23.6,0,11,8,8,6.8,18310,18259,1825.9,-311,642,0
7609,1051,-1411,1814.2,18142,16864,6.8,7,7,10,209,20.9,1,0,1,0,1,183,18.3,1,8,11,11,7.2,18275,17091,1709.1,1411,-1051,0
7610,932,-534,1606.8,16068,17607,6.6,4,4,6,235,23.5,0,0,1,0,0,241,24.1,0,2,2,2,7.0,18141,15136,1513.6,534,-932,1
7611,1197,-947,1804.1,18041,17904,7.0,5,5,5,229,22.9,1,0,1,0,1,224,22.4,1,7,6,6,7.4,18851,16844,1684.4,947,-1197,0
7612,2858,2734,1758.3,17583,18536,7.2,11,11,11,223,22.3,1,0,1,0,0,190,19.0,0,2,4,4,6.4,15802,14725,1472.5,-2734,-2858,1
7613,202,686,1538.1,15381,17303,6.8,4,4,4,198,19.8,1,0,0,1,0,214,21.4,0,6,4,4,6.6,16617,15179,1517.9,-686,-202,1
7614,-688,-1113,1592.9,15929,17996,7.0,3,3,4,236,23.6,1,1,1,0,0,269,26.9,0,4,4,4,7.2,19109,16617,1661.7,1113,688,0
7615,6289,3996,2113.2,21132,19941,7.6,13,13,13,217,21.7,1,1,1,0,0,179,17.9,0,6,5,5,6.4,15945,14843,1484.3,-3996,-6289,1
7616,-4075,-3154,1402.2,14022,16586,6.8,1,1,1,223,22.3,0,0,0,1,1,211,21.1,2,7,8,8,7.2,19740,18097,1809.7,3154,4075,0
7617,651,2427,1678.6,16786,18389,7.0,8,8,7,250,25.0,1,1,0,1,0,201,20.1,1,3,3,3,6.4,15962,16135,1613.5,-2427,-651,0
7618,-1882,-1917,1717.1,17171,18333,6.8,6,6,8,254,25.4,0,0,0,1,1,218,21.8,2,6,11,11,7.6,20250,19053,1905.3,1917,1882,0
7619,-695,-683,1600.4,16004,18381,7.0,6,6,6,216,21.6,1,1,1,0,0,240,24.0,0,6,6,6,7.0,19064,16699,1669.9,683,695,1
7620,711,1614,1604.3,16043,18432,7.0,4,4,4,237,23.7,1,0,0,1,1,209,20.9,1,5,3,3,6.8,16818,15332,1533.2,-1614,-711,0
7621,-325,-231,1572.0,15720,17797,6.8,7,7,5,185,18.5,1,1,0,1,0,200,20.0,0,4,7,7,7.0,18028,16045,1604.5,231,325,0
7622,-341,-1582,1445.1,14451,16951,6.6,3,3,2,213,21.3,1,1,1,0,0,231,23.1,0,3,4,4,7.2,18533,14792,1479.2,1582,341,0
7623,-284,-260,1555.1,15551,17239,6.6,5,5,2,209,20.9,2,1,0,1,0,228,22.8,0,5,4,4,6.8,17499,15835,1583.5,260,284,1
7624,-37,-382,1657.4,16574,18040,6.8,5,5,5,231,23.1,0,0,1,0,0,209,20.9,0,10,8,8,7.0,18422,16611,1661.1,382,37,0
7625,-2234,-2021,1426.4,14264,15870,6.2,3,3,3,201,20.1,0,0,0,1,1,204,20.4,1,6,8,8,6.8,17891,16498,1649.8,2021,2234,0
7626,-299,-238,1522.3,15223,17157,6.8,3,3,6,217,21.7,0,0,1,0,1,203,20.3,1,7,4,4,6.8,17395,15522,1552.2,238,299,1
7627,-3046,-1990,1436.6,14366,16510,6.6,2,2,2,221,22.1,0,0,0,1,1,222,22.2,1,15,9,9,7.2,18500,17412,1741.2,1990,3046,0
7628,-259,357,1686.0,16860,19037,7.2,6,6,4,239,23.9,1,0,0,1,0,238,23.8,0,6,8,8,7.2,18680,17119,1711.9,-357,259,0
7629,2095,1876,1779.1,17791,19229,7.2,9,9,10,219,21.9,1,0,1,0,1,214,21.4,1,8,4,4,7.0,17353,15696,1569.6,-1876,-2095,1
7630,4597,3583,1806.6,18066,18920,7.0,8,8,8,242,24.2,1,0,1,0,1,189,18.9,1,1,1,1,6.4,15337,13469,1346.9,-3583,-4597,1
7631,4151,3492,2024.5,20245,21086,7.6,11,11,13,240,24.0,0,0,1,0,0,171,17.1,0,9,6,6,7.0,17594,16094,1609.4,-3492,-4151,1
7632,-3,-765,1541.3,15413,16314,6.4,5,5,6,210,21.0,0,0,0,1,0,221,22.1,0,4,5,5,6.6,17079,15416,1541.6,765,3,1
7633,1215,1170,1551.0,15510,17649,7.0,5,5,1,203,20.3,0,0,1,0,1,244,24.4,1,2,2,2,6.6,16479,14295,1429.5,-1170,-1215,1
7634,-2279,-2155,1583.8,15838,17892,7.0,5,5,8,236,23.6,1,1,0,1,0,235,23.5,0,7,11,11,7.4,20047,18117,1811.7,2155,2279,0
7635,771,1255,1602.9,16029,19239,7.4,4,4,2,236,23.6,1,1,1,0,0,208,20.8,1,3,3,3,7.0,17984,15258,1525.8,-1255,-771,1
7636,-1288,-685,1450.6,14506,17908,7.2,2,2,2,230,23.0,1,1,0,1,0,217,21.7,0,5,3,3,7.0,18593,15794,1579.4,685,1288,0
7637,-4408,-4522,1529.3,15293,15389,6.4,5,5,7,202,20.2,0,0,0,1,1,250,25.0,2,2,7,7,7.4,19911,19701,1970.1,4522,4408,0
7638,-3385,-2980,1479.6,14796,16448,6.4,3,3,2,204,20.4,0,0,0,1,1,223,22.3,2,10,10,10,7.4,19428,18181,1818.1,2980,3385,0
7639,-1691,-1608,1414.2,14142,16922,6.8,1,1,1,229,22.9,2,1,0,1,0,234,23.4,0,4,4,4,7.0,18530,15833,1583.3,1608,1691,0
7640,995,707,1589.0,15890,18495,7.0,5,5,2,232,23.2,0,0,1,0,1,219,21.9,1,4,2,2,6.8,17788,14895,1489.5,-707,-995,0
7641,2402,2023,1704.0,17040,18270,6.8,8,8,15,191,19.1,1,1,0,1,0,228,22.8,0,1,1,1,6.6,16247,14638,1463.8,-2023,-2402,1
7642,-25,954,1619.6,16196,18801,7.2,6,6,5,214,21.4,1,1,1,0,0,217,21.7,0,8,6,6,6.8,17847,16221,1622.1,-954,25,0
7643,1221,494,1637.3,16373,18169,7.0,8,8,5,188,18.8,1,1,1,0,0,209,20.9,0,4,5,5,7.0,17675,15152,1515.2,-494,-1221,0
7644,1841,-591,1750.5,17505,17635,6.8,10,10,11,224,22.4,0,0,0,1,1,197,19.7,1,2,5,5,6.8,18226,15664,1566.4,591,-1841,0
7645,4368,3523,1863.5,18635,19958,7.2,11,11,8,230,23.0,2,1,1,0,0,208,20.8,0,0,1,1,6.6,16435,14267,1426.7,-3523,-4368,1
7646,2052,2845,1680.7,16807,19662,7.2,6,6,5,232,23.2,2,1,0,1,0,216,21.6,0,1,3,3,6.8,16817,14755,1475.5,-2845,-2052,0
7647,-1725,-2264,1684.2,16842,16280,6.4,8,8,12,210,21.0,1,0,1,0,1,192,19.2,1,13,11,11,7.0,18544,18567,1856.7,2264,1725,0
7648,1479,1002,1696.3,16963,17360,6.8,8,8,8,203,20.3,0,0,0,1,1,173,17.3,1,10,6,6,6.6,16358,15484,1548.4,-1002,-1479,1
7649,-674,909,1658.7,16587,17801,6.8,7,7,11,216,21.6,0,0,0,1,0,219,21.9,0,8,6,6,6.6,16892,17261,1726.1,-909,674,0
7650,3993,2165,1840.4,18404,19768,7.4,8,8,8,245,24.5,1,1,1,0,0,188,18.8,0,6,3,3,7.2,17603,14411,1441.1,-2165,-3993,1
7651,-2522,-1763,1590.1,15901,18666,7.0,4,4,5,245,24.5,1,1,0,1,0,250,25.0,0,7,8,8,7.6,20429,18423,1842.3,1763,2522,0
7652,1858,1429,1749.5,17495,19239,7.0,9,9,11,235,23.5,1,0,1,0,1,215,21.5,1,3,4,4,6.8,17810,15637,1563.7,-1429,-1858,1
7653,-996,-1894,1489.1,14891,17103,6.6,4,4,7,210,21.0,1,1,0,1,0,261,26.1,0,3,3,3,7.0,18997,15887,1588.7,1894,996,0
7654,-346,316,1607.2,16072,18312,7.0,6,6,3,229,22.9,0,0,0,1,1,241,24.1,1,6,6,6,6.8,17996,16418,1641.8,-316,346,1
7655,-1946,-1148,1546.0,15460,16868,6.6,5,5,4,184,18.4,0,0,0,1,0,250,25.0,0,8,7,7,7.0,18016,17406,1740.6,1148,1946,0
7656,-775,-412,1670.8,16708,17428,7.0,8,8,9,193,19.3,0,0,1,0,0,178,17.8,0,8,11,11,7.0,17840,17483,1748.3,412,775,0
7657,-1963,-1936,1827.5,18275,17102,6.6,12,12,15,173,17.3,1,0,1,0,1,214,21.4,1,20,13,13,7.2,19038,20238,2023.8,1936,1963,1
7658,-6199,-4997,1378.5,13785,15847,6.4,2,2,2,195,19.5,0,0,0,1,0,249,24.9,1,6,9,9,7.6,20844,19984,1998.4,4997,6199,0
7659,520,941,1859.6,18596,20017,7.6,11,11,11,198,19.8,0,0,0,1,0,207,20.7,0,9,13,13,7.2,19076,18076,1807.6,-941,-520,1
7660,-243,860,1596.4,15964,17988,6.8,5,5,8,206,20.6,0,0,0,1,1,205,20.5,2,8,6,6,6.6,17128,16207,1620.7,-860,243,1
7661,3314,2262,1834.3,18343,18609,6.8,8,8,11,246,24.6,0,0,1,0,0,204,20.4,0,4,4,4,6.6,16347,15029,1502.9,-2262,-3314,1
7662,1680,2384,1707.9,17079,19361,7.4,4,4,0,250,25.0,1,0,0,1,0,200,20.0,0,3,4,4,6.6,16977,15399,1539.9,-2384,-1680,1
7663,5025,3609,1963.9,19639,19564,7.2,13,13,11,239,23.9,2,1,1,0,0,147,14.7,0,8,5,5,6.4,15955,14614,1461.4,-3609,-5025,1
7664,4426,2385,2056.0,20560,19784,7.4,12,12,19,216,21.6,0,0,1,0,0,206,20.6,0,6,6,6,6.6,17399,16134,1613.4,-2385,-4426,1
7665,-1937,-1459,1501.3,15013,16013,6.6,4,4,5,210,21.0,0,0,0,1,0,197,19.7,1,10,7,7,6.8,17472,16950,1695.0,1459,1937,1
7666,1481,996,1584.6,15846,18039,6.8,6,6,5,201,20.1,0,0,0,1,0,208,20.8,0,2,3,3,7.0,17043,14365,1436.5,-996,-1481,0
7667,-3643,-3628,1501.8,15018,15571,6.4,3,3,6,192,19.2,0,0,0,1,1,220,22.0,1,18,10,10,7.0,19199,18661,1866.1,3628,3643,0
7668,-2240,-1945,1612.3,16123,16738,6.6,6,6,4,194,19.4,0,0,1,0,0,223,22.3,0,13,10,10,6.8,18683,18363,1836.3,1945,2240,0
7669,2027,2259,1716.6,17166,20100,7.4,8,8,8,208,20.8,1,1,1,0,0,218,21.8,0,1,3,3,6.8,17841,15139,1513.9,-2259,-2027,1
7670,-2844,-2533,1543.1,15431,17257,6.8,3,3,3,237,23.7,1,1,0,1,0,221,22.1,0,11,9,9,7.2,19790,18275,1827.5,2533,2844,1
7671,500,1220,1481.4,14814,18414,7.0,2,2,1,233,23.3,0,0,1,0,0,213,21.3,1,5,2,2,6.8,17194,14314,1431.4,-1220,-500,1
7672,-315,-293,1755.4,17554,19237,7.4,9,9,9,243,24.3,0,0,0,1,0,179,17.9,0,7,12,12,7.4,19530,17869,1786.9,293,315,0
7673,-4625,-3193,1445.0,14450,16178,6.4,4,4,4,191,19.1,0,0,1,0,0,236,23.6,0,11,10,10,7.2,19371,19075,1907.5,3193,4625,0
7674,-2162,-1230,1519.3,15193,16021,6.4,6,6,8,199,19.9,0,0,0,1,1,205,20.5,1,11,8,8,6.6,17251,17355,1735.5,1230,2162,0
7675,4170,4481,1914.0,19140,20293,7.4,10,10,6,257,25.7,0,0,0,1,0,171,17.1,0,3,5,5,6.4,15812,14970,1497.0,-4481,-4170,1
7676,-473,-1354,1638.8,16388,17884,6.8,6,6,8,236,23.6,1,1,1,0,0,235,23.5,0,9,6,6,7.4,19238,16861,1686.1,1354,473,1
7677,3248,2592,1853.2,18532,19666,7.6,11,11,9,202,20.2,2,1,1,0,0,164,16.4,0,6,5,5,6.6,17074,15284,1528.4,-2592,-3248,1
7678,-5624,-4155,1433.2,14332,15949,6.4,2,2,3,219,21.9,0,0,0,1,1,226,22.6,1,19,14,14,7.4,20104,19956,1995.6,4155,5624,0
7679,-1769,-587,1469.7,14697,17577,6.8,2,2,5,230,23.0,1,1,0,1,0,254,25.4,0,6,6,6,7.0,18164,16466,1646.6,587,1769,0
7680,-2238,-1138,1573.1,15731,17396,6.8,6,6,9,236,23.6,1,1,0,1,0,235,23.5,0,8,8,8,7.2,18534,17969,1796.9,1138,2238,0
7681,-3756,-1406,1388.1,13881,16578,6.6,1,1,0,215,21.5,0,0,0,1,1,184,18.4,1,10,10,10,7.2,17984,17637,1763.7,1406,3756,0
7682,-2314,-1903,1585.7,15857,16404,6.6,7,7,7,177,17.7,0,0,1,0,1,203,20.3,2,8,8,8,6.8,18307,18171,1817.1,1903,2314,0
7683,-207,-1282,1613.1,16131,17990,7.0,4,4,4,242,24.2,0,0,1,0,0,223,22.3,1,3,6,6,7.2,19272,16338,1633.8,1282,207,1
7684,2445,1807,1934.9,19349,19673,7.2,11,11,12,219,21.9,1,1,1,0,0,194,19.4,0,10,8,8,6.8,17866,16904,1690.4,-1807,-2445,1
7685,2073,2090,1673.1,16731,17558,7.0,6,6,11,239,23.9,0,0,1,0,0,203,20.3,0,4,4,4,6.4,15468,14658,1465.8,-2090,-2073,1
7686,2012,2314,1836.3,18363,20591,7.6,8,8,10,250,25.0,0,0,0,1,1,221,22.1,2,4,4,4,7.0,18277,16351,1635.1,-2314,-2012,1
7687,-1740,-916,1513.2,15132,17149,6.6,5,5,4,196,19.6,0,0,0,1,1,230,23.0,1,8,7,7,6.8,18065,16872,1687.2,916,1740,0
7688,1959,2441,1739.3,17393,19257,7.2,8,8,7,219,21.9,1,1,0,1,0,212,21.2,0,7,5,5,6.6,16816,15434,1543.4,-2441,-1959,1
7689,1471,187,1561.5,15615,18309,6.8,3,3,4,237,23.7,0,0,1,0,0,187,18.7,0,1,1,1,6.8,18122,14144,1414.4,-187,-1471,0
7690,-3859,-2011,1535.8,15358,16660,6.6,4,4,6,213,21.3,0,0,0,1,1,216,21.6,1,10,12,12,6.8,18671,19217,1921.7,2011,3859,0
7691,-2566,-1797,1393.6,13936,16231,6.6,1,1,1,235,23.5,0,0,0,1,1,264,26.4,1,5,5,5,7.0,18028,16502,1650.2,1797,2566,0
7692,-1518,-1106,1704.7,17047,18719,7.2,10,10,7,202,20.2,0,0,0,1,1,256,25.6,1,5,10,10,7.4,19825,18565,1856.5,1106,1518,1
7693,1387,702,1635.0,16350,18813,7.2,6,6,5,233,23.3,1,1,1,0,0,217,21.7,0,3,3,3,6.8,18111,14963,1496.3,-702,-1387,1
7694,370,726,1644.4,16444,18703,7.0,6,6,5,207,20.7,1,1,0,1,0,226,22.6,0,3,6,6,6.8,17977,16074,1607.4,-726,-370,1
7695,7605,3993,2170.3,21703,19827,7.2,17,17,20,202,20.2,1,1,1,0,0,177,17.7,1,2,4,4,6.4,15834,14098,1409.8,-3993,-7605,1
7696,-609,-1011,1652.6,16526,17292,6.6,9,9,8,194,19.4,0,0,0,1,0,228,22.8,0,10,9,9,7.0,18303,17135,1713.5,1011,609,0
7697,-501,-1154,1469.8,14698,17544,6.8,2,2,2,208,20.8,0,0,1,0,1,227,22.7,1,2,3,3,7.2,18698,15199,1519.9,1154,501,0
7698,-486,180,1532.9,15329,17425,6.8,4,4,5,210,21.0,0,0,0,1,1,218,21.8,1,9,5,5,6.8,17245,15815,1581.5,-180,486,1
7699,-1108,-370,1474.6,14746,17610,6.8,3,3,0,206,20.6,1,1,1,0,0,210,21.0,0,6,6,6,7.0,17980,15854,1585.4,370,1108,0
7700,-152,16,1583.1,15831,17839,7.2,4,4,5,247,24.7,0,0,0,1,0,243,24.3,0,6,4,4,7.0,17823,15983,1598.3,-16,152,0
7701,1501,274,1857.5,18575,18686,7.2,8,8,8,228,22.8,0,0,0,1,0,219,21.9,0,7,8,8,7.2,18412,17074,1707.4,-274,-1501,1
7702,1829,1496,1680.3,16803,19509,7.4,6,6,9,242,24.2,0,0,1,0,1,239,23.9,1,2,2,2,7.0,18013,14974,1497.4,-1496,-1829,1
7703,-790,-741,1666.6,16666,18258,7.2,5,5,4,236,23.6,1,1,1,0,0,230,23.0,0,7,7,7,7.2,18999,17456,1745.6,741,790,0
7704,1885,1082,1861.6,18616,19395,7.4,10,10,10,213,21.3,1,1,1,0,0,189,18.9,0,9,9,9,7.0,18313,16731,1673.1,-1082,-1885,1
7705,-1348,-2082,1493.9,14939,16939,6.4,2,2,2,218,21.8,0,0,1,0,0,250,25.0,1,4,5,5,7.4,19021,16287,1628.7,2082,1348,1
7706,-47,-888,1682.8,16828,17628,6.8,8,8,8,227,22.7,0,0,0,1,1,240,24.0,1,10,6,6,7.0,18516,16875,1687.5,888,47,1
7707,-1091,-617,1539.8,15398,17243,6.8,4,4,5,213,21.3,0,0,0,1,1,222,22.2,2,5,7,7,6.8,17860,16489,1648.9,617,1091,0
7708,-1808,-1818,1408.7,14087,16178,6.4,2,2,1,217,21.7,1,1,0,1,0,183,18.3,0,7,6,6,7.2,17996,15895,1589.5,1818,1808,1
7709,2061,924,1708.1,17081,18350,7.2,6,6,8,226,22.6,1,1,0,1,0,218,21.8,0,3,4,4,6.8,17426,15020,1502.0,-924,-2061,1
7710,-872,-432,1621.6,16216,17978,7.0,4,4,4,233,23.3,0,0,0,1,0,213,21.3,1,8,7,7,7.0,18410,17088,1708.8,432,872,0
7711,-1682,-2102,1717.4,17174,16698,6.8,9,9,16,186,18.6,0,0,0,1,1,221,22.1,1,15,11,11,7.2,18800,18856,1885.6,2102,1682,1
7712,-262,-1246,1716.1,17161,17805,6.8,8,8,7,227,22.7,0,0,1,0,1,202,20.2,1,10,8,8,7.0,19051,17423,1742.3,1246,262,0
7713,4108,2927,1811.9,18119,18951,7.0,12,12,13,198,19.8,0,0,0,1,1,179,17.9,1,1,4,4,6.4,16024,14011,1401.1,-2927,-4108,1
7714,-2398,-2326,1533.2,15332,16368,6.6,5,5,4,187,18.7,0,0,1,0,1,202,20.2,1,8,11,11,7.2,18694,17730,1773.0,2326,2398,0
7715,-167,309,1638.6,16386,18530,7.2,5,5,10,218,21.8,0,0,0,1,0,230,23.0,1,3,4,4,7.0,18221,16553,1655.3,-309,167,0
7716,3105,2085,1859.1,18591,20081,7.4,9,9,8,260,26.0,2,1,1,0,0,208,20.8,0,5,4,4,6.8,17996,15486,1548.6,-2085,-3105,1
7717,-1208,-1365,1613.8,16138,17626,6.8,6,6,8,178,17.8,1,0,1,0,1,215,21.5,1,7,8,8,7.2,18991,17346,1734.6,1365,1208,0
7718,4088,2662,1866.2,18662,19321,7.4,7,7,3,255,25.5,1,1,1,0,0,209,20.9,0,2,2,2,6.6,16659,14574,1457.4,-2662,-4088,1
7719,2042,1127,1645.4,16454,18576,7.0,7,7,9,207,20.7,0,0,0,1,0,195,19.5,0,1,2,2,6.8,17449,14412,1441.2,-1127,-2042,1
7720,-4801,-5205,1579.7,15797,15229,6.2,8,8,9,168,16.8,1,1,0,1,0,219,21.9,0,14,15,15,7.4,20434,20598,2059.8,5205,4801,0
7721,192,-1312,1602.8,16028,17147,6.8,6,6,7,220,22.0,1,1,1,0,0,211,21.1,0,3,5,5,7.2,18459,15836,1583.6,1312,-192,1
7722,-566,-3406,1514.2,15142,14696,6.2,6,6,8,178,17.8,1,1,1,0,0,246,24.6,0,2,4,4,7.0,18102,15708,1570.8,3406,566,1
7723,1651,402,1684.9,16849,16993,6.6,7,7,8,205,20.5,2,1,1,0,0,207,20.7,0,7,4,4,6.6,16591,15198,1519.8,-402,-1651,1
7724,4646,3861,2006.6,20066,19018,7.2,15,15,13,209,20.9,1,0,0,1,0,193,19.3,0,7,7,7,6.0,15157,15420,1542.0,-3861,-4646,0
7725,-980,-684,1431.2,14312,17694,6.8,2,2,0,216,21.6,0,0,1,0,0,236,23.6,0,0,3,3,7.0,18378,15292,1529.2,684,980,0
7726,2264,1130,1678.6,16786,19003,7.4,5,5,7,260,26.0,0,0,1,0,1,247,24.7,2,1,1,1,6.8,17873,14522,1452.2,-1130,-2264,1
7727,-1673,-787,1429.9,14299,17111,6.8,2,2,1,211,21.1,1,1,0,1,0,228,22.8,0,8,5,5,7.0,17898,15972,1597.2,787,1673,0
7728,-866,-2133,1572.4,15724,15396,6.2,8,8,14,203,20.3,0,0,1,0,0,198,19.8,1,5,6,6,7.0,17529,16590,1659.0,2133,866,0
7729,-1402,-90,1482.8,14828,18224,7.2,2,2,1,234,23.4,0,0,0,1,1,230,23.0,1,10,5,5,7.2,18314,16230,1623.0,90,1402,1
7730,-445,-293,1629.4,16294,17550,6.6,8,8,8,186,18.6,2,1,0,1,0,193,19.3,0,6,6,6,6.8,17843,16739,1673.9,293,445,1
7731,-802,-1243,1576.1,15761,17783,7.0,4,4,4,230,23.0,0,0,0,1,0,247,24.7,0,5,5,5,7.4,19026,16563,1656.3,1243,802,1
7732,179,-417,1456.5,14565,16719,6.4,4,4,7,192,19.2,0,0,1,0,1,199,19.9,1,2,3,3,6.6,17136,14386,1438.6,417,-179,0
7733,886,706,1571.1,15711,17395,7.0,4,4,7,223,22.3,0,0,1,0,1,225,22.5,1,4,3,3,6.8,16689,14825,1482.5,-706,-886,1
7734,1409,2205,1611.6,16116,19219,7.2,7,7,2,246,24.6,1,1,1,0,0,203,20.3,0,2,2,2,6.8,17014,14707,1470.7,-2205,-1409,1
7735,-3259,-1518,1462.9,14629,16283,6.8,4,4,8,183,18.3,0,0,0,1,1,210,21.0,2,16,10,10,7.0,17801,17888,1788.8,1518,3259,1
7736,1074,237,1569.4,15694,17914,6.8,4,4,5,219,21.9,1,1,1,0,0,210,21.0,0,2,3,3,6.8,17677,14620,1462.0,-237,-1074,0
7737,1016,2078,1704.1,17041,18750,7.4,7,7,6,232,23.2,0,0,0,1,1,211,21.1,1,7,6,6,6.6,16672,16025,1602.5,-2078,-1016,0
7738,-697,-1133,1547.8,15478,18118,7.0,3,3,3,214,21.4,0,0,0,1,1,244,24.4,2,4,5,5,7.2,19251,16175,1617.5,1133,697,0
7739,399,1148,1695.6,16956,18267,7.0,7,7,9,229,22.9,0,0,1,0,1,187,18.7,2,12,7,7,6.8,17119,16557,1655.7,-1148,-399,0
7740,-387,1466,1695.6,16956,19562,7.2,4,4,2,252,25.2,0,0,0,1,1,236,23.6,1,11,10,10,7.0,18096,17343,1734.3,-1466,387,1
7741,3456,3233,1917.2,19172,18959,7.0,11,11,5,242,24.2,2,1,1,0,0,197,19.7,0,5,5,5,6.4,15726,15716,1571.6,-3233,-3456,1
7742,1486,991,1697.9,16979,18700,7.2,8,8,5,213,21.3,0,0,1,0,0,200,20.0,0,3,5,5,7.0,17709,15493,1549.3,-991,-1486,1
7743,-2194,-1240,1480.6,14806,17653,6.8,2,2,3,211,21.1,0,0,0,1,1,247,24.7,1,7,6,6,7.0,18893,17000,1700.0,1240,2194,0
7744,-173,-989,1824.4,18244,18223,7.0,7,7,9,205,20.5,1,1,0,1,0,210,21.0,0,9,10,10,7.0,19212,18417,1841.7,989,173,0
7745,2000,1065,1698.9,16989,18031,7.0,5,5,7,256,25.6,0,0,1,0,1,206,20.6,1,7,4,4,6.8,16966,14989,1498.9,-1065,-2000,1
7746,-7666,-5484,1428.1,14281,13851,6.2,3,3,3,183,18.3,0,0,0,1,0,231,23.1,1,15,15,15,7.2,19335,21947,2194.7,5484,7666,0
7747,1875,1361,1539.3,15393,17028,6.8,2,2,2,230,23.0,0,0,1,0,0,215,21.5,0,0,0,0,6.4,15667,13518,1351.8,-1361,-1875,1
7748,2578,1160,1763.6,17636,19295,7.4,8,8,9,249,24.9,1,1,1,0,0,232,23.2,1,1,3,3,7.0,18135,15058,1505.8,-1160,-2578,1
7749,-629,-1232,1660.0,16600,17594,6.8,6,6,10,213,21.3,0,0,0,1,0,203,20.3,0,10,9,9,7.0,18826,17229,1722.9,1232,629,1
7750,-1253,17,1588.9,15889,18326,7.0,7,7,10,228,22.8,0,0,1,0,0,225,22.5,0,7,6,6,7.0,18309,17142,1714.2,-17,1253,0
7751,1675,-423,1965.7,19657,18537,7.0,13,13,10,204,20.4,0,0,1,0,1,202,20.2,1,9,8,8,7.2,18960,17982,1798.2,423,-1675,0
7752,3138,2806,1681.8,16818,18454,7.0,8,8,5,231,23.1,0,0,1,0,1,196,19.6,2,0,3,3,6.4,15648,13680,1368.0,-2806,-3138,1
7753,2148,1502,1741.5,17415,19432,7.2,8,8,6,246,24.6,2,1,1,0,0,212,21.2,0,1,3,3,6.8,17930,15267,1526.7,-1502,-2148,1
7754,2919,2298,1660.2,16602,19275,7.2,6,6,7,246,24.6,0,0,1,0,0,214,21.4,0,0,1,1,6.6,16977,13683,1368.3,-2298,-2919,1
7755,-2692,-1609,1718.1,17181,18481,7.0,7,7,13,184,18.4,0,0,1,0,1,191,19.1,1,20,15,15,7.4,20090,19873,1987.3,1609,2692,0
7756,-499,-295,1649.2,16492,16905,6.6,7,7,6,202,20.2,1,0,1,0,1,220,22.0,1,10,7,7,6.8,17200,16991,1699.1,295,499,1
7757,75,644,1641.0,16410,18121,6.8,4,4,6,236,23.6,1,1,1,0,0,201,20.1,0,7,6,6,7.0,17477,16335,1633.5,-644,-75,0
7758,-1314,-1498,1523.8,15238,16831,6.8,3,3,5,209,20.9,0,0,0,1,0,226,22.6,0,6,5,5,6.8,18329,16552,1655.2,1498,1314,0
7759,3243,1919,2027.1,20271,19487,7.2,16,16,18,200,20.0,1,1,1,0,0,235,23.5,0,8,7,7,6.8,17568,17028,1702.8,-1919,-3243,1
7760,-443,-732,1537.2,15372,17632,7.0,5,5,2,228,22.8,0,0,1,0,0,237,23.7,0,3,4,4,7.2,18364,15815,1581.5,732,443,0
7761,-1844,-1368,1493.0,14930,16710,6.6,3,3,4,222,22.2,0,0,0,1,1,212,21.2,1,9,9,9,6.8,18078,16774,1677.4,1368,1844,0
7762,270,638,1745.0,17450,18989,7.2,8,8,10,236,23.6,0,0,1,0,0,220,22.0,1,5,7,7,6.8,18351,17180,1718.0,-638,-270,1
7763,1221,-311,1481.2,14812,17296,6.6,1,1,1,254,25.4,0,0,1,0,1,214,21.4,1,0,0,0,6.8,17607,13591,1359.1,311,-1221,1
7764,1132,778,1760.5,17605,19074,7.2,9,9,10,241,24.1,0,0,0,1,0,219,21.9,0,5,5,5,7.0,18296,16473,1647.3,-778,-1132,0
7765,-1482,-724,1684.1,16841,17341,6.8,5,5,5,234,23.4,0,0,0,1,1,199,19.9,1,11,9,9,7.0,18065,18323,1832.3,724,1482,0
7766,1151,-108,1632.1,16321,18143,7.0,5,5,8,249,24.9,2,1,1,0,0,218,21.8,0,4,3,3,7.0,18251,15170,1517.0,108,-1151,1
7767,-143,708,1627.0,16270,17716,6.8,5,5,7,230,23.0,1,0,0,1,1,206,20.6,1,8,8,8,6.6,17008,16413,1641.3,-708,143,1
7768,305,-374,1595.4,15954,17461,7.0,7,7,5,191,19.1,1,1,1,0,0,234,23.4,0,9,5,5,6.8,17835,15649,1564.9,374,-305,1
7769,-438,-778,1568.2,15682,18027,7.0,5,5,0,247,24.7,1,1,0,1,0,206,20.6,0,6,6,6,7.0,18805,16120,1612.0,778,438,0
7770,-3531,-1781,1619.0,16190,17466,7.0,5,5,6,215,21.5,0,0,0,1,1,236,23.6,1,21,11,11,7.2,19247,19721,1972.1,1781,3531,0
7771,3987,1169,1957.2,19572,18020,7.0,12,12,16,213,21.3,2,1,0,1,0,193,19.3,0,6,5,5,6.6,16851,15585,1558.5,-1169,-3987,1
7772,179,-962,1593.0,15930,17859,6.8,5,5,5,236,23.6,0,0,0,1,1,225,22.5,2,4,5,5,7.2,18821,15751,1575.1,962,-179,0
7773,-4124,-3090,1378.5,13785,16211,6.8,1,1,1,215,21.5,0,0,0,1,1,260,26.0,1,13,10,10,7.2,19301,17909,1790.9,3090,4124,0
7774,2927,3135,1689.8,16898,19309,7.2,6,6,7,247,24.7,1,0,1,0,0,212,21.2,0,2,2,2,6.6,16174,13971,1397.1,-3135,-2927,1
7775,1665,1578,1833.3,18333,18853,6.8,7,7,5,229,22.9,2,1,0,1,0,181,18.1,0,15,7,7,6.8,17275,16668,1666.8,-1578,-1665,1
7776,-2946,-2952,1428.9,14289,16754,6.8,1,1,1,220,22.0,1,1,0,1,0,223,22.3,0,7,6,6,7.2,19706,17235,1723.5,2952,2946,0
7777,1440,1148,1650.1,16501,18045,7.0,7,7,13,208,20.8,0,0,1,0,0,258,25.8,0,2,3,3,6.8,16897,15061,1506.1,-1148,-1440,1
7778,2263,1451,1661.8,16618,19643,7.2,5,5,5,250,25.0,0,0,1,0,0,243,24.3,0,1,1,1,6.8,18192,14355,1435.5,-1451,-2263,1
7779,1878,703,1655.7,16557,18637,7.2,6,6,6,261,26.1,2,1,1,0,0,233,23.3,0,0,0,0,7.0,17934,14679,1467.9,-703,-1878,0
7780,-4259,-3503,1697.8,16978,13699,5.6,11,11,10,158,15.8,0,0,1,0,0,203,20.3,1,21,14,14,7.0,17202,21237,2123.7,3503,4259,0
7781,-1311,-1472,1657.7,16577,16338,6.6,6,6,6,221,22.1,0,0,0,1,1,169,16.9,1,12,10,10,7.0,17810,17888,1788.8,1472,1311,0
7782,-3856,-1959,1470.6,14706,16463,6.6,4,4,2,195,19.5,0,0,1,0,0,250,25.0,0,14,9,9,7.0,18422,18562,1856.2,1959,3856,0
7783,-1317,-816,1679.5,16795,18170,6.8,7,7,8,217,21.7,0,0,0,1,1,247,24.7,1,14,9,9,7.4,18986,18112,1811.2,816,1317,0
7784,-1538,-320,1528.8,15288,18195,7.0,4,4,3,242,24.2,1,1,0,1,0,226,22.6,0,9,5,5,7.0,18515,16826,1682.6,320,1538,0
7785,-1641,-602,1487.5,14875,17019,6.8,5,5,5,194,19.4,2,1,0,1,0,217,21.7,0,5,6,6,6.8,17621,16516,1651.6,602,1641,1
7786,-1255,-254,1686.1,16861,17932,6.8,7,7,6,184,18.4,1,0,0,1,0,195,19.5,0,10,10,10,7.2,18186,18116,1811.6,254,1255,1
7787,-1154,-93,1713.6,17136,17077,6.8,9,9,8,203,20.3,1,1,1,0,0,189,18.9,0,13,10,10,6.6,17170,18290,1829.0,93,1154,0
7788,2312,2522,1776.5,17765,19108,7.2,8,8,10,242,24.2,1,1,0,1,0,170,17.0,0,5,7,7,6.6,16586,15453,1545.3,-2522,-2312,1
7789,-4431,-4570,1455.5,14555,16626,6.6,3,3,1,200,20.0,0,0,1,0,1,251,25.1,1,12,10,10,7.6,21196,18986,1898.6,4570,4431,0
7790,-4215,-1902,1402.0,14020,15872,6.4,2,2,2,203,20.3,1,1,0,1,0,229,22.9,1,11,10,10,6.8,17774,18235,1823.5,1902,4215,0
7791,2658,1915,1757.5,17575,18579,7.2,8,8,13,228,22.8,1,1,1,0,0,211,21.1,0,2,2,2,6.6,16664,14917,1491.7,-1915,-2658,1
7792,-2576,-2182,1530.7,15307,17610,6.8,5,5,3,227,22.7,1,1,0,1,0,249,24.9,0,5,8,8,7.4,19792,17883,1788.3,2182,2576,0
7793,3029,1278,1675.1,16751,19355,7.2,5,5,4,245,24.5,0,0,1,0,1,189,18.9,1,1,1,1,6.8,18077,13722,1372.2,-1278,-3029,1
7794,787,846,1627.1,16271,17500,7.0,7,7,10,218,21.8,0,0,0,1,1,208,20.8,1,4,5,5,6.8,16654,15484,1548.4,-846,-787,1
7795,-514,-1465,1642.0,16420,17929,6.8,7,7,6,209,20.9,0,0,1,0,1,236,23.6,1,9,6,6,7.2,19394,16934,1693.4,1465,514,0
7796,-227,923,1557.0,15570,17682,7.0,6,6,4,180,18.0,0,0,0,1,1,227,22.7,1,5,6,6,6.6,16759,15797,1579.7,-923,227,1
7797,-347,125,1494.8,14948,17612,6.8,3,3,1,218,21.8,0,0,0,1,0,204,20.4,0,2,3,3,6.6,17487,15295,1529.5,-125,347,0
7798,-1645,-1268,1516.7,15167,15683,6.4,4,4,8,220,22.0,1,0,1,0,0,198,19.8,0,17,8,8,6.4,16951,16812,1681.2,1268,1645,0
7799,239,-709,1548.4,15484,18175,6.8,3,3,3,250,25.0,0,0,0,1,1,209,20.9,2,0,2,2,7.2,18884,15245,1524.5,709,-239,1
7800,226,-955,1785.6,17856,18232,6.8,8,8,12,221,22.1,0,0,1,0,1,221,22.1,1,8,8,8,7.2,19187,17630,1763.0,955,-226,1
7801,-2150,-1486,1476.7,14767,17485,7.0,3,3,5,212,21.2,0,0,0,1,1,225,22.5,1,9,7,7,7.2,18971,16917,1691.7,1486,2150,0
7802,2680,1517,1847.4,18474,18239,7.0,11,11,11,217,21.7,1,0,1,0,0,219,21.9,0,4,5,5,6.4,16722,15794,1579.4,-1517,-2680,1
7803,-975,334,1418.3,14183,17942,6.8,0,0,0,243,24.3,0,0,0,1,1,206,20.6,1,5,3,3,7.0,17608,15158,1515.8,-334,975,0
7804,484,-614,1597.1,15971,18396,7.2,4,4,5,242,24.2,1,0,1,0,1,242,24.2,1,1,4,4,7.2,19010,15487,1548.7,614,-484,1
7805,-2914,-1623,1431.9,14319,16192,6.4,2,2,0,210,21.0,0,0,0,1,0,193,19.3,0,15,9,9,6.8,17815,17233,1723.3,1623,2914,0
7806,-795,-1185,1620.6,16206,18093,7.0,3,3,4,260,26.0,1,1,0,1,0,242,24.2,1,4,3,3,7.2,19278,17001,1700.1,1185,795,0
7807,1208,1363,1570.4,15704,18000,7.2,5,5,5,213,21.3,1,1,1,0,0,209,20.9,0,3,3,3,6.8,16637,14496,1449.6,-1363,-1208,0
7808,201,1596,1813.7,18137,19154,7.0,9,9,6,218,21.8,1,1,0,1,0,197,19.7,0,14,9,9,6.6,17558,17936,1793.6,-1596,-201,1
7809,-2695,-1275,1494.4,14944,17675,6.6,2,2,2,239,23.9,0,0,0,1,1,252,25.2,1,9,9,9,7.0,18950,17639,1763.9,1275,2695,0
7810,-7079,-4936,1317.2,13172,14988,6.0,1,1,1,187,18.7,0,0,0,1,1,222,22.2,1,21,14,14,7.4,19924,20251,2025.1,4936,7079,0
7811,2120,358,1836.3,18363,18844,7.2,9,9,11,220,22.0,1,1,1,0,0,215,21.5,0,5,6,6,7.0,18486,16243,1624.3,-358,-2120,0
7812,-1806,-541,1520.0,15200,17118,6.6,4,4,2,228,22.8,0,0,0,1,0,224,22.4,0,10,8,8,7.0,17659,17006,1700.6,541,1806,0
7813,297,518,1731.5,17315,18632,7.0,7,7,6,218,21.8,0,0,0,1,0,221,22.1,0,11,7,7,7.0,18114,17018,1701.8,-518,-297,0
7814,1234,1855,1651.6,16516,19168,7.4,4,4,1,259,25.9,1,0,1,0,0,229,22.9,0,5,4,4,6.8,17313,15282,1528.2,-1855,-1234,1
7815,-3956,-2930,1401.0,14010,15841,6.4,4,4,2,170,17.0,0,0,0,1,1,207,20.7,1,9,9,9,7.0,18771,17966,1796.6,2930,3956,0
7816,-731,-118,1558.0,15580,17701,6.8,4,4,4,205,20.5,0,0,1,0,1,229,22.9,2,6,7,7,6.8,17819,16311,1631.1,118,731,0
7817,3339,3179,1773.1,17731,20617,7.6,7,7,7,238,23.8,1,0,0,1,1,236,23.6,1,2,2,2,6.8,17438,14392,1439.2,-3179,-3339,1
7818,4331,3427,1918.6,19186,19737,7.2,9,9,13,261,26.1,1,1,1,0,0,199,19.9,0,4,3,3,6.4,16310,14855,1485.5,-3427,-4331,1
7819,2275,1360,1813.5,18135,19138,7.0,7,7,6,252,25.2,0,0,1,0,0,212,21.2,0,3,3,3,7.0,17778,15860,1586.0,-1360,-2275,1
7820,-2086,-2017,1594.7,15947,17802,7.0,7,7,4,204,20.4,0,0,1,0,1,188,18.8,1,10,9,9,7.2,19819,18033,1803.3,2017,2086,0
7821,-3637,-2456,1668.1,16681,16014,6.4,10,10,11,168,16.8,1,1,0,1,0,219,21.9,0,17,16,16,7.2,18470,20318,2031.8,2456,3637,0
7822,2685,2307,1673.3,16733,19451,7.2,5,5,4,232,23.2,1,1,1,0,0,207,20.7,0,2,1,1,6.8,17144,14048,1404.8,-2307,-2685,1
7823,-1121,-858,1523.3,15233,17625,7.0,4,4,4,220,22.0,0,0,0,1,1,210,21.0,1,6,9,9,7.0,18483,16354,1635.4,858,1121,1
7824,4990,2055,1840.6,18406,19320,7.4,7,7,7,247,24.7,0,0,1,0,1,196,19.6,1,0,0,0,6.8,17265,13416,1341.6,-2055,-4990,1
7825,-3289,-4291,1671.1,16711,15855,6.4,7,7,7,201,20.1,0,0,1,0,0,201,20.1,1,17,16,16,7.4,20146,20000,2000.0,4291,3289,0
7826,-1805,-2047,1609.3,16093,16567,6.4,7,7,7,175,17.5,0,0,0,1,1,238,23.8,1,9,8,8,6.8,18614,17898,1789.8,2047,1805,0
7827,446,429,1556.3,15563,18747,7.2,3,3,2,252,25.2,0,0,1,0,0,229,22.9,0,2,3,3,6.8,18318,15117,1511.7,-429,-446,1
7828,-859,361,1574.5,15745,17698,6.8,5,5,4,203,20.3,1,0,1,0,1,220,22.0,1,8,5,5,6.8,17337,16604,1660.4,-361,859,0
7829,231,-184,1595.8,15958,17066,6.6,8,8,12,185,18.5,0,0,0,1,1,208,20.8,1,2,6,6,6.8,17250,15727,1572.7,184,-231,0
7830,3195,1056,1750.1,17501,17203,7.0,9,9,12,195,19.5,1,1,1,0,0,166,16.6,0,4,5,5,6.4,16147,14306,1430.6,-1056,-3195,1
7831,3973,3481,1803.8,18038,19458,7.2,7,7,6,240,24.0,1,1,0,1,0,195,19.5,0,1,3,3,6.6,15977,14065,1406.5,-3481,-3973,1
7832,-2528,-2509,1625.6,16256,17776,6.8,4,4,4,248,24.8,0,0,1,0,1,221,22.1,2,15,10,10,7.6,20285,18784,1878.4,2509,2528,0
7833,636,-419,1658.9,16589,18101,7.0,6,6,2,239,23.9,0,0,0,1,1,216,21.6,1,3,5,5,7.2,18520,15953,1595.3,419,-636,1
7834,993,872,1525.8,15258,18398,7.0,5,5,6,223,22.3,1,1,1,0,0,225,22.5,0,1,1,1,6.8,17526,14265,1426.5,-872,-993,0
7835,-246,-1064,1648.1,16481,17470,7.0,7,7,8,223,22.3,0,0,0,1,0,220,22.0,0,6,9,9,7.0,18534,16727,1672.7,1064,246,1
7836,-125,-637,1591.3,15913,17268,7.0,6,6,7,195,19.5,0,0,0,1,1,232,23.2,1,7,5,5,6.8,17905,16038,1603.8,637,125,0
7837,1766,719,1616.2,16162,17887,6.8,4,4,3,257,25.7,1,1,1,0,0,215,21.5,0,3,2,2,6.6,17168,14396,1439.6,-719,-1766,1
7838,1811,875,1726.4,17264,18035,7.0,8,8,7,214,21.4,0,0,1,0,0,186,18.6,0,5,4,4,6.6,17160,15453,1545.3,-875,-1811,1
7839,-418,-1320,1670.0,16700,17519,7.0,7,7,8,241,24.1,1,1,1,0,0,224,22.4,0,9,7,7,7.0,18839,17118,1711.8,1320,418,0
7840,-38,281,1633.7,16337,17367,6.8,7,7,10,197,19.7,0,0,0,1,1,192,19.2,1,4,8,8,6.6,17086,16375,1637.5,-281,38,0
7841,-2878,-1184,1579.0,15790,17533,6.8,4,4,7,208,20.8,0,0,0,1,0,234,23.4,0,13,11,11,7.0,18717,18668,1866.8,1184,2878,1
7842,-703,-653,1597.0,15970,17837,7.0,4,4,5,217,21.7,0,0,0,1,1,221,22.1,1,6,6,6,7.2,18490,16673,1667.3,653,703,1
7843,-1957,-354,1493.3,14933,18353,7.2,2,2,3,213,21.3,0,0,0,1,1,220,22.0,2,4,7,7,7.0,18707,16890,1689.0,354,1957,0
7844,1982,2243,1806.0,18060,19784,7.4,9,9,8,241,24.1,2,1,0,1,0,206,20.6,0,5,6,6,6.6,17541,16078,1607.8,-2243,-1982,1
7845,-2642,-2116,1473.2,14732,16524,6.6,4,4,5,208,20.8,0,0,0,1,0,227,22.7,0,8,8,8,7.0,18640,17374,1737.4,2116,2642,0
7846,2393,725,1712.1,17121,18545,7.0,7,7,3,242,24.2,1,1,1,0,0,194,19.4,0,3,4,4,7.0,17820,14728,1472.8,-725,-2393,1
7847,3002,1582,1891.3,18913,17351,6.6,11,11,9,229,22.9,1,1,1,0,0,170,17.0,0,8,7,7,6.4,15769,15911,1591.1,-1582,-3002,1
7848,1346,849,1723.7,17237,18352,7.2,7,7,6,196,19.6,2,1,1,0,0,241,24.1,0,3,4,4,6.8,17503,15891,1589.1,-849,-1346,1
7849,-6200,-3576,1326.5,13265,15753,6.4,1,1,1,195,19.5,0,0,0,1,1,248,24.8,1,8,11,11,7.2,19329,19465,1946.5,3576,6200,0
7850,7166,4491,2102.0,21020,21002,7.6,14,14,19,237,23.7,1,1,1,0,0,193,19.3,0,6,3,3,6.6,16511,13854,1385.4,-4491,-7166,1
7851,2199,459,1732.0,17320,18039,7.0,7,7,11,210,21.0,0,0,1,0,0,234,23.4,0,4,3,3,6.8,17580,15121,1512.1,-459,-2199,0
7852,-1022,-1301,1558.6,15586,17198,6.8,6,6,8,199,19.9,1,1,1,0,0,210,21.0,0,7,8,8,6.8,18499,16608,1660.8,1301,1022,1
7853,931,740,1720.8,17208,20217,7.6,8,8,5,218,21.8,0,0,0,1,0,209,20.9,0,5,6,6,7.2,19477,16277,1627.7,-740,-931,0
7854,-6225,-3975,1328.2,13282,16226,6.4,0,0,0,194,19.4,0,0,0,1,1,226,22.6,1,9,9,9,7.4,20201,19507,1950.7,3975,6225,0
7855,-3638,-3337,1555.5,15555,17008,6.6,5,5,6,222,22.2,1,1,1,0,0,227,22.7,0,13,12,12,7.6,20345,19193,1919.3,3337,3638,0
7856,1903,4023,1700.8,17008,19831,7.2,4,4,2,255,25.5,1,0,0,1,1,182,18.2,1,12,5,5,6.4,15808,15105,1510.5,-4023,-1903,1
7857,-513,-1056,1605.0,16050,17391,6.8,6,6,7,191,19.1,1,0,1,0,0,235,23.5,0,10,7,7,6.8,18447,16563,1656.3,1056,513,0
7858,257,1183,1683.0,16830,18264,7.0,8,8,6,203,20.3,1,0,1,0,1,180,18.0,1,9,8,8,7.0,17081,16573,1657.3,-1183,-257,0
7859,-633,-1089,1637.0,16370,17433,6.8,6,6,5,209,20.9,0,0,1,0,1,195,19.5,1,12,8,8,7.2,18522,17003,1700.3,1089,633,1
7860,-3151,-3729,1485.1,14851,16367,6.6,3,3,3,183,18.3,0,0,0,1,0,207,20.7,0,9,9,9,7.4,20096,18002,1800.2,3729,3151,0
7861,-1931,-1572,1532.5,15325,17018,6.8,4,4,3,215,21.5,0,0,1,0,1,220,22.0,1,16,8,8,7.2,18590,17256,1725.6,1572,1931,0
7862,607,1293,1838.5,18385,19948,7.4,9,9,12,248,24.8,0,0,1,0,1,240,24.0,2,8,8,8,7.0,18655,17778,1777.8,-1293,-607,1
7863,-3510,-3014,1407.4,14074,16376,6.4,2,2,0,203,20.3,0,0,0,1,0,266,26.6,1,4,7,7,7.2,19390,17584,1758.4,3014,3510,0
7864,1063,-125,1629.9,16299,18568,7.2,5,5,2,225,22.5,1,1,1,0,0,202,20.2,0,3,5,5,7.0,18693,15236,1523.6,125,-1063,0
7865,60,-325,1664.4,16644,17295,6.8,7,7,14,238,23.8,1,1,0,1,0,229,22.9,0,11,6,6,6.8,17620,16584,1658.4,325,-60,0
7866,639,-401,1699.7,16997,17893,6.8,6,6,8,215,21.5,2,1,1,0,0,220,22.0,0,6,5,5,6.8,18294,16358,1635.8,401,-639,0
7867,960,39,1536.0,15360,18355,7.0,3,3,1,220,22.0,0,0,1,0,0,206,20.6,0,2,2,2,6.8,18316,14400,1440.0,-39,-960,0
7868,3332,1330,1714.1,17141,18486,7.0,7,7,6,230,23.0,1,1,1,0,0,218,21.8,1,0,1,1,6.8,17156,13809,1380.9,-1330,-3332,1
7869,2689,1875,1788.2,17882,19474,7.2,7,7,8,233,23.3,1,0,0,1,0,218,21.8,0,5,6,6,6.8,17599,15193,1519.3,-1875,-2689,1
7870,-30,1414,1834.2,18342,19368,7.2,11,11,10,190,19.0,1,1,0,1,0,164,16.4,0,10,9,9,7.0,17954,18372,1837.2,-1414,30,0
7871,-2343,-2231,1525.1,15251,18342,7.0,4,4,8,197,19.7,0,0,1,0,1,238,23.8,2,5,6,6,7.4,20573,17594,1759.4,2231,2343,0
7872,2501,2231,1769.3,17693,18557,7.0,8,8,5,251,25.1,0,0,1,0,0,176,17.6,0,7,6,6,6.4,16326,15192,1519.2,-2231,-2501,1
7873,-2109,-335,1538.5,15385,17267,6.8,4,4,4,219,21.9,0,0,0,1,1,226,22.6,1,14,8,8,7.0,17602,17494,1749.4,335,2109,0
7874,2588,1353,1754.9,17549,19400,7.4,7,7,7,239,23.9,0,0,1,0,0,192,19.2,0,6,5,5,6.6,18047,14961,1496.1,-1353,-2588,1
7875,-4085,-3256,1514.8,15148,16861,6.6,5,5,6,219,21.9,0,0,0,1,1,220,22.0,2,14,10,10,7.4,20117,19233,1923.3,3256,4085,0
7876,-369,-379,1755.8,17558,18661,7.0,11,11,6,174,17.4,2,1,1,0,0,188,18.8,0,11,11,11,7.4,19040,17927,1792.7,379,369,0
7877,1359,132,1698.9,16989,18073,7.0,6,6,9,242,24.2,1,1,1,0,0,239,23.9,0,2,3,3,7.0,17941,15630,1563.0,-132,-1359,0
7878,3559,3296,1878.6,18786,19353,7.4,11,11,9,244,24.4,0,0,0,1,0,187,18.7,0,5,5,5,6.4,16057,15227,1522.7,-3296,-3559,1
7879,-1269,-1991,1518.8,15188,17740,6.8,4,4,2,194,19.4,0,0,0,1,0,213,21.3,1,5,7,7,7.2,19731,16457,1645.7,1991,1269,0
7880,-2195,-291,1552.0,15520,18045,6.8,4,4,7,199,19.9,0,0,0,1,0,255,25.5,0,8,7,7,7.0,18336,17715,1771.5,291,2195,1
7881,4988,3720,2087.6,20876,21016,7.6,13,13,22,226,22.6,1,1,1,0,0,212,21.2,1,6,6,6,6.8,17296,15888,1588.8,-3720,-4988,1
7882,2714,2819,1705.9,17059,18997,7.2,6,6,5,268,26.8,0,0,0,1,0,209,20.9,0,2,2,2,6.6,16178,14345,1434.5,-2819,-2714,1
7883,-1052,-1064,1676.0,16760,17857,6.8,7,7,6,206,20.6,0,0,1,0,1,231,23.1,1,6,6,6,7.2,18921,17812,1781.2,1064,1052,0
7884,-3251,-2143,1466.0,14660,17265,6.6,3,3,2,203,20.3,0,0,0,1,1,234,23.4,1,5,9,9,7.2,19408,17911,1791.1,2143,3251,0
7885,-264,550,1551.0,15510,17367,7.0,6,6,5,202,20.2,1,0,1,0,1,202,20.2,1,6,5,5,6.6,16817,15774,1577.4,-550,264,0
7886,-2191,-1391,1689.7,16897,15328,6.4,9,9,9,159,15.9,1,0,0,1,1,185,18.5,1,19,14,14,6.8,16719,19088,1908.8,1391,2191,0
7887,1297,564,1686.1,16861,18373,7.0,8,8,12,227,22.7,0,0,0,1,0,230,23.0,0,3,2,2,7.0,17809,15564,1556.4,-564,-1297,0
7888,2691,2052,1844.5,18445,19242,7.2,11,11,9,218,21.8,1,1,1,0,0,205,20.5,0,5,6,6,6.6,17190,15754,1575.4,-2052,-2691,1
7889,-2713,-1456,1577.7,15777,18203,6.6,4,4,2,221,22.1,0,0,0,1,1,219,21.9,1,12,10,10,7.4,19659,18490,1849.0,1456,2713,0
7890,2748,2277,1828.4,18284,19460,7.2,7,7,7,224,22.4,0,0,0,1,1,211,21.1,1,2,3,3,7.0,17183,15536,1553.6,-2277,-2748,0
7891,-537,29,1704.7,17047,17725,6.8,10,10,9,192,19.2,0,0,1,0,0,207,20.7,0,8,8,8,7.0,17696,17584,1758.4,-29,537,0
7892,4027,3285,1760.6,17606,20053,7.6,5,5,4,229,22.9,1,0,1,0,0,220,22.0,0,0,0,0,6.6,16768,13579,1357.9,-3285,-4027,1
7893,705,1616,1744.7,17447,17850,7.0,7,7,10,216,21.6,0,0,1,0,0,194,19.4,0,13,9,9,6.6,16234,16742,1674.2,-1616,-705,0
7894,-4038,-2854,1378.9,13789,16947,6.8,1,1,0,210,21.0,1,1,0,1,0,252,25.2,0,12,7,7,7.4,19801,17827,1782.7,2854,4038,0
7895,524,478,1855.7,18557,18792,7.2,11,11,16,192,19.2,0,0,0,1,1,213,21.3,1,7,9,9,7.0,18314,18033,1803.3,-478,-524,0
7896,40,-731,1556.8,15568,17520,6.8,4,4,5,246,24.6,0,0,0,1,0,211,21.1,0,6,3,3,6.8,18251,15528,1552.8,731,-40,0
7897,1291,20,1732.7,17327,18807,7.2,10,10,9,220,22.0,0,0,1,0,1,210,21.0,1,6,5,5,7.2,18787,16036,1603.6,-20,-1291,0
7898,72,-81,1611.0,16110,17501,7.0,6,6,9,206,20.6,1,1,0,1,0,217,21.7,0,5,5,5,6.8,17582,16038,1603.8,81,-72,0
7899,1287,440,1820.9,18209,16955,6.8,10,10,10,200,20.0,0,0,0,1,0,198,19.8,0,16,9,9,6.2,16515,16922,1692.2,-440,-1287,1
7900,1299,-918,1602.3,16023,17244,6.8,5,5,5,207,20.7,1,0,1,0,1,173,17.3,1,7,6,6,7.0,18162,14724,1472.4,918,-1299,1
7901,1218,1150,1768.5,17685,19338,7.2,8,8,6,231,23.1,1,1,0,1,0,226,22.6,0,4,7,7,7.0,18188,16467,1646.7,-1150,-1218,1
7902,-1380,326,1480.3,14803,17318,6.8,4,4,3,213,21.3,1,1,0,1,0,238,23.8,0,10,5,5,7.0,16992,16183,1618.3,-326,1380,1
7903,-1275,-551,1565.6,15656,16252,6.4,6,6,12,195,19.5,0,0,0,1,1,202,20.2,1,8,7,7,6.6,16803,16931,1693.1,551,1275,0
7904,5664,6002,1915.4,19154,20112,7.4,12,12,6,258,25.8,1,1,1,0,0,179,17.9,1,2,3,3,6.0,14110,13490,1349.0,-6002,-5664,1
7905,2186,1698,1748.3,17483,18777,7.2,9,9,11,222,22.2,1,1,0,1,0,231,23.1,0,3,3,3,6.8,17079,15297,1529.7,-1698,-2186,1
7906,-2286,-2574,1459.8,14598,17033,6.6,1,1,1,217,21.7,0,0,1,0,1,227,22.7,1,9,6,6,7.2,19607,16884,1688.4,2574,2286,0
7907,-769,-217,1608.8,16088,17857,7.2,6,6,8,205,20.5,1,1,1,0,0,202,20.2,1,7,7,7,7.0,18074,16857,1685.7,217,769,0
7908,650,128,1581.2,15812,17970,7.0,4,4,3,241,24.1,0,0,1,0,1,198,19.8,1,4,4,4,6.8,17842,15162,1516.2,-128,-650,1
7909,970,748,1603.0,16030,19449,7.2,5,5,5,240,24.0,2,1,1,0,0,218,21.8,0,4,3,3,7.0,18701,15060,1506.0,-748,-970,1
7910,-1856,-1804,1578.7,15787,18200,7.2,4,4,6,230,23.0,1,1,1,0,0,225,22.5,0,11,7,7,7.4,20004,17643,1764.3,1804,1856,0
7911,1872,1869,1787.0,17870,18803,7.2,10,10,10,177,17.7,1,1,1,0,0,225,22.5,0,4,4,4,6.8,16934,15998,1599.8,-1869,-1872,1
7912,1880,1473,1787.5,17875,17882,6.8,12,12,17,205,20.5,0,0,0,1,0,190,19.0,0,3,6,6,6.4,16409,15995,1599.5,-1473,-1880,1
7913,1652,701,1652.3,16523,18018,7.0,6,6,8,196,19.6,0,0,1,0,0,239,23.9,0,1,2,2,6.4,17317,14871,1487.1,-701,-1652,1
7914,-1348,-407,1618.0,16180,18710,7.2,5,5,4,234,23.4,1,1,1,0,0,245,24.5,0,6,6,6,7.0,19117,17528,1752.8,407,1348,1
7915,-102,363,1744.8,17448,17864,6.8,7,7,6,205,20.5,1,1,1,0,0,181,18.1,0,11,10,10,6.8,17501,17550,1755.0,-363,102,0
7916,-4130,-2849,1449.3,14493,15935,6.6,4,4,3,210,21.0,0,0,0,1,1,226,22.6,1,14,11,11,7.0,18784,18623,1862.3,2849,4130,0
7917,1383,1273,1780.7,17807,17661,6.8,9,9,6,217,21.7,1,0,0,1,1,192,19.2,1,6,7,7,6.6,16388,16424,1642.4,-1273,-1383,1
7918,-1787,-608,1500.1,15001,18001,6.8,3,3,2,206,20.6,0,0,0,1,1,257,25.7,1,8,5,5,7.0,18609,16788,1678.8,608,1787,0
7919,3522,1442,1898.4,18984,18355,7.2,11,11,13,246,24.6,1,0,1,0,0,186,18.6,0,4,5,5,6.6,16913,15462,1546.2,-1442,-3522,1
7920,-449,-1347,1652.8,16528,17624,6.8,6,6,7,212,21.2,0,0,1,0,0,235,23.5,0,6,7,7,7.2,18971,16977,1697.7,1347,449,0
7921,-1756,-985,1502.0,15020,17488,7.0,2,2,4,224,22.4,0,0,1,0,1,275,27.5,2,8,5,5,7.0,18473,16776,1677.6,985,1756,0
7922,-3849,-2159,1365.7,13657,16618,6.4,1,1,0,220,22.0,0,0,0,1,1,235,23.5,1,7,7,7,7.0,18777,17506,1750.6,2159,3849,0
7923,1121,933,1767.2,17672,18962,7.2,8,8,13,245,24.5,0,0,1,0,1,238,23.8,1,8,6,6,6.8,18029,16551,1655.1,-933,-1121,1
7924,4882,2658,1950.8,19508,19814,7.4,11,11,15,233,23.3,1,1,0,1,0,219,21.9,0,1,2,2,6.8,17156,14626,1462.6,-2658,-4882,1
7925,2945,2019,1859.0,18590,18992,7.0,11,11,9,215,21.5,0,0,1,0,0,202,20.2,1,7,5,5,6.6,16973,15645,1564.5,-2019,-2945,1
7926,1006,820,1726.0,17260,16577,6.6,9,9,16,187,18.7,2,1,1,0,0,204,20.4,0,10,6,6,6.4,15757,16254,1625.4,-820,-1006,1
7927,1287,603,1609.5,16095,18658,7.0,3,3,3,254,25.4,1,1,1,0,0,241,24.1,0,2,2,2,6.6,18055,14808,1480.8,-603,-1287,1
7928,-1817,-1035,1538.4,15384,17460,6.8,4,4,5,211,21.1,1,0,0,1,1,240,24.0,1,6,8,8,7.0,18495,17201,1720.1,1035,1817,0
7929,733,675,1879.5,18795,19236,7.4,11,11,14,231,23.1,0,0,1,0,1,213,21.3,1,11,11,11,7.0,18561,18062,1806.2,-675,-733,1
7930,2413,2163,1773.7,17737,18648,7.2,8,8,13,224,22.4,1,1,0,1,0,179,17.9,0,7,5,5,6.6,16485,15324,1532.4,-2163,-2413,1
7931,-1093,-1572,1419.1,14191,16725,6.8,2,2,2,207,20.7,1,0,0,1,0,239,23.9,0,3,3,3,7.2,18297,15284,1528.4,1572,1093,0
7932,-3666,-2993,1455.7,14557,15691,6.4,5,5,6,169,16.9,0,0,1,0,0,235,23.5,0,8,8,8,7.2,18684,18223,1822.3,2993,3666,0
7933,1569,664,1673.9,16739,17995,7.0,7,7,13,229,22.9,1,1,1,0,0,250,25.0,0,2,2,2,6.8,17331,15170,1517.0,-664,-1569,0
7934,-4403,-3750,1523.0,15230,16550,6.6,6,6,6,165,16.5,1,1,1,0,0,238,23.8,0,14,13,13,7.4,20300,19633,1963.3,3750,4403,0
7935,-189,-1118,1660.0,16600,18188,7.0,5,5,5,250,25.0,0,0,0,1,1,207,20.7,1,10,7,7,7.4,19306,16789,1678.9,1118,189,0
7936,-2156,-1052,1624.0,16240,16610,6.6,6,6,8,209,20.9,0,0,0,1,1,167,16.7,1,12,12,12,7.0,17662,18396,1839.6,1052,2156,0
7937,4371,3099,1872.2,18722,19399,7.2,11,11,14,216,21.6,1,1,1,0,0,228,22.8,0,5,2,2,6.6,16300,14351,1435.1,-3099,-4371,1
7938,77,630,1564.0,15640,18748,7.0,3,3,2,246,24.6,0,0,1,0,1,248,24.8,1,4,2,2,7.0,18118,15563,1556.3,-630,-77,0
7939,1938,738,1794.0,17940,19767,7.4,7,7,11,242,24.2,0,0,1,0,1,221,22.1,1,3,5,5,7.2,19029,16002,1600.2,-738,-1938,1
7940,-58,-1047,1641.4,16414,18297,6.8,4,4,5,247,24.7,0,0,0,1,1,244,24.4,1,2,6,6,7.0,19344,16472,1647.2,1047,58,0
7941,-2723,-1062,1420.7,14207,16373,6.6,2,2,1,211,21.1,0,0,0,1,1,208,20.8,1,7,6,6,6.8,17435,16930,1693.0,1062,2723,0
7942,1411,1163,1673.7,16737,18903,7.2,7,7,6,240,24.0,1,1,1,0,0,177,17.7,0,3,6,6,7.0,17740,15326,1532.6,-1163,-1411,1
7943,-2998,-3331,1467.2,14672,16566,6.6,1,1,1,234,23.4,0,0,0,1,0,251,25.1,0,10,9,9,7.2,19897,17670,1767.0,3331,2998,0
7944,97,-1064,1536.0,15360,17742,6.8,4,4,4,228,22.8,1,1,1,0,0,220,22.0,0,0,4,4,7.0,18806,15263,1526.3,1064,-97,1
7945,1395,1943,1779.5,17795,19039,7.2,11,11,7,213,21.3,1,1,1,0,0,198,19.8,0,8,6,6,6.8,17096,16400,1640.0,-1943,-1395,1
7946,2438,1105,1689.6,16896,18664,7.0,7,7,7,246,24.6,1,1,1,0,0,211,21.1,0,2,2,2,6.6,17559,14458,1445.8,-1105,-2438,1
7947,-925,-360,1618.2,16182,18355,7.0,4,4,4,216,21.6,0,0,0,1,1,212,21.2,2,7,7,7,7.0,18715,17107,1710.7,360,925,0
7948,679,211,1772.9,17729,17260,6.8,11,11,11,190,19.0,1,0,0,1,0,192,19.2,0,7,9,9,6.8,17049,17050,1705.0,-211,-679,1
7949,1050,-1270,1755.2,17552,18284,7.2,10,10,12,222,22.2,1,0,1,0,1,192,19.2,1,5,8,8,7.4,19554,16502,1650.2,1270,-1050,0
7950,392,866,1649.1,16491,19790,7.6,6,6,5,214,21.4,2,1,1,0,0,241,24.1,0,3,4,4,7.4,18924,16099,1609.9,-866,-392,1
7951,24,483,1764.3,17643,18331,7.2,9,9,4,221,22.1,0,0,1,0,1,153,15.3,1,17,11,11,7.0,17848,17619,1761.9,-483,-24,0
7952,266,1738,1624.7,16247,19667,7.4,6,6,7,218,21.8,0,0,1,0,1,213,21.3,1,8,6,6,7.0,17929,15981,1598.1,-1738,-266,1
7953,1396,89,1707.2,17072,16658,6.4,8,8,11,192,19.2,0,0,1,0,1,179,17.9,1,15,6,6,6.8,16569,15676,1567.6,-89,-1396,1
7954,3807,1849,1888.2,18882,18137,6.6,12,12,11,202,20.2,2,1,1,0,0,187,18.7,0,9,5,5,6.8,16288,15075,1507.5,-1849,-3807,1
7955,-1127,-843,1452.0,14520,17410,7.0,3,3,4,182,18.2,0,0,1,0,0,234,23.4,0,1,3,3,7.0,18253,15647,1564.7,843,1127,0
7956,3823,3324,1837.4,18374,20120,7.6,10,10,14,229,22.9,1,1,1,0,0,176,17.6,0,4,4,4,6.6,16796,14551,1455.1,-3324,-3823,1
7957,32,822,1607.3,16073,17592,6.8,6,6,5,211,21.1,1,1,1,0,0,207,20.7,1,8,4,4,6.2,16770,16041,1604.1,-822,-32,0
7958,1306,431,1644.8,16448,18932,7.2,4,4,6,248,24.8,1,1,1,0,0,262,26.2,0,2,1,1,7.0,18501,15142,1514.2,-431,-1306,1
7959,1618,514,1882.1,18821,18407,7.0,12,12,12,203,20.3,1,1,1,0,0,181,18.1,1,7,8,8,7.2,17893,17203,1720.3,-514,-1618,1
7960,-2854,-2798,1548.5,15485,17138,6.8,6,6,6,193,19.3,1,0,0,1,0,225,22.5,0,9,10,10,7.4,19936,18339,1833.9,2798,2854,0
7961,-1417,860,1512.9,15129,16869,6.6,5,5,3,204,20.4,1,1,1,0,0,182,18.2,0,14,9,9,6.6,16009,16546,1654.6,-860,1417,0
7962,1320,-178,1632.9,16329,17600,6.8,5,5,7,205,20.5,0,0,1,0,0,218,21.8,0,4,3,3,6.8,17778,15009,1500.9,178,-1320,1
7963,2954,3730,1680.7,16807,19976,7.2,6,6,5,263,26.3,0,0,1,0,1,177,17.7,1,1,1,1,6.6,16246,13853,1385.3,-3730,-2954,1
7964,2460,498,2033.0,20330,18408,7.0,11,11,21,234,23.4,0,0,0,1,1,205,20.5,1,24,10,10,6.8,17910,17870,1787.0,-498,-2460,1
7965,132,-28,1666.6,16666,17512,6.8,6,6,6,185,18.5,1,1,0,1,0,237,23.7,0,6,6,6,6.8,17540,16534,1653.4,28,-132,1
7966,2276,1630,1694.6,16946,17723,6.8,7,7,6,247,24.7,1,1,1,0,0,194,19.4,0,7,5,5,6.4,16093,14670,1467.0,-1630,-2276,1
7967,1586,2622,1702.8,17028,19169,7.4,7,7,6,247,24.7,0,0,1,0,1,214,21.4,1,4,4,4,6.6,16547,15442,1544.2,-2622,-1586,1
7968,-418,60,1668.6,16686,19183,7.4,5,5,7,240,24.0,1,0,0,1,1,273,27.3,1,3,5,5,7.2,19123,17104,1710.4,-60,418,0
7969,-1449,-539,1499.3,14993,16922,6.8,4,4,2,223,22.3,1,1,0,1,0,255,25.5,0,6,6,6,6.8,17461,16442,1644.2,539,1449,1
7970,-663,-413,1465.4,14654,17393,7.0,3,3,4,201,20.1,0,0,0,1,1,248,24.8,1,2,1,1,6.8,17806,15317,1531.7,413,663,1
7971,-339,-1529,1557.0,15570,17440,6.8,3,3,6,232,23.2,0,0,0,1,1,244,24.4,2,1,3,3,7.2,18969,15909,1590.9,1529,339,1
7972,-597,-1198,1717.8,17178,18476,7.0,8,8,11,216,21.6,0,0,0,1,0,253,25.3,0,6,8,8,7.4,19674,17775,1777.5,1198,597,1
7973,-2671,-1258,1433.3,14333,17362,6.8,1,1,2,222,22.2,0,0,0,1,1,224,22.4,1,6,7,7,6.8,18620,17004,1700.4,1258,2671,0
7974,-2889,-2882,1445.3,14453,17152,6.8,1,1,1,244,24.4,0,0,0,1,1,216,21.6,1,6,10,10,7.2,20034,17342,1734.2,2882,2889,0
7975,-1111,679,1593.2,15932,17831,6.8,3,3,2,238,23.8,1,0,0,1,1,191,19.1,1,7,7,7,6.8,17152,17043,1704.3,-679,1111,1
7976,-1972,-717,1510.1,15101,18480,7.0,3,3,1,226,22.6,0,0,0,1,1,263,26.3,1,4,6,6,7.2,19197,17073,1707.3,717,1972,0
7977,1457,715,1662.8,16628,18812,7.0,6,6,9,216,21.6,0,0,0,1,1,208,20.8,1,4,4,4,7.2,18097,15171,1517.1,-715,-1457,0
7978,-2566,-2224,1499.7,14997,16588,6.6,4,4,2,217,21.7,2,1,0,1,0,216,21.6,0,9,9,9,7.2,18812,17563,1756.3,2224,2566,0
7979,563,442,1766.4,17664,18757,7.0,10,10,7,233,23.3,1,0,1,0,0,219,21.9,0,6,8,8,7.0,18315,17101,1710.1,-442,-563,1
7980,-2924,-1587,1508.2,15082,17691,6.8,4,4,4,211,21.1,1,1,0,1,0,216,21.6,0,6,10,10,7.4,19278,18006,1800.6,1587,2924,1
7981,-2935,-1462,1696.4,16964,18163,6.8,8,8,5,214,21.4,1,1,0,1,0,235,23.5,0,15,12,12,7.4,19625,19899,1989.9,1462,2935,0
7982,1671,1072,1699.9,16999,17880,6.8,7,7,9,228,22.8,0,0,0,1,1,206,20.6,1,6,4,4,6.4,16808,15328,1532.8,-1072,-1671,1
7983,282,399,1662.1,16621,17333,6.6,6,6,6,220,22.0,0,0,1,0,0,216,21.6,0,8,6,6,6.8,16934,16339,1633.9,-399,-282,1
7984,-896,-661,1706.0,17060,17118,6.6,9,9,8,179,17.9,1,1,0,1,0,200,20.0,0,14,11,11,7.0,17779,17956,1795.6,661,896,1
7985,-2993,-2494,1475.8,14758,15950,6.6,3,3,5,202,20.2,1,1,1,0,0,215,21.5,1,12,7,7,7.0,18444,17751,1775.1,2494,2993,0
7986,1810,1012,1711.7,17117,18326,7.0,8,8,11,204,20.4,1,1,1,0,0,211,21.1,0,6,4,4,6.6,17314,15307,1530.7,-1012,-1810,1
7987,-2461,-1828,1641.3,16413,17648,7.0,6,6,6,204,20.4,0,0,0,1,1,223,22.3,1,13,10,10,7.4,19476,18874,1887.4,1828,2461,1
7988,-1620,-1431,1444.8,14448,15930,6.4,3,3,5,209,20.9,0,0,0,1,0,204,20.4,1,10,6,6,6.8,17361,16068,1606.8,1431,1620,0
7989,2375,2688,1677.8,16778,18893,7.2,5,5,4,247,24.7,0,0,1,0,0,235,23.5,0,0,1,1,6.6,16205,14403,1440.3,-2688,-2375,1
7990,-618,-413,1449.4,14494,18008,6.8,2,2,3,244,24.4,1,1,0,1,0,247,24.7,0,2,1,1,6.8,18421,15112,1511.2,413,618,0
7991,2253,2082,1826.7,18267,19241,7.4,9,9,13,226,22.6,0,0,1,0,0,178,17.8,0,7,6,6,6.8,17159,16014,1601.4,-2082,-2253,1
7992,2821,2754,1644.0,16440,18417,7.0,6,6,6,208,20.8,1,1,1,0,0,203,20.3,0,2,2,2,6.2,15663,13619,1361.9,-2754,-2821,0
7993,1716,1837,1739.0,17390,19016,7.2,8,8,8,212,21.2,2,1,0,1,0,226,22.6,0,8,5,5,6.8,17179,15674,1567.4,-1837,-1716,1
7994,501,-495,1703.5,17035,18588,7.2,6,6,6,235,23.5,0,0,1,0,0,207,20.7,0,4,7,7,7.0,19083,16534,1653.4,495,-501,1
7995,-2830,-2212,1719.8,17198,15293,6.4,11,11,19,156,15.6,0,0,1,0,1,174,17.4,1,24,16,16,6.8,17505,20028,2002.8,2212,2830,0
7996,3140,1824,1743.0,17430,18040,6.8,10,10,10,210,21.0,1,0,1,0,0,228,22.8,0,2,2,2,6.8,16216,14290,1429.0,-1824,-3140,1
7997,-1152,-1535,1532.0,15320,16960,7.0,4,4,4,217,21.7,1,0,1,0,1,225,22.5,1,5,6,6,7.0,18495,16472,1647.2,1535,1152,0
7998,-704,-193,1534.7,15347,17612,6.8,3,3,5,243,24.3,0,0,0,1,1,220,22.0,1,3,4,4,6.8,17805,16051,1605.1,193,704,0
7999,2621,2483,1800.2,18002,19391,7.0,12,12,11,199,19.9,0,0,1,0,0,195,19.5,0,5,6,6,6.8,16908,15381,1538.1,-2483,-2621,1
8000,-2529,-1607,1790.1,17901,16538,6.8,11,11,10,171,17.1,0,0,0,1,0,205,20.5,1,17,16,16,7.0,18145,20430,2043.0,1607,2529,0
8001,-1099,-396,1420.5,14205,18034,7.0,3,3,1,197,19.7,0,0,0,1,1,236,23.6,1,4,4,4,7.0,18430,15304,1530.4,396,1099,0
8002,-3147,-3323,1377.2,13772,14954,6.0,4,4,1,178,17.8,0,0,0,1,0,223,22.3,1,6,6,6,7.0,18277,16919,1691.9,3323,3147,0
8003,3142,2037,1723.1,17231,19272,7.2,6,6,7,237,23.7,1,1,1,0,0,245,24.5,0,1,1,1,6.8,17235,14089,1408.9,-2037,-3142,1
8004,-1231,496,1598.3,15983,19337,7.2,6,6,6,233,23.3,0,0,0,1,0,201,20.1,0,11,8,8,7.4,18841,17214,1721.4,-496,1231,0
8005,-1991,-1055,1465.1,14651,18301,6.8,2,2,2,241,24.1,0,0,1,0,0,248,24.8,0,4,4,4,7.2,19356,16642,1664.2,1055,1991,0
8006,4250,3916,1878.9,18789,20433,7.4,11,11,13,231,23.1,1,1,1,0,0,223,22.3,0,1,1,1,6.4,16517,14539,1453.9,-3916,-4250,1
8007,-3683,-3420,1548.5,15485,16784,6.6,6,6,3,213,21.3,0,0,0,1,1,209,20.9,2,13,12,12,7.4,20204,19168,1916.8,3420,3683,0
8008,3313,1465,1799.2,17992,18842,7.0,10,10,11,212,21.2,1,0,1,0,1,217,21.7,1,4,3,3,6.8,17377,14679,1467.9,-1465,-3313,1
8009,2117,180,1882.8,18828,18186,7.2,10,10,17,197,19.7,1,1,1,0,0,209,20.9,1,8,8,8,6.8,18006,16711,1671.1,-180,-2117,1
8010,-3268,-3888,1479.7,14797,17124,6.6,3,3,3,212,21.2,0,0,1,0,1,218,21.8,1,6,9,9,7.6,21012,18065,1806.5,3888,3268,0
8011,-629,-209,1552.4,15524,17843,7.0,4,4,5,228,22.8,1,1,0,1,0,192,19.2,0,7,7,7,6.8,18052,16153,1615.3,209,629,1
8012,3184,3874,1828.8,18288,20765,7.6,10,10,6,234,23.4,2,1,1,0,0,209,20.9,0,5,4,4,6.8,16891,15104,1510.4,-3874,-3184,1
8013,-890,-1261,1630.4,16304,18344,7.0,5,5,2,222,22.2,0,0,0,1,1,218,21.8,2,5,8,8,7.4,19605,17194,1719.4,1261,890,0
8014,-4646,-3186,1497.4,14974,15389,6.2,5,5,8,201,20.1,1,1,0,1,0,201,20.1,0,17,10,10,7.2,18575,19620,1962.0,3186,4646,0
8015,1937,1019,1659.8,16598,18693,7.0,4,4,4,256,25.6,0,0,1,0,1,239,23.9,1,1,2,2,6.8,17674,14661,1466.1,-1019,-1937,0
8016,15,-2108,1527.3,15273,16349,6.8,5,5,7,189,18.9,0,0,1,0,1,216,21.6,1,6,5,5,7.0,18457,15258,1525.8,2108,-15,1
8017,-44,673,1551.5,15515,18510,7.2,4,4,2,222,22.2,0,0,1,0,0,218,21.8,0,4,5,5,6.8,17837,15559,1555.9,-673,44,0
8018,3133,2377,1602.4,16024,19005,6.8,4,4,2,220,22.0,0,0,1,0,0,206,20.6,0,0,0,0,6.6,16628,12891,1289.1,-2377,-3133,0
8019,-2450,-2260,1566.7,15667,17592,7.0,4,4,7,225,22.5,0,0,1,0,1,252,25.2,1,14,8,8,7.6,19852,18117,1811.7,2260,2450,0
8020,1309,657,1845.1,18451,19111,7.4,9,9,5,226,22.6,0,0,0,1,0,206,20.6,0,5,7,7,6.8,18454,17142,1714.2,-657,-1309,1
8021,-994,266,1635.5,16355,17998,6.8,8,8,5,198,19.8,0,0,0,1,1,202,20.2,1,9,9,9,6.8,17732,17349,1734.9,-266,994,0
8022,-4199,-3415,1514.0,15140,15933,6.6,4,4,3,198,19.8,1,0,1,0,0,221,22.1,0,11,12,12,7.2,19348,19339,1933.9,3415,4199,0
8023,1684,1773,1575.5,15755,18468,7.0,2,2,4,258,25.8,0,0,1,0,0,212,21.2,0,1,1,1,6.8,16695,14071,1407.1,-1773,-1684,0
8024,95,772,1630.2,16302,18040,7.0,6,6,7,212,21.2,0,0,0,1,1,205,20.5,1,7,6,6,6.8,17268,16207,1620.7,-772,-95,1
8025,-3453,-2582,1382.5,13825,16773,6.8,2,2,3,173,17.3,0,0,0,1,0,237,23.7,0,4,7,7,7.4,19355,17278,1727.8,2582,3453,0
8026,2432,1875,1672.4,16724,18895,7.0,5,5,5,229,22.9,1,1,1,0,0,221,22.1,0,3,2,2,6.6,17020,14292,1429.2,-1875,-2432,0
8027,2680,1700,1844.2,18442,19414,7.4,9,9,11,248,24.8,0,0,1,0,1,240,24.0,2,1,2,2,7.0,17714,15762,1576.2,-1700,-2680,1
8028,-4178,-1302,1700.8,17008,18223,7.2,8,8,4,217,21.7,0,0,1,0,1,219,21.9,1,13,13,13,7.4,19525,21186,2118.6,1302,4178,0
8029,897,806,1651.3,16513,18334,7.0,5,5,4,249,24.9,1,1,0,1,0,201,20.1,0,5,3,3,6.8,17528,15616,1561.6,-806,-897,1
8030,-1232,-1020,1555.4,15554,18372,7.0,4,4,5,242,24.2,0,0,0,1,1,230,23.0,1,5,6,6,7.4,19392,16786,1678.6,1020,1232,0
8031,-4112,-2493,1540.0,15400,17541,7.0,5,5,5,215,21.5,0,0,0,1,0,219,21.9,0,9,9,9,7.4,20034,19512,1951.2,2493,4112,1
8032,2514,1416,1905.2,19052,18439,7.0,10,10,11,242,24.2,1,1,1,0,0,197,19.7,0,11,7,7,6.6,17023,16538,1653.8,-1416,-2514,1
8033,-2088,-2153,1603.9,16039,16635,6.6,6,6,8,198,19.8,1,1,1,0,0,201,20.1,0,15,12,12,7.0,18788,18127,1812.7,2153,2088,0
8034,-414,-601,1709.3,17093,18357,7.0,6,6,5,233,23.3,1,1,1,0,0,243,24.3,0,7,8,8,7.2,18958,17507,1750.7,601,414,0
8035,-3368,-3384,1544.0,15440,16864,6.8,4,4,3,207,20.7,0,0,0,1,0,216,21.6,0,17,11,11,7.4,20248,18808,1880.8,3384,3368,0
8036,-539,723,1554.7,15547,18141,6.8,4,4,2,214,21.4,0,0,0,1,1,207,20.7,1,6,7,7,7.0,17418,16086,1608.6,-723,539,1
8037,495,21,1627.5,16275,16968,6.8,7,7,10,190,19.0,0,0,1,0,0,197,19.7,0,10,6,6,6.8,16947,15780,1578.0,-21,-495,0
8038,1794,927,1762.7,17627,19004,7.0,7,7,9,204,20.4,1,1,1,0,0,194,19.4,0,7,5,5,7.0,18077,15833,1583.3,-927,-1794,1
8039,1459,970,1664.1,16641,18150,7.0,7,7,10,221,22.1,1,1,0,1,0,210,21.0,0,2,4,4,6.8,17180,15182,1518.2,-970,-1459,0
8040,685,333,1600.9,16009,17605,6.8,6,6,12,194,19.4,1,1,0,1,0,252,25.2,0,0,1,1,6.6,17272,15324,1532.4,-333,-685,1
8041,-782,-1431,1501.0,15010,16558,6.8,4,4,4,211,21.1,1,1,1,0,0,248,24.8,0,3,3,3,7.0,17989,15792,1579.2,1431,782,0
8042,-876,389,1596.9,15969,18868,7.0,4,4,6,195,19.5,1,1,0,1,0,228,22.8,0,9,5,5,7.0,18479,16845,1684.5,-389,876,1
8043,-302,-646,1500.7,15007,17469,7.2,2,2,6,232,23.2,0,0,1,0,0,248,24.8,0,3,3,3,6.8,18115,15309,1530.9,646,302,0
8044,-4235,-4926,1449.4,14494,15036,6.4,3,3,3,208,20.8,0,0,1,0,1,254,25.4,1,4,8,8,7.4,19962,18729,1872.9,4926,4235,0
8045,-316,63,1657.6,16576,18349,7.0,6,6,4,220,22.0,1,0,0,1,0,214,21.4,0,5,6,6,7.0,18286,16892,1689.2,-63,316,1
8046,-2362,79,1657.5,16575,18524,7.0,7,7,8,204,20.4,0,0,0,1,0,247,24.7,0,9,10,10,7.0,18445,18937,1893.7,-79,2362,0
8047,3708,2901,1933.9,19339,19966,7.2,12,12,14,225,22.5,2,1,1,0,0,203,20.3,0,3,4,4,6.8,17065,15631,1563.1,-2901,-3708,0
8048,-258,569,1662.1,16621,19387,7.0,6,6,7,206,20.6,1,1,0,1,0,225,22.5,0,10,6,6,7.2,18818,16879,1687.9,-569,258,1
8049,-2634,-1282,1430.8,14308,17611,6.8,1,1,1,235,23.5,1,0,0,1,1,247,24.7,1,9,6,6,7.4,18893,16942,1694.2,1282,2634,0
8050,-3709,-4015,1516.5,15165,16025,6.6,6,6,5,188,18.8,0,0,1,0,1,227,22.7,1,8,11,11,7.2,20040,18874,1887.4,4015,3709,0
8051,4074,3921,1875.4,18754,20402,7.6,11,11,14,202,20.2,0,0,0,1,1,200,20.0,1,6,3,3,6.8,16481,14680,1468.0,-3921,-4074,0
8052,-26,989,1660.8,16608,18459,7.2,7,7,6,233,23.3,1,1,0,1,0,203,20.3,0,7,6,6,6.8,17470,16634,1663.4,-989,26,0
8053,143,713,1637.5,16375,18026,7.0,7,7,6,172,17.2,1,1,1,0,0,217,21.7,1,3,4,4,6.6,17313,16232,1623.2,-713,-143,0
8054,-155,-47,1598.7,15987,17964,7.0,5,5,6,207,20.7,1,0,0,1,0,231,23.1,0,6,6,6,7.0,18011,16142,1614.2,47,155,1
8055,302,1420,1702.7,17027,19345,7.4,8,8,9,217,21.7,1,1,0,1,0,237,23.7,1,7,5,5,7.0,17925,16725,1672.5,-1420,-302,0
8056,-1615,-1393,1588.5,15885,16350,6.4,5,5,7,216,21.6,0,0,0,1,1,221,22.1,2,10,8,8,6.8,17743,17500,1750.0,1393,1615,0
8057,1443,-453,1623.8,16238,18724,7.0,3,3,1,241,24.1,1,1,1,0,0,215,21.5,0,2,2,2,7.2,19177,14795,1479.5,453,-1443,0
8058,-1446,-965,1677.8,16778,17640,7.2,6,6,9,218,21.8,0,0,1,0,1,234,23.4,2,10,7,7,7.0,18605,18224,1822.4,965,1446,0
8059,341,-352,1700.4,17004,19168,7.2,7,7,2,216,21.6,0,0,0,1,1,207,20.7,1,4,7,7,7.2,19520,16663,1666.3,352,-341,0
8060,-120,-393,1766.8,17668,17036,6.8,12,12,10,184,18.4,0,0,1,0,0,194,19.4,0,8,8,8,6.8,17429,17788,1778.8,393,120,1
8061,566,-528,1638.9,16389,18131,7.0,7,7,8,225,22.5,1,1,0,1,0,261,26.1,1,5,3,3,7.2,18659,15823,1582.3,528,-566,1
8062,166,-1644,1725.2,17252,15960,6.4,9,9,13,188,18.8,0,0,1,0,1,192,19.2,1,8,7,7,7.0,17604,17086,1708.6,1644,-166,1
8063,-49,-1803,1785.4,17854,16635,6.8,7,7,12,195,19.5,1,1,1,0,0,238,23.8,1,6,6,6,6.8,18438,17903,1790.3,1803,49,1
8064,-2661,-3190,1543.1,15431,17309,6.8,4,4,6,218,21.8,0,0,0,1,1,260,26.0,2,9,8,8,7.2,20499,18092,1809.2,3190,2661,0
8065,-1522,-1437,1498.5,14985,17710,7.0,2,2,2,224,22.4,0,0,1,0,1,253,25.3,1,5,5,5,7.2,19147,16507,1650.7,1437,1522,0
8066,1060,1708,1600.8,16008,18674,6.8,2,2,4,237,23.7,0,0,1,0,1,211,21.1,1,5,3,3,6.8,16966,14948,1494.8,-1708,-1060,1
8067,4043,1803,1966.3,19663,19052,7.2,9,9,6,247,24.7,1,0,0,1,0,214,21.4,0,5,4,4,6.8,17249,15620,1562.0,-1803,-4043,1
8068,2699,2575,1693.2,16932,19942,7.2,7,7,10,235,23.5,1,1,1,0,0,242,24.2,0,1,1,1,6.8,17367,14233,1423.3,-2575,-2699,1
8069,843,1776,1702.6,17026,18824,7.2,8,8,9,212,21.2,0,0,0,1,1,220,22.0,1,2,6,6,7.0,17048,16183,1618.3,-1776,-843,1
8070,2193,2957,1780.3,17803,20184,7.4,9,9,7,267,26.7,1,1,1,0,0,207,20.7,0,4,5,5,6.8,17227,15610,1561.0,-2957,-2193,1
8071,-18,788,1558.2,15582,18842,7.0,5,5,5,234,23.4,1,1,1,0,0,202,20.2,0,7,3,3,7.0,18054,15600,1560.0,-788,18,1
8072,-1352,-2339,1480.8,14808,16826,6.8,2,2,3,219,21.9,0,0,0,1,0,257,25.7,0,5,4,4,7.4,19165,16160,1616.0,2339,1352,1
8073,-1736,-2692,1649.7,16497,16957,6.6,7,7,8,207,20.7,1,1,1,0,0,246,24.6,0,7,9,9,7.2,19649,18233,1823.3,2692,1736,0
8074,171,42,1650.3,16503,18377,7.0,5,5,7,240,24.0,0,0,1,0,1,232,23.2,1,10,6,6,7.0,18335,16332,1633.2,-42,-171,1
8075,-1711,-1406,1552.2,15522,18255,7.0,4,4,5,220,22.0,0,0,1,0,1,239,23.9,1,6,6,6,7.4,19661,17233,1723.3,1406,1711,0
8076,-2793,-3416,1737.1,17371,17227,6.8,9,9,9,183,18.3,0,0,0,1,0,228,22.8,0,12,15,15,7.6,20643,20164,2016.4,3416,2793,0
8077,1549,1179,1772.0,17720,19150,7.2,8,8,8,232,23.2,1,1,1,0,0,212,21.2,1,4,7,7,7.0,17971,16171,1617.1,-1179,-1549,0
8078,2565,1634,1798.1,17981,19233,7.2,8,8,7,245,24.5,1,1,1,0,0,199,19.9,0,3,5,5,6.6,17599,15416,1541.6,-1634,-2565,1
8079,-174,-70,1522.9,15229,16903,6.8,5,5,12,160,16.0,2,1,1,0,0,235,23.5,0,2,3,3,6.6,16973,15403,1540.3,70,174,0
8080,-1029,754,1642.5,16425,18524,7.0,5,5,5,201,20.1,1,0,1,0,1,225,22.5,1,11,7,7,6.8,17770,17454,1745.4,-754,1029,0
8081,785,-350,1579.0,15790,17238,6.8,4,4,7,209,20.9,1,1,1,0,0,241,24.1,0,3,2,2,7.0,17588,15005,1500.5,350,-785,0
8082,3652,1943,1733.9,17339,19573,7.2,4,4,6,237,23.7,0,0,1,0,1,217,21.7,1,0,0,0,6.8,17630,13687,1368.7,-1943,-3652,1
8083,995,-458,1648.7,16487,18146,7.0,4,4,7,229,22.9,0,0,1,0,0,230,23.0,0,2,4,4,7.0,18604,15492,1549.2,458,-995,0
8084,3703,3118,1792.2,17922,18511,7.2,9,9,10,224,22.4,0,0,1,0,0,206,20.6,0,4,2,2,6.2,15393,14219,1421.9,-3118,-3703,1
8085,-74,-482,1677.8,16778,18459,6.8,6,6,3,236,23.6,2,1,1,0,0,212,21.2,0,10,7,7,7.0,18941,16852,1685.2,482,74,0
8086,719,387,1806.8,18068,18462,6.8,8,8,8,204,20.4,2,1,1,0,0,203,20.3,0,8,8,8,6.8,18075,17349,1734.9,-387,-719,1
8087,1074,52,1736.6,17366,17659,7.0,8,8,11,229,22.9,1,1,1,0,0,245,24.5,0,3,5,5,6.8,17607,16292,1629.2,-52,-1074,1
8088,-3259,-1311,1504.1,15041,17616,6.8,2,2,1,229,22.9,1,0,0,1,1,249,24.9,1,13,8,8,7.0,18927,18300,1830.0,1311,3259,1
8089,-3704,-4361,1513.5,15135,16444,6.8,5,5,7,197,19.7,0,0,1,0,1,244,24.4,1,12,10,10,7.6,20805,18839,1883.9,4361,3704,0
8090,-2772,-2957,1608.3,16083,16509,6.6,6,6,10,218,21.8,1,0,0,1,1,207,20.7,1,11,13,13,7.2,19466,18855,1885.5,2957,2772,0
8091,2322,1048,1744.6,17446,19285,7.0,8,8,7,223,22.3,1,1,1,0,0,222,22.2,0,1,4,4,6.8,18237,15124,1512.4,-1048,-2322,1
8092,-3304,-1505,1428.4,14284,17853,7.0,2,2,1,243,24.3,0,0,0,1,1,237,23.7,1,8,7,7,7.2,19358,17588,1758.8,1505,3304,0
8093,1393,1671,1758.5,17585,19364,7.2,8,8,9,213,21.3,0,0,1,0,1,207,20.7,1,6,7,7,7.0,17693,16192,1619.2,-1671,-1393,1
8094,2954,2444,1653.7,16537,19213,7.2,7,7,7,232,23.2,2,1,1,0,0,202,20.2,0,0,1,1,6.8,16769,13583,1358.3,-2444,-2954,1
8095,3409,1964,1889.5,18895,18495,7.2,10,10,11,245,24.5,1,1,1,0,0,180,18.0,0,8,6,6,6.8,16531,15486,1548.6,-1964,-3409,1
8096,-5228,-6488,1437.0,14370,15153,6.4,4,4,4,167,16.7,0,0,1,0,0,250,25.0,0,9,12,12,7.8,21641,19598,1959.8,6488,5228,0
8097,2422,656,1827.4,18274,18252,7.2,9,9,14,242,24.2,0,0,1,0,0,228,22.8,0,4,4,4,7.0,17596,15852,1585.2,-656,-2422,1
8098,149,-1568,1828.6,18286,16569,6.6,11,11,12,183,18.3,1,1,1,0,0,205,20.5,1,12,10,10,7.0,18137,18137,1813.7,1568,-149,1
8099,-435,-1431,1635.2,16352,18216,6.8,7,7,7,224,22.4,1,1,0,1,0,233,23.3,0,7,7,7,7.2,19647,16787,1678.7,1431,435,0
8100,510,921,1754.6,17546,18498,7.2,10,10,10,191,19.1,0,0,0,1,1,217,21.7,1,7,8,8,7.0,17577,17036,1703.6,-921,-510,0
8101,-2203,-2676,1643.3,16433,18008,7.0,4,4,5,227,22.7,0,0,0,1,0,204,20.4,1,13,12,12,7.4,20684,18636,1863.6,2676,2203,0
8102,-304,-1063,1541.4,15414,18476,7.2,2,2,2,232,23.2,0,0,1,0,1,237,23.7,1,1,3,3,7.4,19539,15718,1571.8,1063,304,1
8103,648,617,1773.7,17737,18616,7.0,7,7,12,234,23.4,0,0,0,1,1,202,20.2,1,10,8,8,7.0,17999,17089,1708.9,-617,-648,0
8104,1365,1563,1757.0,17570,18879,7.2,8,8,11,222,22.2,1,1,1,0,0,220,22.0,0,7,6,6,6.8,17316,16205,1620.5,-1563,-1365,0
8105,-2550,-1700,1713.1,17131,18470,7.2,7,7,12,242,24.2,0,0,0,1,0,258,25.8,0,7,11,11,7.2,20170,19681,1968.1,1700,2550,0
8106,1932,168,1723.7,17237,17508,6.6,8,8,10,226,22.6,1,0,1,0,1,182,18.2,1,3,6,6,6.8,17340,15305,1530.5,-168,-1932,0
8107,1692,1775,1781.4,17814,18465,7.0,9,9,11,206,20.6,0,0,0,1,0,196,19.6,0,11,7,7,6.8,16690,16122,1612.2,-1775,-1692,1
8108,624,1208,1673.8,16738,19296,7.2,8,8,9,214,21.4,1,1,0,1,0,225,22.5,0,3,6,6,7.0,18088,16114,1611.4,-1208,-624,1
8109,4024,2465,1809.2,18092,18652,7.0,11,11,10,213,21.3,0,0,1,0,1,212,21.2,1,1,3,3,6.2,16187,14068,1406.8,-2465,-4024,1
8110,-1128,-2710,1652.2,16522,17675,6.8,6,6,7,223,22.3,0,0,0,1,1,224,22.4,1,4,9,9,7.4,20385,17650,1765.0,2710,1128,0
8111,4135,1375,1805.3,18053,18267,6.8,9,9,15,247,24.7,1,1,1,0,0,211,21.1,0,2,1,1,6.6,16892,13918,1391.8,-1375,-4135,1
8112,4765,3054,1947.5,19475,18887,7.2,10,10,16,233,23.3,0,0,1,0,1,202,20.2,1,3,3,3,6.6,15833,14710,1471.0,-3054,-4765,0
8113,1581,1899,1869.3,18693,19277,7.4,12,12,11,206,20.6,1,1,1,0,0,207,20.7,0,11,7,7,6.6,17378,17112,1711.2,-1899,-1581,0
8114,1603,1827,1648.8,16488,18632,7.2,5,5,7,220,22.0,1,1,0,1,0,197,19.7,1,4,4,4,6.6,16805,14885,1488.5,-1827,-1603,1
8115,2236,288,1753.1,17531,18252,6.8,8,8,8,230,23.0,0,0,1,0,0,212,21.2,0,2,4,4,6.8,17964,15295,1529.5,-288,-2236,0
8116,1391,214,1542.2,15422,16988,6.8,3,3,3,215,21.5,0,0,1,0,1,232,23.2,1,3,2,2,6.8,16774,14031,1403.1,-214,-1391,1
8117,-1729,-437,1527.6,15276,18400,7.2,3,3,1,214,21.4,0,0,0,1,1,250,25.0,1,8,6,6,7.0,18837,17005,1700.5,437,1729,0
8118,614,-322,1739.0,17390,17256,7.0,9,9,12,196,19.6,2,1,1,0,0,213,21.3,0,7,5,5,6.6,17578,16776,1677.6,322,-614,0
8119,-1538,-1233,1759.3,17593,17439,6.8,10,10,10,178,17.8,0,0,1,0,1,201,20.1,2,15,11,11,7.0,18672,19131,1913.1,1233,1538,0
8120,-2116,-1407,1582.0,15820,18253,7.0,6,6,7,203,20.3,0,0,0,1,1,223,22.3,1,11,10,10,7.2,19660,17936,1793.6,1407,2116,0
8121,2973,1838,1719.8,17198,17495,6.8,8,8,5,226,22.6,0,0,1,0,1,141,14.1,1,5,4,4,6.2,15657,14225,1422.5,-1838,-2973,1
8122,-149,427,1700.0,17000,18009,6.8,8,8,7,190,19.0,1,1,0,1,0,211,21.1,0,8,9,9,7.0,17582,17149,1714.9,-427,149,1
8123,-1240,-76,1519.6,15196,18612,6.8,6,6,2,209,20.9,0,0,0,1,1,210,21.0,1,6,6,6,7.0,18688,16436,1643.6,76,1240,0
8124,-2651,-1695,1635.8,16358,17640,6.8,5,5,3,206,20.6,0,0,1,0,0,218,21.8,0,14,12,12,7.2,19335,19009,1900.9,1695,2651,1
8125,-1022,-1200,1746.9,17469,16911,6.8,9,9,13,195,19.5,1,1,1,0,0,248,24.8,0,13,10,10,6.8,18111,18491,1849.1,1200,1022,1
8126,1643,882,1603.1,16031,17458,6.8,7,7,4,218,21.8,1,1,0,1,0,225,22.5,0,0,2,2,6.6,16576,14388,1438.8,-882,-1643,1
8127,760,995,1707.0,17070,18971,7.2,6,6,7,223,22.3,1,1,1,0,0,230,23.0,0,6,5,5,6.8,17976,16310,1631.0,-995,-760,0
8128,-1454,-1276,1478.2,14782,17600,6.8,3,3,3,238,23.8,0,0,0,1,1,204,20.4,1,6,6,6,7.2,18876,16236,1623.6,1276,1454,0
8129,1875,2074,1661.0,16610,19266,7.4,5,5,7,246,24.6,1,0,1,0,1,207,20.7,1,3,3,3,6.8,17192,14735,1473.5,-2074,-1875,1
8130,2116,1613,1725.5,17255,18288,7.0,8,8,11,237,23.7,1,1,0,1,0,203,20.3,0,5,4,4,6.6,16675,15139,1513.9,-1613,-2116,1
8131,-1034,-846,1425.9,14259,15830,6.4,3,3,5,202,20.2,0,0,0,1,1,229,22.9,1,0,3,3,6.6,16676,15293,1529.3,846,1034,0
8132,-577,-679,1610.0,16100,18918,7.0,7,7,7,223,22.3,0,0,1,0,1,237,23.7,2,3,6,6,7.0,19597,16677,1667.7,679,577,0
8133,6310,5136,1964.1,19641,19614,7.4,13,13,18,207,20.7,1,1,1,0,0,199,19.9,0,3,1,1,6.0,14478,13331,1333.1,-5136,-6310,1
8134,1482,1629,1734.6,17346,18654,7.0,8,8,8,208,20.8,1,1,0,1,0,211,21.1,0,6,5,5,6.8,17025,15864,1586.4,-1629,-1482,1
8135,787,1089,1600.2,16002,19380,7.2,3,3,3,230,23.0,0,0,0,1,1,231,23.1,1,2,3,3,7.2,18291,15215,1521.5,-1089,-787,1
8136,2170,2480,1607.0,16070,19798,7.2,4,4,6,236,23.6,1,1,1,0,0,240,24.0,0,0,0,0,6.8,17318,13900,1390.0,-2480,-2170,1
8137,-2617,-2322,1422.7,14227,16822,6.6,2,2,1,205,20.5,0,0,0,1,1,208,20.8,1,11,10,10,7.2,19144,16844,1684.4,2322,2617,0
8138,4058,3407,1871.5,18715,19675,7.2,10,10,13,226,22.6,0,0,1,0,0,229,22.9,0,2,2,2,6.6,16268,14657,1465.7,-3407,-4058,1
8139,238,368,1737.5,17375,18035,6.8,9,9,9,217,21.7,1,1,1,0,0,207,20.7,0,11,8,8,6.8,17667,17137,1713.7,-368,-238,1
8140,-1980,-973,1516.2,15162,18046,6.8,3,3,3,227,22.7,0,0,0,1,0,256,25.6,0,5,7,7,7.2,19019,17142,1714.2,973,1980,0
8141,-1137,-982,1557.1,15571,16898,6.8,6,6,6,190,19.0,1,1,0,1,0,228,22.8,1,5,6,6,7.0,17880,16708,1670.8,982,1137,0
8142,-124,253,1507.0,15070,17424,6.6,4,4,4,218,21.8,1,1,1,0,0,198,19.8,0,6,5,5,6.8,17171,15194,1519.4,-253,124,1
8143,2246,1265,1872.3,18723,18851,7.2,12,12,14,190,19.0,2,1,1,0,0,227,22.7,0,5,4,4,6.8,17586,16477,1647.7,-1265,-2246,1
8144,-978,78,1725.8,17258,18755,7.0,8,8,7,214,21.4,1,0,1,0,1,207,20.7,1,8,9,9,7.2,18677,18236,1823.6,-78,978,0
8145,-2659,88,1610.3,16103,18747,7.2,5,5,4,208,20.8,1,0,1,0,0,245,24.5,0,11,6,6,7.4,18659,18762,1876.2,-88,2659,0
8146,-3224,-1270,1470.9,14709,17193,6.8,3,3,1,207,20.7,1,0,0,1,1,238,23.8,1,16,9,9,7.2,18463,17933,1793.3,1270,3224,0
8147,312,-1396,1712.2,17122,17535,7.0,8,8,10,204,20.4,0,0,1,0,1,211,21.1,1,7,7,7,7.0,18931,16810,1681.0,1396,-312,0
8148,-2462,-3352,1369.6,13696,16789,6.8,1,1,0,200,20.0,1,1,1,0,0,202,20.2,1,6,5,5,7.6,20141,16158,1615.8,3352,2462,0
8149,2617,2411,1776.4,17764,19589,7.4,9,9,7,235,23.5,1,1,1,0,0,220,22.0,0,2,3,3,6.6,17178,15147,1514.7,-2411,-2617,1
8150,846,1138,1627.5,16275,19461,7.4,4,4,3,244,24.4,0,0,1,0,0,233,23.3,0,1,3,3,7.2,18323,15429,1542.9,-1138,-846,1
8151,6450,5057,2012.4,20124,19495,7.4,11,11,12,230,23.0,2,1,1,0,0,205,20.5,0,2,2,2,6.0,14438,13674,1367.4,-5057,-6450,1
8152,-2861,-1651,1577.5,15775,17025,6.8,6,6,4,206,20.6,0,0,0,1,1,210,21.0,1,14,11,11,7.0,18676,18636,1863.6,1651,2861,0
8153,355,818,1569.3,15693,17206,6.6,6,6,2,199,19.9,2,1,1,0,0,192,19.2,0,5,6,6,6.6,16388,15338,1533.8,-818,-355,1
8154,2305,482,1747.9,17479,18923,7.0,7,7,8,246,24.6,0,0,1,0,1,226,22.6,2,0,2,2,7.2,18441,15174,1517.4,-482,-2305,1
8155,-359,784,1784.0,17840,19273,7.2,9,9,9,226,22.6,1,0,0,1,1,207,20.7,1,9,10,10,7.0,18489,18199,1819.9,-784,359,1
8156,-3967,-3114,1525.9,15259,15471,6.6,5,5,8,180,18.0,0,0,0,1,0,247,24.7,0,8,6,6,7.0,18585,19226,1922.6,3114,3967,0
8157,-5182,-3884,1522.5,15225,16104,6.2,4,4,3,187,18.7,1,1,0,1,0,246,24.6,1,9,11,11,7.4,19988,20407,2040.7,3884,5182,0
8158,2344,1517,1731.2,17312,19125,7.0,9,9,11,217,21.7,0,0,1,0,0,201,20.1,0,4,4,4,6.8,17608,14968,1496.8,-1517,-2344,1
8159,865,1006,1669.6,16696,17832,7.0,8,8,10,206,20.6,1,0,0,1,0,220,22.0,0,3,4,4,6.6,16826,15831,1583.1,-1006,-865,0
8160,-516,-3,1669.0,16690,18319,7.2,6,6,6,235,23.5,0,0,0,1,1,235,23.5,1,9,7,7,7.0,18322,17206,1720.6,3,516,1
8161,-38,1167,1622.5,16225,18754,7.0,5,5,3,219,21.9,0,0,0,1,0,239,23.9,0,8,6,6,6.8,17587,16263,1626.3,-1167,38,0
8162,-2510,-4246,1572.0,15720,15834,6.4,4,4,8,212,21.2,0,0,1,0,1,249,24.9,2,5,8,8,7.2,20080,18230,1823.0,4246,2510,0
8163,-6260,-3364,1373.8,13738,15483,6.4,2,2,2,169,16.9,0,0,0,1,0,238,23.8,0,15,13,13,7.0,18847,19998,1999.8,3364,6260,0
8164,2953,1980,1824.0,18240,19116,7.0,10,10,7,259,25.9,1,1,1,0,0,197,19.7,0,4,5,5,6.8,17136,15287,1528.7,-1980,-2953,1
8165,1603,1799,1643.9,16439,18635,7.2,6,6,7,220,22.0,1,1,1,0,0,213,21.3,1,1,4,4,6.6,16836,14836,1483.6,-1799,-1603,1
8166,-1454,-1205,1576.1,15761,18196,7.0,4,4,3,253,25.3,0,0,1,0,0,233,23.3,0,6,7,7,7.2,19401,17215,1721.5,1205,1454,0
8167,1550,910,1852.9,18529,18459,7.2,9,9,10,227,22.7,1,0,1,0,1,206,20.6,1,11,8,8,6.6,17549,16979,1697.9,-910,-1550,0
8168,-1065,626,1699.6,16996,18052,6.8,8,8,8,227,22.7,0,0,0,1,0,216,21.6,0,13,10,10,6.8,17426,18061,1806.1,-626,1065,0
8169,753,-587,1766.5,17665,17473,6.8,10,10,10,207,20.7,0,0,1,0,0,191,19.1,0,6,8,8,6.8,18060,16912,1691.2,587,-753,1
8170,-877,418,1696.9,16969,18900,7.0,7,7,5,198,19.8,1,1,1,0,0,229,22.9,0,11,10,10,7.2,18482,17846,1784.6,-418,877,1
8171,-902,385,1547.4,15474,19351,7.4,2,2,3,244,24.4,1,1,0,1,0,237,23.7,1,7,5,5,7.2,18966,16376,1637.6,-385,902,0
8172,1790,350,1820.4,18204,18154,7.0,11,11,15,186,18.6,1,1,0,1,0,229,22.9,0,4,5,5,7.0,17804,16414,1641.4,-350,-1790,1
8173,1497,717,1716.0,17160,18228,7.0,6,6,10,241,24.1,0,0,0,1,1,218,21.8,1,4,5,5,6.8,17511,15663,1566.3,-717,-1497,0
8174,2717,2815,1687.6,16876,18664,7.0,6,6,4,256,25.6,0,0,1,0,0,205,20.5,0,4,3,3,6.4,15849,14159,1415.9,-2815,-2717,1
8175,2428,2186,1812.9,18129,19644,7.2,10,10,7,230,23.0,0,0,0,1,1,212,21.2,1,9,6,6,6.8,17458,15701,1570.1,-2186,-2428,1
8176,42,1367,1721.0,17210,19805,7.4,6,6,4,243,24.3,0,0,0,1,1,255,25.5,1,3,7,7,7.0,18438,17168,1716.8,-1367,-42,1
8177,-3574,-387,1506.7,15067,16500,6.6,5,5,3,203,20.3,0,0,0,1,0,218,21.8,1,14,10,10,6.6,16887,18641,1864.1,387,3574,1
8178,-1008,-717,1501.3,15013,17384,7.0,5,5,4,198,19.8,1,1,0,1,0,225,22.5,0,6,5,5,7.0,18101,16021,1602.1,717,1008,0
8179,714,1650,1694.6,16946,19649,7.4,7,7,6,221,22.1,0,0,1,0,0,215,21.5,0,7,6,6,6.8,17999,16232,1623.2,-1650,-714,1
8180,2239,1539,1840.3,18403,19486,7.4,11,11,11,239,23.9,0,0,0,1,1,231,23.1,1,4,5,5,6.6,17947,16164,1616.4,-1539,-2239,1
8181,-1909,-1282,1411.5,14115,16918,6.8,2,2,2,199,19.9,1,0,0,1,1,229,22.9,1,5,5,5,7.0,18200,16024,1602.4,1282,1909,0
8182,305,992,1532.1,15321,18162,7.0,2,2,0,255,25.5,0,0,1,0,1,222,22.2,1,5,4,4,6.8,17170,15016,1501.6,-992,-305,1
8183,144,312,1585.0,15850,18559,7.0,5,5,0,216,21.6,0,0,1,0,1,238,23.8,1,4,5,5,7.2,18247,15706,1570.6,-312,-144,0
8184,789,-175,1570.4,15704,17817,7.0,3,3,3,246,24.6,0,0,0,1,1,232,23.2,1,2,1,1,6.8,17992,14915,1491.5,175,-789,1
8185,8,-625,1771.6,17716,17963,7.0,5,5,7,216,21.6,1,0,0,1,1,249,24.9,1,4,5,5,7.2,18588,17708,1770.8,625,-8,1
8186,-754,-157,1660.4,16604,18077,7.0,6,6,8,235,23.5,1,0,1,0,0,243,24.3,0,9,7,7,6.8,18234,17358,1735.8,157,754,0
8187,-3363,-1920,1480.8,14808,16376,6.6,4,4,6,180,18.0,0,0,1,0,0,212,21.2,0,7,8,8,7.0,18296,18171,1817.1,1920,3363,0
8188,-510,-837,1592.4,15924,17006,6.8,6,6,8,191,19.1,0,0,0,1,1,225,22.5,1,7,4,4,7.0,17843,16434,1643.4,837,510,1
8189,-1080,-1664,1499.4,14994,16731,6.6,3,3,7,199,19.9,0,0,1,0,0,235,23.5,1,3,5,5,7.0,18395,16074,1607.4,1664,1080,0
8190,-2191,-1498,1353.3,13533,15497,6.4,1,1,0,212,21.2,0,0,0,1,1,207,20.7,1,9,5,5,6.8,16995,15724,1572.4,1498,2191,0
8191,3274,3262,1831.4,18314,21257,7.6,6,6,4,257,25.7,0,0,0,1,1,195,19.5,1,3,3,3,7.0,17995,15040,1504.0,-3262,-3274,1
8192,149,210,1638.7,16387,18488,7.2,4,4,4,235,23.5,0,0,0,1,1,202,20.2,1,9,7,7,6.8,18278,16238,1623.8,-210,-149,0
8193,-317,-27,1562.9,15629,17035,6.8,6,6,4,212,21.2,0,0,0,1,1,200,20.0,1,11,6,6,6.8,17062,15946,1594.6,27,317,0
8194,2422,1766,1607.0,16070,18706,7.0,4,4,1,251,25.1,1,1,1,0,0,199,19.9,0,3,1,1,6.6,16940,13648,1364.8,-1766,-2422,1
8195,370,-66,1559.6,15596,18105,6.8,4,4,5,223,22.3,1,1,1,0,0,200,20.0,0,4,4,4,7.0,18171,15226,1522.6,66,-370,0
8196,2312,1175,1701.0,17010,18660,7.0,5,5,8,250,25.0,1,1,1,0,0,220,22.0,0,2,2,2,6.6,17485,14698,1469.8,-1175,-2312,1
8197,-96,277,1743.1,17431,17957,7.0,8,8,10,208,20.8,1,0,0,1,1,215,21.5,1,8,9,9,6.6,17680,17527,1752.7,-277,96,0
8198,-2262,-1763,1666.4,16664,17627,6.8,7,7,6,214,21.4,0,0,0,1,1,195,19.5,1,16,11,11,7.4,19390,18926,1892.6,1763,2262,0
8199,-4293,-3731,1514.4,15144,16164,6.4,4,4,5,197,19.7,0,0,1,0,0,241,24.1,0,18,11,11,7.4,19895,19437,1943.7,3731,4293,0
8200,-1085,-1869,1570.3,15703,17085,6.6,5,5,8,195,19.5,0,0,1,0,1,229,22.9,2,5,6,6,7.2,18954,16788,1678.8,1869,1085,0
8201,2301,667,1806.2,18062,17582,6.8,10,10,15,220,22.0,0,0,1,0,1,204,20.4,1,9,5,5,6.6,16915,15761,1576.1,-667,-2301,1
8202,800,-237,1678.7,16787,17483,6.8,7,7,8,208,20.8,1,1,0,1,0,236,23.6,0,7,5,5,6.8,17720,15987,1598.7,237,-800,0
8203,2510,2517,1978.5,19785,20587,7.4,12,12,5,221,22.1,1,0,0,1,1,213,21.3,1,10,10,10,7.0,18070,17275,1727.5,-2517,-2510,1
8204,1917,1186,1840.8,18408,19955,7.4,10,10,9,208,20.8,2,1,1,0,0,211,21.1,0,4,5,5,7.0,18769,16491,1649.1,-1186,-1917,1
8205,-558,-1482,1861.4,18614,18540,7.0,11,11,13,208,20.8,1,1,0,1,0,227,22.7,0,15,11,11,7.6,20022,19172,1917.2,1482,558,0
8206,3067,503,1970.4,19704,18253,7.0,12,12,12,209,20.9,1,0,1,0,1,174,17.4,1,6,10,10,6.8,17750,16637,1663.7,-503,-3067,1
8207,-1201,-919,1528.1,15281,17495,6.8,2,2,2,248,24.8,1,1,0,1,0,247,24.7,0,11,5,5,6.8,18414,16482,1648.2,919,1201,0
8208,-2310,-2290,1325.3,13253,16475,6.4,1,1,1,190,19.0,1,1,0,1,0,248,24.8,0,1,3,3,7.4,18765,15563,1556.3,2290,2310,0
8209,203,557,1719.2,17192,17774,7.0,8,8,15,190,19.0,1,1,0,1,0,235,23.5,0,14,8,8,6.8,17217,16989,1698.9,-557,-203,0
8210,117,248,1679.6,16796,18185,6.8,6,6,9,232,23.2,1,1,0,1,0,221,22.1,0,9,5,5,6.8,17937,16679,1667.9,-248,-117,0
8211,2419,1118,1858.2,18582,18084,6.8,11,11,10,207,20.7,1,1,0,1,0,193,19.3,0,8,7,7,7.0,16966,16163,1616.3,-1118,-2419,1
8212,447,919,1709.8,17098,20021,7.4,6,6,7,243,24.3,1,0,0,1,0,220,22.0,0,6,5,5,7.0,19102,16651,1665.1,-919,-447,0
8213,-1219,-759,1576.6,15766,17649,6.8,5,5,5,209,20.9,1,0,0,1,1,227,22.7,1,10,6,6,7.0,18408,16985,1698.5,759,1219,0
8214,-1371,-1951,1476.7,14767,16754,6.8,3,3,3,214,21.4,1,1,1,0,0,256,25.6,0,4,5,5,7.0,18705,16138,1613.8,1951,1371,1
8215,3235,1168,1892.9,18929,18674,7.0,10,10,13,170,17.0,2,1,1,0,0,241,24.1,0,6,3,3,7.0,17506,15694,1569.4,-1168,-3235,1
8216,2299,1804,1804.6,18046,19739,7.4,10,10,12,226,22.6,1,1,1,0,0,229,22.9,0,5,5,5,7.2,17935,15747,1574.7,-1804,-2299,1
8217,-1556,-3181,1703.5,17035,17308,7.0,8,8,6,204,20.4,1,1,0,1,0,213,21.3,0,9,10,10,7.4,20489,18591,1859.1,3181,1556,0
8218,-1323,-1622,1599.2,15992,17572,6.8,3,3,3,251,25.1,0,0,0,1,1,218,21.8,2,10,7,7,7.2,19194,17315,1731.5,1622,1323,0
8219,1625,552,1779.1,17791,18244,7.0,8,8,11,216,21.6,0,0,1,0,1,215,21.5,1,9,6,6,6.8,17692,16166,1616.6,-552,-1625,1
8220,819,-48,1651.7,16517,17812,6.8,5,5,3,246,24.6,1,1,0,1,0,245,24.5,0,4,4,4,7.2,17860,15698,1569.8,48,-819,1
8221,-735,-742,1586.3,15863,18126,7.0,7,7,4,178,17.8,1,1,1,0,0,231,23.1,0,3,8,8,7.0,18868,16598,1659.8,742,735,0
8222,2386,395,1677.9,16779,18382,7.0,5,5,5,268,26.8,0,0,1,0,0,204,20.4,0,4,2,2,7.0,17987,14393,1439.3,-395,-2386,1
8223,-1281,-525,1714.5,17145,18179,6.8,10,10,8,180,18.0,0,0,0,1,0,212,21.2,0,9,9,9,7.0,18704,18426,1842.6,525,1281,0
8224,-786,-837,1516.1,15161,17998,7.0,4,4,4,194,19.4,0,0,0,1,1,231,23.1,1,3,5,5,7.2,18835,15947,1594.7,837,786,1
8225,-224,-1881,1745.1,17451,18484,7.0,6,6,5,249,24.9,1,1,1,0,0,205,20.5,0,10,9,9,7.4,20365,17675,1767.5,1881,224,1
8226,2587,2759,1834.2,18342,20325,7.4,7,7,10,224,22.4,0,0,1,0,1,213,21.3,1,3,4,4,6.6,17566,15755,1575.5,-2759,-2587,1
8227,460,183,1649.8,16498,18296,7.0,5,5,8,259,25.9,1,1,0,1,0,213,21.3,0,7,5,5,7.0,18113,16038,1603.8,-183,-460,1
8228,-3348,-1795,1497.5,14975,17721,7.0,3,3,2,227,22.7,0,0,0,1,0,224,22.4,1,10,8,8,7.2,19516,18323,1832.3,1795,3348,0
8229,2350,2705,1701.7,17017,19023,7.0,9,9,7,204,20.4,1,0,1,0,1,220,22.0,1,3,2,2,6.6,16318,14667,1466.7,-2705,-2350,1
8230,-6115,-3209,1387.2,13872,17095,6.4,2,2,1,197,19.7,0,0,0,1,0,264,26.4,0,9,10,10,7.4,20304,19987,1998.7,3209,6115,0
8231,1340,1826,1794.0,17940,19545,7.4,8,8,9,216,21.6,2,1,0,1,0,219,21.9,0,4,8,8,6.8,17719,16600,1660.0,-1826,-1340,1
8232,-2491,-2521,1403.7,14037,15309,6.2,3,3,4,167,16.7,0,0,1,0,1,202,20.2,2,6,8,8,7.0,17830,16528,1652.8,2521,2491,0
8233,-1109,-1493,1553.4,15534,17293,7.0,5,5,6,207,20.7,1,1,1,0,0,223,22.3,0,4,7,7,7.2,18786,16643,1664.3,1493,1109,0
8234,1634,1007,1807.4,18074,19942,7.4,8,8,11,252,25.2,1,1,1,0,0,223,22.3,0,7,6,6,7.0,18935,16440,1644.0,-1007,-1634,1
8235,1252,-271,1764.0,17640,17082,6.6,11,11,15,164,16.4,2,1,1,0,0,176,17.6,0,11,8,8,6.8,17353,16388,1638.8,271,-1252,1
8236,-244,1250,1553.9,15539,17962,6.8,3,3,4,241,24.1,1,1,0,1,0,185,18.5,0,3,5,5,6.8,16712,15783,1578.3,-1250,244,1
8237,2180,462,1785.4,17854,17358,7.0,9,9,10,170,17.0,1,0,0,1,1,209,20.9,1,6,6,6,6.8,16896,15674,1567.4,-462,-2180,1
8238,2660,-730,1892.4,18924,18340,7.0,9,9,10,216,21.6,2,1,1,0,0,221,22.1,0,3,6,6,7.0,19070,16264,1626.4,730,-2660,1
8239,4124,3900,1882.8,18828,20691,7.4,10,10,7,244,24.4,1,1,1,0,0,220,22.0,0,1,2,2,6.8,16791,14704,1470.4,-3900,-4124,1
8240,34,985,1619.2,16192,18524,7.0,6,6,4,218,21.8,0,0,1,0,1,209,20.9,1,7,6,6,6.8,17539,16158,1615.8,-985,-34,1
8241,-674,530,1731.2,17312,17334,6.6,9,9,10,231,23.1,0,0,0,1,0,200,20.0,0,13,9,9,6.8,16804,17986,1798.6,-530,674,1
8242,-1036,-942,1495.1,14951,17903,6.8,3,3,4,225,22.5,0,0,1,0,1,252,25.2,1,3,3,3,7.2,18845,15987,1598.7,942,1036,0
8243,1059,-338,1740.5,17405,18074,7.0,8,8,11,204,20.4,1,1,1,0,0,221,22.1,0,9,6,6,7.0,18412,16346,1634.6,338,-1059,0
8244,-1398,-26,1920.1,19201,19303,7.0,12,12,12,215,21.5,0,0,1,0,1,215,21.5,1,13,13,13,7.2,19329,20599,2059.9,26,1398,1
8245,6770,4384,2009.5,20095,20229,7.6,13,13,14,219,21.9,1,1,1,0,0,199,19.9,0,0,0,0,6.6,15845,13325,1332.5,-4384,-6770,1
8246,-1302,-611,1479.9,14799,17594,6.6,3,3,3,227,22.7,1,1,0,1,0,201,20.1,0,6,5,5,6.8,18205,16101,1610.1,611,1302,0
8247,3373,2086,1722.0,17220,19745,7.4,4,4,3,233,23.3,2,1,1,0,0,225,22.5,0,0,1,1,7.0,17659,13847,1384.7,-2086,-3373,1
8248,-3528,-2277,1549.4,15494,16228,6.4,5,5,6,187,18.7,2,1,0,1,0,260,26.0,0,8,8,8,7.0,18505,19022,1902.2,2277,3528,0
8249,941,2107,1872.2,18722,18687,7.2,12,12,17,212,21.2,0,0,1,0,1,225,22.5,1,7,9,9,6.6,16580,17781,1778.1,-2107,-941,1
8250,-1404,443,1544.0,15440,16608,6.6,5,5,4,209,20.9,0,0,1,0,0,188,18.8,0,12,8,8,6.6,16165,16844,1684.4,-443,1404,1
8251,8667,7645,2327.8,23278,22125,7.8,19,19,25,240,24.0,0,0,0,1,0,189,18.9,0,7,3,3,6.2,14480,14611,1461.1,-7645,-8667,1
8252,-1782,-972,1652.5,16525,18095,6.8,6,6,5,204,20.4,1,0,1,0,1,217,21.7,1,11,9,9,7.2,19067,18307,1830.7,972,1782,0
8253,1402,1512,1663.8,16638,18824,7.2,6,6,5,212,21.2,1,1,1,0,0,230,23.0,0,3,3,3,6.8,17312,15236,1523.6,-1512,-1402,1
8254,472,-797,1556.2,15562,17070,6.8,3,3,3,224,22.4,0,0,1,0,0,222,22.2,0,3,3,3,7.0,17867,15090,1509.0,797,-472,1
8255,1935,411,1591.9,15919,17737,6.6,2,2,4,262,26.2,2,1,1,0,0,244,24.4,0,0,0,0,6.6,17326,13984,1398.4,-411,-1935,1
8256,-1185,-1150,1592.2,15922,17677,7.0,4,4,8,245,24.5,1,0,0,1,1,236,23.6,1,7,6,6,7.2,18827,17107,1710.7,1150,1185,0
8257,-388,-325,1521.3,15213,17861,6.8,3,3,2,252,25.2,1,1,0,1,0,209,20.9,0,3,5,5,7.0,18186,15601,1560.1,325,388,1
8258,1768,939,1624.7,16247,17036,6.6,7,7,12,205,20.5,2,1,1,0,0,189,18.9,0,2,3,3,6.6,16097,14479,1447.9,-939,-1768,0
8259,5391,2596,1908.2,19082,18868,7.2,10,10,8,231,23.1,2,1,1,0,0,176,17.6,0,2,3,3,6.2,16272,13691,1369.1,-2596,-5391,1
8260,2326,1907,1714.6,17146,18930,7.2,6,6,8,219,21.9,1,1,0,1,0,206,20.6,0,2,3,3,6.6,17023,14820,1482.0,-1907,-2326,1
8261,2508,1742,1707.9,17079,20271,7.6,5,5,7,238,23.8,1,1,1,0,0,249,24.9,0,2,1,1,7.2,18529,14571,1457.1,-1742,-2508,1
8262,-365,-1278,1733.0,17330,17971,7.0,6,6,7,237,23.7,0,0,1,0,1,227,22.7,1,8,7,7,7.2,19249,17695,1769.5,1278,365,0
8263,1828,302,1683.8,16838,18339,7.2,7,7,7,239,23.9,0,0,1,0,1,235,23.5,1,0,3,3,6.8,18037,15010,1501.0,-302,-1828,0
8264,-836,-1109,1742.4,17424,17446,6.8,8,8,8,220,22.0,1,0,1,0,0,211,21.1,0,14,9,9,7.2,18555,18260,1826.0,1109,836,0
8265,-350,626,1588.5,15885,17840,6.8,5,5,9,233,23.3,0,0,1,0,0,221,22.1,0,5,4,4,7.0,17214,16235,1623.5,-626,350,0
8266,457,-959,1633.9,16339,17365,7.0,7,7,10,224,22.4,1,1,1,0,0,254,25.4,1,3,4,4,7.0,18324,15882,1588.2,959,-457,0
8267,3712,2007,1769.3,17693,18485,7.2,7,7,10,241,24.1,1,1,1,0,0,196,19.6,0,4,2,2,6.6,16478,13981,1398.1,-2007,-3712,1
8268,3931,4106,2003.2,20032,20277,7.4,16,16,21,166,16.6,1,1,1,0,0,198,19.8,0,4,5,5,6.6,16171,16101,1610.1,-4106,-3931,1
8269,63,261,1544.7,15447,17708,7.0,4,4,5,201,20.1,1,0,0,1,1,228,22.8,1,1,4,4,6.8,17447,15384,1538.4,-261,-63,1
8270,-4496,-4428,1409.9,14099,15839,6.4,3,3,4,200,20.0,0,0,0,1,1,227,22.7,2,10,8,8,7.4,20267,18595,1859.5,4428,4496,0
8271,-839,-82,1533.5,15335,17217,6.6,3,3,6,219,21.9,1,1,0,1,0,225,22.5,0,5,6,6,7.0,17299,16174,1617.4,82,839,1
8272,-4030,-2539,1419.8,14198,15730,6.4,2,2,2,195,19.5,0,0,0,1,0,198,19.8,0,15,13,13,7.0,18269,18228,1822.8,2539,4030,0
8273,-1596,-1269,1529.8,15298,16504,6.6,4,4,4,208,20.8,0,0,1,0,1,210,21.0,1,10,6,6,6.8,17773,16894,1689.4,1269,1596,1
8274,-4523,-3174,1556.4,15564,17844,6.8,4,4,3,236,23.6,1,1,0,1,0,231,23.1,1,9,11,11,7.6,21018,20087,2008.7,3174,4523,0
8275,1786,2804,1769.6,17696,18812,7.2,8,8,2,224,22.4,2,1,0,1,0,200,20.0,0,7,4,4,6.4,16008,15910,1591.0,-2804,-1786,1
8276,-1495,330,1604.7,16047,18407,6.8,6,6,4,214,21.4,1,1,0,1,0,205,20.5,0,11,8,8,6.8,18077,17542,1754.2,-330,1495,1
8277,-2834,-2773,1411.2,14112,15898,6.4,3,3,5,216,21.6,0,0,0,1,1,203,20.3,1,8,8,8,7.0,18671,16946,1694.6,2773,2834,0
8278,-888,1328,1531.4,15314,17971,7.0,3,3,2,226,22.6,0,0,0,1,0,220,22.0,1,3,5,5,6.8,16643,16202,1620.2,-1328,888,0
8279,-2259,-898,1605.7,16057,17123,6.8,7,7,11,187,18.7,1,1,1,0,0,227,22.7,0,14,10,10,6.8,18021,18316,1831.6,898,2259,1
8280,1300,127,1626.6,16266,18203,7.0,6,6,6,208,20.8,0,0,1,0,1,155,15.5,1,4,6,6,7.2,18076,14966,1496.6,-127,-1300,1
8281,-3764,-1700,1516.8,15168,16728,6.6,4,4,4,197,19.7,1,1,0,1,0,198,19.8,0,12,11,11,6.8,18428,18932,1893.2,1700,3764,0
8282,-1426,-272,1766.5,17665,18891,6.8,9,9,13,211,21.1,1,0,1,0,1,214,21.4,1,14,10,10,7.2,19163,19091,1909.1,272,1426,1
8283,-1614,15,1436.6,14366,17267,6.8,4,4,2,207,20.7,1,0,0,1,1,216,21.6,1,9,5,5,7.0,17252,15980,1598.0,-15,1614,0
8284,2013,900,1910.6,19106,17739,6.8,11,11,14,189,18.9,0,0,0,1,0,188,18.8,0,8,7,7,6.6,16839,17093,1709.3,-900,-2013,1
8285,-4513,-2787,1385.0,13850,16985,6.8,0,0,0,217,21.7,1,1,0,1,0,246,24.6,0,15,9,9,7.4,19772,18363,1836.3,2787,4513,0
8286,-5271,-4236,1563.3,15633,16398,6.4,7,7,4,188,18.8,0,0,0,1,1,269,26.9,2,14,12,12,7.6,20634,20904,2090.4,4236,5271,0
8287,-197,919,1720.8,17208,17852,6.8,9,9,8,194,19.4,0,0,1,0,0,218,21.8,0,10,8,8,6.6,16933,17405,1740.5,-919,197,1
8288,-2842,-1722,1577.1,15771,17334,6.8,6,6,6,187,18.7,2,1,1,0,0,264,26.4,0,9,6,6,7.0,19056,18613,1861.3,1722,2842,0
8289,-4668,-3772,1413.2,14132,16898,6.8,2,2,2,210,21.0,1,1,0,1,0,226,22.6,1,11,9,9,7.6,20670,18800,1880.0,3772,4668,0
8290,3994,3953,1841.3,18413,19646,7.2,14,14,18,196,19.6,1,1,0,1,0,213,21.3,0,2,3,3,6.2,15693,14419,1441.9,-3953,-3994,1
8291,-2420,-2518,1567.3,15673,17330,6.6,6,6,6,197,19.7,1,1,1,0,0,197,19.7,0,10,11,11,7.4,19848,18093,1809.3,2518,2420,0
8292,2805,2754,1709.1,17091,19482,7.2,6,6,2,229,22.9,1,1,1,0,0,235,23.5,0,1,1,1,6.6,16728,14286,1428.6,-2754,-2805,1
8293,-11,-1495,1688.5,16885,17748,6.6,8,8,7,220,22.0,0,0,1,0,1,213,21.3,1,6,7,7,7.2,19243,16896,1689.6,1495,11,0
8294,-3421,-2836,1483.6,14836,16507,6.4,3,3,6,214,21.4,0,0,0,1,1,229,22.9,1,9,10,10,7.2,19343,18257,1825.7,2836,3421,0
8295,1142,841,1830.3,18303,19278,7.2,11,11,7,220,22.0,0,0,0,1,0,201,20.1,0,7,8,8,7.0,18437,17161,1716.1,-841,-1142,0
8296,-2892,-2716,1550.3,15503,18406,6.8,4,4,8,204,20.4,0,0,0,1,1,261,26.1,2,6,8,8,7.6,21122,18395,1839.5,2716,2892,0
8297,324,231,1539.8,15398,17885,6.8,3,3,3,227,22.7,1,1,0,1,0,239,23.9,1,1,3,3,6.8,17654,15074,1507.4,-231,-324,1
8298,3865,3559,1842.0,18420,19497,7.4,11,11,15,214,21.4,0,0,1,0,1,203,20.3,1,3,3,3,6.4,15938,14555,1455.5,-3559,-3865,0
8299,-3191,-1620,1470.2,14702,16103,6.6,4,4,5,193,19.3,0,0,0,1,1,219,21.9,1,17,11,11,7.0,17723,17893,1789.3,1620,3191,0
8300,2070,1019,1935.5,19355,20151,7.6,12,12,8,208,20.8,0,0,1,0,0,217,21.7,0,9,9,9,7.2,19132,17285,1728.5,-1019,-2070,1
8301,-3729,-3285,1498.0,14980,17318,6.8,5,5,4,187,18.7,0,0,0,1,1,257,25.7,1,7,9,9,7.6,20603,18709,1870.9,3285,3729,1
8302,-1127,471,1752.0,17520,19706,7.4,6,6,7,239,23.9,2,1,1,0,0,239,23.9,0,10,10,10,7.2,19235,18647,1864.7,-471,1127,1
8303,6713,5380,2125.7,21257,20163,7.4,17,17,25,220,22.0,2,1,0,1,0,170,17.0,0,3,4,4,6.2,14783,14544,1454.4,-5380,-6713,1
8304,350,-664,1556.5,15565,17390,6.8,3,3,5,227,22.7,1,1,0,1,0,221,22.1,1,4,4,4,7.0,18054,15215,1521.5,664,-350,1
8305,2568,3054,1672.3,16723,17764,6.8,7,7,7,193,19.3,1,1,1,0,0,183,18.3,0,6,4,4,6.2,14710,14155,1415.5,-3054,-2568,0
8306,-1625,-2418,1509.6,15096,16516,6.8,3,3,2,222,22.2,0,0,1,0,0,236,23.6,0,10,6,6,7.0,18934,16721,1672.1,2418,1625,0
8307,-2713,-1237,1482.7,14827,17370,6.6,4,4,0,207,20.7,0,0,0,1,1,247,24.7,2,11,6,6,7.2,18607,17540,1754.0,1237,2713,0
8308,1743,2124,1735.4,17354,18530,7.0,10,10,10,217,21.7,1,1,0,1,0,236,23.6,0,4,4,4,6.8,16406,15611,1561.1,-2124,-1743,1
8309,-1706,-685,1581.4,15814,17936,6.8,5,5,5,229,22.9,1,0,0,1,1,238,23.8,1,10,7,7,7.0,18621,17520,1752.0,685,1706,0
8310,-764,-128,1588.2,15882,17373,6.6,5,5,4,231,23.1,0,0,0,1,1,225,22.5,1,6,6,6,6.8,17501,16646,1664.6,128,764,0
8311,-2436,-3016,1533.1,15331,16126,6.6,3,3,4,212,21.2,0,0,0,1,1,237,23.7,1,5,9,9,7.2,19142,17767,1776.7,3016,2436,0
8312,-1988,-1490,1788.6,17886,15999,6.4,8,8,11,219,21.9,0,0,1,0,1,151,15.1,2,17,14,14,6.8,17489,19874,1987.4,1490,1988,0
8313,942,952,1689.7,16897,18457,7.2,5,5,6,218,21.8,1,0,0,1,0,220,22.0,0,4,5,5,6.8,17505,15955,1595.5,-952,-942,1
8314,-1002,-498,1561.3,15613,18046,6.6,4,4,4,244,24.4,0,0,1,0,1,181,18.1,2,9,7,7,7.0,18544,16615,1661.5,498,1002,1
8315,1787,1001,1690.2,16902,18641,7.2,8,8,15,189,18.9,1,1,1,0,0,222,22.2,1,4,3,3,6.8,17640,15115,1511.5,-1001,-1787,1
8316,1239,568,1654.4,16544,16417,6.6,9,9,10,191,19.1,0,0,1,0,0,179,17.9,1,8,6,6,6.4,15849,15305,1530.5,-568,-1239,0
8317,-232,97,1635.7,16357,16464,6.6,8,8,8,193,19.3,0,0,0,1,1,196,19.6,1,8,8,8,6.6,16367,16589,1658.9,-97,232,0
8318,974,748,1625.5,16255,18434,7.0,6,6,6,225,22.5,1,1,0,1,0,201,20.1,0,4,3,3,7.0,17686,15281,1528.1,-748,-974,1
8319,289,-201,1668.5,16685,18643,7.0,4,4,7,236,23.6,1,0,0,1,1,234,23.4,1,4,6,6,7.0,18844,16396,1639.6,201,-289,1
8320,-2568,-3931,1503.6,15036,15796,6.4,4,4,3,194,19.4,0,0,0,1,0,198,19.8,0,8,12,12,7.4,19727,17604,1760.4,3931,2568,0
8321,2402,2330,1755.4,17554,18464,7.0,9,9,7,240,24.0,1,0,1,0,0,172,17.2,0,3,5,5,6.4,16134,15152,1515.2,-2330,-2402,1
8322,1998,1200,1706.6,17066,18756,7.0,6,6,10,230,23.0,1,1,0,1,0,253,25.3,0,2,2,2,6.8,17556,15068,1506.8,-1200,-1998,0
8323,-77,-1515,1598.9,15989,17682,6.8,4,4,7,254,25.4,0,0,1,0,1,250,25.0,2,3,3,3,7.0,19197,16066,1606.6,1515,77,0
8324,763,1019,1598.4,15984,18367,7.0,7,7,5,205,20.5,0,0,1,0,1,175,17.5,1,6,5,5,6.8,17348,15221,1522.1,-1019,-763,1
8325,1092,806,1780.4,17804,17743,6.8,11,11,12,210,21.0,0,0,0,1,0,208,20.8,0,10,8,8,6.6,16937,16712,1671.2,-806,-1092,0
8326,436,-475,1613.6,16136,16071,6.4,7,7,9,212,21.2,1,1,0,1,0,190,19.0,0,6,7,7,6.8,16546,15700,1570.0,475,-436,0
8327,-2671,-719,1463.1,14631,17718,6.8,3,3,4,226,22.6,0,0,0,1,1,252,25.2,1,6,7,7,7.0,18437,17302,1730.2,719,2671,0
8328,-2958,-1446,1466.8,14668,16865,6.6,4,4,3,193,19.3,0,0,0,1,1,232,23.2,1,9,8,8,7.0,18311,17626,1762.6,1446,2958,0
8329,4739,2119,1926.3,19263,19673,7.2,10,10,14,236,23.6,2,1,1,0,0,231,23.1,0,0,1,1,6.8,17554,14524,1452.4,-2119,-4739,1
8330,-1518,-2542,1464.5,14645,16717,6.8,2,2,2,224,22.4,0,0,1,0,0,207,20.7,0,4,7,7,7.2,19259,16163,1616.3,2542,1518,1
8331,1458,1753,1762.8,17628,18881,7.0,8,8,7,233,23.3,0,0,1,0,1,196,19.6,1,5,6,6,7.0,17128,16170,1617.0,-1753,-1458,1
8332,98,-786,1600.2,16002,16283,6.6,4,4,8,204,20.4,0,0,1,0,1,193,19.3,1,8,7,7,6.6,17069,15904,1590.4,786,-98,1
8333,-3248,-2442,1585.1,15851,16800,6.6,5,5,6,182,18.2,0,0,0,1,1,243,24.3,1,9,12,12,7.2,19242,19099,1909.9,2442,3248,0
8334,3439,3469,1848.4,18484,19140,7.0,10,10,9,230,23.0,1,1,1,0,0,218,21.8,0,1,1,1,6.4,15671,15045,1504.5,-3469,-3439,1
8335,-376,-1118,1584.0,15840,16689,6.8,6,6,8,204,20.4,0,0,0,1,0,228,22.8,0,4,4,4,6.8,17807,16216,1621.6,1118,376,0
8336,4141,2833,1882.9,18829,18693,7.2,9,9,8,233,23.3,1,0,1,0,0,198,19.8,0,3,4,4,6.6,15860,14688,1468.8,-2833,-4141,1
8337,-2358,-1400,1672.8,16728,17887,7.0,7,7,8,191,19.1,1,1,0,1,0,211,21.1,1,11,11,11,7.2,19287,19086,1908.6,1400,2358,0
8338,-3762,-1626,1574.4,15744,16509,6.8,7,7,5,201,20.1,0,0,0,1,1,213,21.3,2,16,13,13,6.8,18135,19506,1950.6,1626,3762,0
8339,159,-369,1664.0,16640,18123,7.0,4,4,5,223,22.3,1,1,1,0,0,214,21.4,1,4,7,7,7.2,18492,16481,1648.1,369,-159,0
8340,-2438,-1929,1374.4,13744,16719,6.8,2,2,0,207,20.7,0,0,0,1,0,241,24.1,0,5,6,6,6.8,18648,16182,1618.2,1929,2438,0
8341,2071,1096,1788.5,17885,17553,6.8,8,8,15,216,21.6,0,0,1,0,1,188,18.8,1,10,7,7,6.6,16457,15814,1581.4,-1096,-2071,1
8342,5148,2922,1864.6,18646,19491,7.0,10,10,8,237,23.7,1,1,1,0,0,210,21.0,0,0,1,1,6.4,16569,13498,1349.8,-2922,-5148,1
8343,-2405,-1720,1421.9,14219,16055,6.6,2,2,3,213,21.3,0,0,1,0,0,235,23.5,0,7,5,5,6.8,17775,16624,1662.4,1720,2405,0
8344,441,379,1561.6,15616,18728,6.8,4,4,4,224,22.4,0,0,0,1,0,230,23.0,0,2,3,3,6.8,18349,15175,1517.5,-379,-441,1
8345,759,-221,1917.7,19177,17889,7.0,10,10,14,197,19.7,1,1,1,0,0,178,17.8,1,11,10,10,7.0,18110,18418,1841.8,221,-759,1
8346,898,732,1597.7,15977,18445,7.0,5,5,4,205,20.5,0,0,0,1,0,215,21.5,0,2,4,4,7.0,17713,15079,1507.9,-732,-898,0
8347,2397,958,1830.2,18302,18292,7.2,9,9,10,228,22.8,2,1,1,0,0,202,20.2,0,8,6,6,7.0,17334,15905,1590.5,-958,-2397,1
8348,1149,1056,1563.4,15634,16928,6.8,5,5,9,223,22.3,1,1,0,1,0,208,20.8,0,5,3,3,6.4,15872,14485,1448.5,-1056,-1149,1
8349,857,1040,1616.5,16165,18868,7.2,5,5,5,229,22.9,0,0,0,1,1,197,19.7,1,3,5,5,7.0,17828,15308,1530.8,-1040,-857,1
8350,-3237,-2680,1590.0,15900,16277,6.6,6,6,5,208,20.8,0,0,1,0,0,219,21.9,1,6,9,9,7.0,18957,19137,1913.7,2680,3237,0
8351,1072,411,1777.6,17776,18126,6.8,8,8,10,224,22.4,1,1,1,0,0,238,23.8,0,8,6,6,6.6,17715,16704,1670.4,-411,-1072,1
8352,-1522,-1504,1759.7,17597,16212,6.6,9,9,12,188,18.8,1,1,1,0,0,185,18.5,0,15,13,13,6.8,17716,19119,1911.9,1504,1522,1
8353,-2633,-1640,1407.1,14071,16114,6.8,2,2,2,231,23.1,0,0,0,1,1,238,23.8,1,6,6,6,6.8,17754,16704,1670.4,1640,2633,1
8354,-213,399,1738.0,17380,18665,7.2,8,8,8,220,22.0,1,0,0,1,0,215,21.5,0,14,9,9,7.0,18266,17593,1759.3,-399,213,0
8355,-3315,-2013,1466.6,14666,17730,6.8,3,3,2,215,21.5,0,0,1,0,1,257,25.7,2,2,5,5,7.2,19743,17981,1798.1,2013,3315,0
8356,3987,3310,1823.2,18232,19347,7.4,11,11,4,231,23.1,1,1,1,0,0,168,16.8,0,3,4,4,6.4,16037,14245,1424.5,-3310,-3987,0
8357,-417,81,1700.4,17004,19083,7.2,7,7,8,193,19.3,0,0,1,0,1,206,20.6,1,7,8,8,7.2,19002,17421,1742.1,-81,417,1
8358,-4732,-1805,1566.4,15664,16740,6.6,7,7,5,174,17.4,0,0,0,1,1,228,22.8,1,20,17,17,7.0,18545,20396,2039.6,1805,4732,1
8359,1517,-69,1843.2,18432,17701,7.0,10,10,17,203,20.3,1,0,1,0,1,193,19.3,1,16,8,8,6.8,17770,16915,1691.5,69,-1517,0
8360,-2609,-2248,1549.5,15495,17144,7.0,3,3,3,231,23.1,0,0,0,1,1,237,23.7,1,7,11,11,7.0,19392,18104,1810.4,2248,2609,0
8361,-67,-481,1631.8,16318,18452,7.2,5,5,4,234,23.4,1,1,1,0,0,200,20.0,0,4,7,7,7.2,18933,16385,1638.5,481,67,1
8362,593,-702,1612.3,16123,17197,6.6,5,5,9,204,20.4,1,1,1,0,0,238,23.8,0,2,3,3,7.0,17899,15530,1553.0,702,-593,1
8363,-3388,-1882,1407.9,14079,17003,7.0,2,2,2,207,20.7,0,0,0,1,1,239,23.9,1,6,8,8,7.2,18885,17467,1746.7,1882,3388,1
8364,4233,3106,1808.1,18081,19648,7.2,9,9,13,214,21.4,1,1,1,0,0,193,19.3,0,2,2,2,6.6,16542,13848,1384.8,-3106,-4233,1
8365,-167,-395,1644.9,16449,16962,6.6,6,6,7,232,23.2,0,0,0,1,0,196,19.6,0,9,8,8,7.0,17357,16616,1661.6,395,167,1
8366,-2088,-2417,1494.7,14947,17628,7.0,2,2,1,241,24.1,0,0,1,0,1,280,28.0,1,4,4,4,7.2,20045,17035,1703.5,2417,2088,0
8367,-1647,-3035,1545.7,15457,17048,6.6,5,5,8,191,19.1,1,0,0,1,1,251,25.1,1,7,7,7,7.4,20083,17104,1710.4,3035,1647,0
8368,1004,211,1712.9,17129,18794,7.2,5,5,6,256,25.6,1,1,0,1,0,234,23.4,0,4,4,4,6.8,18583,16125,1612.5,-211,-1004,0
8369,1625,1945,1752.7,17527,19414,7.2,8,8,7,236,23.6,2,1,0,1,0,208,20.8,0,2,6,6,6.8,17469,15902,1590.2,-1945,-1625,1
8370,-4339,-2857,1439.6,14396,16065,6.6,4,4,3,203,20.3,0,0,0,1,0,234,23.4,0,4,10,10,7.0,18922,18735,1873.5,2857,4339,0
8371,-1142,229,1613.1,16131,17821,7.0,5,5,6,206,20.6,1,1,1,0,0,221,22.1,1,6,8,8,6.8,17592,17273,1727.3,-229,1142,1
8372,4774,3524,1947.6,19476,20412,7.8,10,10,10,262,26.2,0,0,0,1,1,211,21.1,1,3,3,3,6.8,16888,14702,1470.2,-3524,-4774,1
8373,-5219,-4005,1431.6,14316,14965,6.2,3,3,5,195,19.5,0,0,1,0,1,183,18.3,1,23,16,16,7.2,18970,19535,1953.5,4005,5219,0
8374,-1984,-1530,1515.9,15159,17052,6.6,3,3,3,235,23.5,0,0,1,0,1,238,23.8,1,16,7,7,6.8,18582,17143,1714.3,1530,1984,1
8375,697,700,1580.0,15800,18222,7.0,5,5,2,236,23.6,0,0,1,0,0,209,20.9,1,6,3,3,6.8,17522,15103,1510.3,-700,-697,1
8376,774,1187,1678.0,16780,19102,7.0,5,5,6,253,25.3,0,0,1,0,1,233,23.3,1,7,5,5,7.0,17915,16006,1600.6,-1187,-774,0
8377,427,479,1642.4,16424,17990,7.0,7,7,7,205,20.5,1,1,0,1,0,237,23.7,0,4,5,5,7.0,17511,15997,1599.7,-479,-427,0
8378,1487,617,1703.5,17035,18941,7.2,3,3,2,257,25.7,1,0,1,0,1,223,22.3,1,6,4,4,7.0,18324,15548,1554.8,-617,-1487,1
8379,-1960,-1464,1477.6,14776,17631,6.8,3,3,4,203,20.3,0,0,0,1,1,252,25.2,1,5,5,5,7.2,19095,16736,1673.6,1464,1960,0
8380,4695,2313,1869.7,18697,19162,7.2,10,10,15,237,23.7,0,0,1,0,0,235,23.5,0,1,1,1,6.4,16849,14002,1400.2,-2313,-4695,1
8381,47,-264,1445.2,14452,16280,6.8,3,3,7,202,20.2,0,0,1,0,1,226,22.6,1,2,2,2,6.6,16544,14405,1440.5,264,-47,0
8382,-2145,-917,1654.0,16540,18158,7.0,6,6,6,235,23.5,1,1,1,0,0,193,19.3,1,15,13,13,7.2,19075,18685,1868.5,917,2145,0
8383,907,-411,1665.0,16650,17551,6.8,8,8,5,233,23.3,2,1,1,0,0,195,19.5,0,3,6,6,6.6,17962,15743,1574.3,411,-907,0
8384,1564,1214,1688.7,16887,18500,7.0,7,7,6,212,21.2,1,0,1,0,1,200,20.0,1,5,5,5,6.6,17286,15323,1532.3,-1214,-1564,1
8385,686,350,1809.6,18096,18860,7.2,11,11,12,222,22.2,1,1,0,1,0,193,19.3,1,7,7,7,7.0,18510,17410,1741.0,-350,-686,0
8386,531,947,1619.9,16199,18445,7.0,6,6,7,213,21.3,2,1,0,1,0,234,23.4,0,4,4,4,6.8,17498,15668,1566.8,-947,-531,1
8387,-506,-228,1695.6,16956,18364,7.0,6,6,8,197,19.7,1,1,1,0,0,234,23.4,0,9,8,8,7.0,18592,17462,1746.2,228,506,1
8388,-1528,-1421,1564.6,15646,17325,7.0,7,7,5,192,19.2,0,0,0,1,1,225,22.5,1,8,8,8,7.2,18746,17174,1717.4,1421,1528,1
8389,-2376,-894,1542.6,15426,18021,7.0,4,4,5,207,20.7,1,0,0,1,1,227,22.7,1,9,6,6,7.0,18915,17802,1780.2,894,2376,1
8390,-313,-1056,1630.8,16308,17279,7.0,6,6,8,217,21.7,0,0,1,0,1,207,20.7,1,10,7,7,7.0,18335,16621,1662.1,1056,313,0
8391,-1306,-998,1529.3,15293,17871,6.8,4,4,2,204,20.4,0,0,1,0,1,221,22.1,2,9,6,6,7.0,18869,16599,1659.9,998,1306,0
8392,997,-1143,1638.9,16389,17526,6.6,4,4,4,210,21.0,1,0,1,0,1,204,20.4,1,4,4,4,7.2,18669,15392,1539.2,1143,-997,0
8393,1923,734,1857.2,18572,19279,7.2,10,10,9,208,20.8,2,1,1,0,0,205,20.5,0,4,7,7,7.0,18545,16649,1664.9,-734,-1923,1
8394,2518,860,1825.0,18250,17742,7.0,8,8,8,235,23.5,2,1,1,0,0,216,21.6,0,6,6,6,6.6,16882,15732,1573.2,-860,-2518,1
8395,-4949,-3427,1512.3,15123,15874,6.6,4,4,7,169,16.9,0,0,1,0,1,221,22.1,2,14,12,12,7.2,19301,20072,2007.2,3427,4949,1
8396,115,-80,1679.3,16793,17595,6.8,8,8,7,210,21.0,0,0,0,1,1,238,23.8,1,6,6,6,6.8,17675,16678,1667.8,80,-115,0
8397,-4814,-3701,1425.9,14259,16277,6.4,2,2,1,216,21.6,0,0,0,1,1,240,24.0,2,14,9,9,7.4,19978,19073,1907.3,3701,4814,1
8398,2261,1906,1660.7,16607,19014,7.0,4,4,4,261,26.1,1,1,1,0,0,221,22.1,0,0,2,2,6.6,17108,14346,1434.6,-1906,-2261,1
8399,-2904,-3121,1542.5,15425,16296,6.6,5,5,3,204,20.4,0,0,1,0,0,212,21.2,0,10,14,14,7.2,19417,18329,1832.9,3121,2904,0
8400,6597,4613,2046.4,20464,19989,7.4,9,9,9,251,25.1,2,1,1,0,0,215,21.5,0,2,2,2,6.2,15376,13867,1386.7,-4613,-6597,1
8401,-4269,-3208,1434.4,14344,16049,6.6,3,3,2,193,19.3,1,1,0,1,0,232,23.2,0,5,7,7,7.2,19257,18613,1861.3,3208,4269,0
8402,218,-1933,1593.6,15936,16572,6.8,4,4,3,229,22.9,0,0,1,0,1,243,24.3,1,5,4,4,7.0,18505,15718,1571.8,1933,-218,1
8403,3263,1440,1818.8,18188,18675,7.0,8,8,9,208,20.8,1,0,1,0,1,200,20.0,1,2,2,2,6.8,17235,14925,1492.5,-1440,-3263,1
8404,-3597,-862,1468.6,14686,17861,6.8,3,3,0,238,23.8,0,0,0,1,1,243,24.3,1,8,6,6,7.0,18723,18283,1828.3,862,3597,0
8405,-1725,-1169,1421.1,14211,17395,7.0,0,0,0,227,22.7,0,0,0,1,1,230,23.0,1,7,4,4,7.0,18564,15936,1593.6,1169,1725,0
8406,500,64,1599.5,15995,19023,7.2,4,4,3,220,22.0,0,0,1,0,1,234,23.4,2,1,2,2,7.0,18959,15495,1549.5,-64,-500,0
8407,-5533,-2481,1479.8,14798,17372,6.8,3,3,0,225,22.5,0,0,0,1,0,233,23.3,0,13,12,12,7.6,19853,20331,2033.1,2481,5533,0
8408,2028,1165,1582.3,15823,17964,7.0,5,5,4,197,19.7,1,1,1,0,0,205,20.5,0,1,1,1,6.8,16799,13795,1379.5,-1165,-2028,1
8409,-3131,-1768,1487.4,14874,16729,6.8,2,2,3,232,23.2,0,0,1,0,1,221,22.1,2,5,6,6,7.2,18497,18005,1800.5,1768,3131,0
8410,3304,-85,1951.7,19517,18337,7.0,11,11,10,216,21.6,1,1,1,0,0,208,20.8,0,7,6,6,7.0,18422,16213,1621.3,85,-3304,1
8411,-1421,-1364,1669.1,16691,16656,6.8,8,8,6,191,19.1,0,0,1,0,0,237,23.7,0,7,6,6,7.0,18020,18112,1811.2,1364,1421,1
8412,-1980,-3337,1532.8,15328,16143,6.4,5,5,8,191,19.1,0,0,0,1,1,227,22.7,1,9,7,7,7.0,19480,17308,1730.8,3337,1980,0
8413,1648,1881,1705.2,17052,19250,7.2,7,7,5,234,23.4,1,1,0,1,0,223,22.3,0,4,4,4,6.6,17369,15404,1540.4,-1881,-1648,1
8414,239,285,1674.9,16749,17028,6.6,9,9,6,177,17.7,0,0,1,0,0,219,21.9,0,5,6,6,6.6,16743,16510,1651.0,-285,-239,1
8415,1643,2462,1802.2,18022,17168,6.8,13,13,13,182,18.2,1,0,1,0,1,153,15.3,1,6,7,7,6.2,14706,16379,1637.9,-2462,-1643,1
8416,994,-85,1567.5,15675,17474,6.8,5,5,9,198,19.8,0,0,1,0,1,243,24.3,1,1,1,1,7.0,17559,14681,1468.1,85,-994,1
8417,-1025,-1860,1913.1,19131,18354,7.0,12,12,13,209,20.9,1,1,1,0,0,220,22.0,1,9,12,12,7.6,20214,20156,2015.6,1860,1025,1
8418,-2820,-2226,1429.4,14294,17461,6.6,2,2,2,220,22.0,1,1,0,1,0,236,23.6,1,5,6,6,7.4,19687,17114,1711.4,2226,2820,0
8419,-5617,-4035,1423.2,14232,16592,6.6,3,3,3,216,21.6,0,0,0,1,1,238,23.8,1,17,12,12,7.6,20627,19849,1984.9,4035,5617,0
8420,-2733,-2104,1571.5,15715,17533,6.8,4,4,4,229,22.9,0,0,0,1,1,237,23.7,2,9,8,8,7.4,19637,18448,1844.8,2104,2733,0
8421,5,185,1600.3,16003,18252,7.0,5,5,2,221,22.1,0,0,1,0,1,189,18.9,1,7,8,8,6.8,18067,15998,1599.8,-185,-5,0
8422,-1333,284,1590.1,15901,18288,6.8,4,4,2,233,23.3,0,0,0,1,1,214,21.4,1,13,8,8,7.0,18004,17234,1723.4,-284,1333,0
8423,1718,1073,1669.9,16699,18113,7.0,8,8,9,238,23.8,1,1,0,1,0,225,22.5,0,3,2,2,6.8,17040,14981,1498.1,-1073,-1718,1
8424,-2132,-2887,1626.9,16269,17222,7.0,6,6,9,222,22.2,1,1,1,0,0,255,25.5,1,5,7,7,7.4,20109,18401,1840.1,2887,2132,0
8425,6439,4362,2129.7,21297,19371,7.2,16,16,17,221,22.1,1,1,1,0,0,165,16.5,1,7,5,5,6.2,15009,14858,1485.8,-4362,-6439,1
8426,-2564,-2469,1461.8,14618,16828,6.6,3,3,3,199,19.9,2,1,0,1,0,244,24.4,0,6,7,7,7.0,19297,17182,1718.2,2469,2564,0
8427,-3481,-1919,1557.1,15571,17116,6.8,4,4,3,228,22.8,1,1,0,1,0,258,25.8,1,13,10,10,7.4,19035,19052,1905.2,1919,3481,0
8428,2350,1981,1908.7,19087,19779,7.2,9,9,8,250,25.0,0,0,1,0,1,216,21.6,1,7,7,7,7.0,17798,16737,1673.7,-1981,-2350,0
8429,-3804,-2878,1473.1,14731,16187,6.6,3,3,3,193,19.3,0,0,1,0,1,217,21.7,1,17,11,11,7.4,19065,18535,1853.5,2878,3804,0
8430,2804,2924,1737.5,17375,18886,7.0,8,8,11,241,24.1,1,1,1,0,0,226,22.6,0,3,2,2,6.6,15962,14571,1457.1,-2924,-2804,1
8431,951,-101,1711.6,17116,18779,7.2,7,7,3,245,24.5,0,0,1,0,0,252,25.2,1,3,4,4,7.2,18880,16165,1616.5,101,-951,1
8432,2831,1855,1943.5,19435,19608,7.4,7,7,8,248,24.8,2,1,0,1,0,197,19.7,0,6,7,7,6.8,17753,16604,1660.4,-1855,-2831,1
8433,-4264,-4127,1646.7,16467,16438,6.6,7,7,5,190,19.0,0,0,1,0,1,245,24.5,1,19,14,14,7.4,20565,20731,2073.1,4127,4264,1
8434,2006,617,1740.9,17409,18491,6.8,8,8,10,259,25.9,0,0,1,0,1,183,18.3,1,4,7,7,7.0,17874,15403,1540.3,-617,-2006,1
8435,1708,419,1749.2,17492,19477,7.4,5,5,8,244,24.4,2,1,1,0,0,237,23.7,0,3,3,3,7.2,19058,15784,1578.4,-419,-1708,0
8436,-2018,-2401,1653.6,16536,16917,6.8,6,6,8,232,23.2,0,0,0,1,1,232,23.2,1,12,11,11,7.0,19318,18554,1855.4,2401,2018,0
8437,383,-759,1529.8,15298,17946,7.0,3,3,3,232,23.2,1,1,1,0,0,233,23.3,0,0,2,2,7.2,18705,14915,1491.5,759,-383,1
8438,-4199,-3576,1521.7,15217,16160,6.4,5,5,1,193,19.3,0,0,1,0,1,270,27.0,1,10,12,12,7.2,19736,19416,1941.6,3576,4199,0
8439,-1240,-793,1593.0,15930,19263,7.0,3,3,4,241,24.1,0,0,0,1,1,252,25.2,1,6,6,6,7.2,20056,17170,1717.0,793,1240,1
8440,90,-1069,1652.1,16521,17859,6.8,6,6,7,214,21.4,1,1,1,0,0,243,24.3,1,3,6,6,7.2,18928,16431,1643.1,1069,-90,1
8441,737,50,1830.6,18306,17828,6.8,9,9,14,207,20.7,0,0,1,0,1,183,18.3,1,12,11,11,7.0,17778,17569,1756.9,-50,-737,1
8442,993,1759,1724.8,17248,19160,7.0,6,6,4,242,24.2,1,0,0,1,1,192,19.2,1,7,7,7,6.8,17401,16255,1625.5,-1759,-993,1
8443,2281,292,1732.7,17327,18249,7.0,7,7,6,215,21.5,0,0,1,0,0,205,20.5,0,2,5,5,7.0,17957,15046,1504.6,-292,-2281,1
8444,-778,-1358,1756.1,17561,17359,6.8,9,9,16,208,20.8,0,0,1,0,0,231,23.1,1,10,9,9,7.2,18717,18339,1833.9,1358,778,1
8445,-4178,-3371,1396.4,13964,16677,6.6,3,3,2,196,19.6,0,0,0,1,1,231,23.1,1,7,7,7,7.4,20048,18142,1814.2,3371,4178,0
8446,-6092,-4820,1333.7,13337,14126,6.0,4,4,2,141,14.1,0,0,0,1,1,216,21.6,1,9,13,13,7.2,18946,19429,1942.9,4820,6092,0
8447,-22,-801,1725.2,17252,18419,7.0,8,8,16,197,19.7,1,1,1,0,0,228,22.8,1,10,6,6,7.2,19220,17274,1727.4,801,22,0
8448,-1421,-1547,1773.5,17735,18655,7.4,8,8,9,203,20.3,0,0,0,1,0,246,24.6,0,11,11,11,7.4,20202,19156,1915.6,1547,1421,1
8449,4091,2830,1962.1,19621,20681,7.6,10,10,12,261,26.1,0,0,0,1,1,202,20.2,1,6,4,4,6.8,17851,15530,1553.0,-2830,-4091,1
8450,3923,3613,1722.6,17226,18501,7.2,8,8,13,224,22.4,1,1,1,0,0,183,18.3,0,3,2,2,6.0,14888,13303,1330.3,-3613,-3923,1
8451,2896,2001,1955.1,19551,18331,7.2,14,14,22,198,19.8,0,0,1,0,0,228,22.8,0,6,5,5,6.6,16330,16655,1665.5,-2001,-2896,1
8452,-2534,-1019,1610.7,16107,17630,6.8,5,5,4,229,22.9,1,1,0,1,0,204,20.4,1,14,10,10,7.2,18649,18641,1864.1,1019,2534,0
8453,774,-188,1741.8,17418,14242,6.2,10,10,10,175,17.5,1,1,1,0,0,143,14.3,0,12,10,10,6.0,14430,16644,1664.4,188,-774,0
8454,838,914,1811.6,18116,18447,6.8,13,13,12,187,18.7,0,0,1,0,1,204,20.4,2,9,8,8,7.2,17533,17278,1727.8,-914,-838,0
8455,-683,-2098,1605.8,16058,16690,6.6,7,7,7,158,15.8,2,1,0,1,0,214,21.4,0,3,5,5,7.4,18788,16741,1674.1,2098,683,0
8456,-1540,-313,1541.8,15418,17598,7.0,3,3,4,232,23.2,1,1,0,1,0,214,21.4,0,10,7,7,6.8,17911,16958,1695.8,313,1540,0
8457,623,640,1598.8,15988,18515,7.0,4,4,3,251,25.1,1,1,0,1,0,234,23.4,1,2,3,3,7.0,17875,15365,1536.5,-640,-623,1
8458,-2447,-1476,1401.2,14012,15628,6.4,1,1,2,211,21.1,0,0,0,1,0,198,19.8,0,10,8,8,6.6,17104,16459,1645.9,1476,2447,0
8459,-6324,-3885,1542.3,15423,16791,6.8,5,5,9,175,17.5,1,1,0,1,0,233,23.3,1,14,14,14,7.6,20676,21747,2174.7,3885,6324,1
8460,-964,-202,1625.0,16250,17847,6.8,5,5,7,233,23.3,1,0,0,1,1,221,22.1,1,7,8,8,6.8,18049,17214,1721.4,202,964,1
8461,3825,2747,2166.3,21663,19484,7.4,16,16,27,226,22.6,0,0,0,1,0,216,21.6,0,15,8,8,6.4,16737,17838,1783.8,-2747,-3825,1
8462,-379,-662,1777.0,17770,18781,7.2,8,8,8,223,22.3,1,1,1,0,0,228,22.8,1,9,9,9,7.0,19443,18149,1814.9,662,379,0
8463,-977,271,1711.9,17119,18614,6.8,7,7,5,216,21.6,1,0,0,1,1,215,21.5,1,12,10,10,7.0,18343,18096,1809.6,-271,977,0
8464,1004,559,1704.2,17042,18045,7.0,7,7,12,223,22.3,1,1,1,0,0,182,18.2,0,9,5,5,6.8,17486,16038,1603.8,-559,-1004,1
8465,2760,3641,1962.7,19627,20041,7.4,11,11,9,237,23.7,0,0,0,1,1,167,16.7,1,11,8,8,6.6,16400,16867,1686.7,-3641,-2760,0
8466,1168,2292,1634.4,16344,19071,7.2,5,5,3,227,22.7,2,1,0,1,0,206,20.6,0,3,5,5,6.8,16779,15176,1517.6,-2292,-1168,1
8467,3046,442,1737.8,17378,18286,7.2,4,4,2,262,26.2,1,1,1,0,0,211,21.1,0,2,1,1,6.8,17844,14332,1433.2,-442,-3046,1
8468,1752,830,1753.7,17537,18384,7.0,7,7,9,232,23.2,0,0,1,0,1,201,20.1,1,4,6,6,6.8,17554,15785,1578.5,-830,-1752,1
8469,-713,-653,1519.5,15195,17434,7.0,3,3,2,226,22.6,0,0,0,1,1,232,23.2,1,6,5,5,7.0,18087,15908,1590.8,653,713,0
8470,-1913,-1233,1498.7,14987,15728,6.6,5,5,4,199,19.9,0,0,1,0,1,202,20.2,1,16,9,9,6.6,16961,16900,1690.0,1233,1913,0
8471,-2403,-2787,1547.6,15476,17206,6.8,6,6,5,187,18.7,0,0,0,1,1,243,24.3,1,9,8,8,7.4,19993,17879,1787.9,2787,2403,0
8472,821,2119,1571.4,15714,19458,7.0,2,2,3,243,24.3,1,0,0,1,1,226,22.6,1,3,2,2,6.8,17339,14893,1489.3,-2119,-821,0
8473,1805,941,1802.6,18026,18892,7.2,9,9,7,229,22.9,1,0,1,0,1,210,21.0,1,8,7,7,7.0,17951,16221,1622.1,-941,-1805,1
8474,-1249,-1518,1718.0,17180,17696,6.8,8,8,8,216,21.6,0,0,1,0,1,183,18.3,1,10,10,10,7.4,19214,18429,1842.9,1518,1249,0
8475,-44,73,1555.0,15550,18512,7.0,4,4,7,221,22.1,1,1,1,0,0,216,21.6,0,5,4,4,7.0,18439,15594,1559.4,-73,44,1
8476,1151,1870,1571.0,15710,18022,6.8,1,1,1,247,24.7,1,0,0,1,0,170,17.0,0,3,4,4,6.0,16152,14559,1455.9,-1870,-1151,1
8477,-2168,-2144,1490.2,14902,17309,6.8,4,4,6,198,19.8,0,0,1,0,1,204,20.4,1,9,9,9,7.2,19453,17070,1707.0,2144,2168,0
8478,348,-662,1609.9,16099,18334,7.0,3,3,4,227,22.7,1,1,1,0,0,247,24.7,0,1,2,2,7.2,18996,15751,1575.1,662,-348,1
8479,644,427,1566.7,15667,17801,7.0,3,3,8,212,21.2,0,0,1,0,1,194,19.4,1,5,3,3,7.0,17374,15023,1502.3,-427,-644,1
8480,-3449,-1995,1523.9,15239,18073,7.0,2,2,1,232,23.2,0,0,0,1,1,231,23.1,1,13,10,10,7.6,20068,18688,1868.8,1995,3449,0
8481,2900,2308,1904.9,19049,20348,7.6,12,12,13,225,22.5,0,0,1,0,1,172,17.2,1,5,7,7,6.8,18040,16149,1614.9,-2308,-2900,1
8482,-2696,70,1787.2,17872,18662,7.0,10,10,17,206,20.6,1,1,0,1,0,245,24.5,1,17,12,12,7.2,18592,20568,2056.8,-70,2696,1
8483,7847,5766,2094.3,20943,19895,7.4,16,16,15,241,24.1,2,1,1,0,0,142,14.2,0,2,2,2,6.0,14129,13096,1309.6,-5766,-7847,1
8484,-3400,-3115,1316.7,13167,15884,6.0,1,1,0,213,21.3,0,0,0,1,1,229,22.9,2,7,6,6,7.0,18999,16567,1656.7,3115,3400,0
8485,-1387,-1802,1465.3,14653,16215,6.6,2,2,1,218,21.8,1,1,0,1,0,188,18.8,1,8,5,5,6.8,18017,16040,1604.0,1802,1387,0
8486,253,-529,1678.0,16780,18032,6.8,6,6,3,244,24.4,0,0,0,1,1,222,22.2,2,6,6,6,7.2,18561,16527,1652.7,529,-253,1
8487,-839,-623,1545.3,15453,17463,6.8,4,4,5,191,19.1,1,1,0,1,0,201,20.1,0,6,5,5,6.8,18086,16292,1629.2,623,839,0
8488,2945,2977,1876.8,18768,19351,7.0,9,9,10,200,20.0,2,1,1,0,0,215,21.5,0,8,6,6,6.6,16374,15823,1582.3,-2977,-2945,1
8489,-1346,-2280,1524.6,15246,16921,6.6,4,4,6,224,22.4,0,0,1,0,1,221,22.1,1,10,6,6,7.0,19201,16592,1659.2,2280,1346,0
8490,1951,1640,1665.8,16658,18573,7.0,6,6,3,251,25.1,1,1,0,1,0,203,20.3,0,3,3,3,6.6,16933,14707,1470.7,-1640,-1951,0
8491,-2164,-2554,1539.9,15399,16243,6.4,5,5,7,196,19.6,1,1,1,0,0,214,21.4,0,8,7,7,7.0,18797,17563,1756.3,2554,2164,0
8492,-817,-968,1568.5,15685,16091,6.6,7,7,9,179,17.9,0,0,0,1,0,209,20.9,0,9,6,6,6.6,17059,16502,1650.2,968,817,1
8493,3643,3695,1730.3,17303,18810,7.0,6,6,6,234,23.4,1,1,1,0,0,179,17.9,0,3,2,2,6.2,15115,13660,1366.0,-3695,-3643,1
8494,3066,2297,1755.5,17555,19037,7.2,10,10,8,242,24.2,1,0,1,0,0,203,20.3,0,5,3,3,6.8,16740,14489,1448.9,-2297,-3066,1
8495,2241,1219,1964.5,19645,18468,7.0,11,11,14,246,24.6,0,0,1,0,1,203,20.3,1,9,9,9,6.6,17249,17404,1740.4,-1219,-2241,1
8496,-1933,-1659,1506.8,15068,16740,6.6,5,5,5,208,20.8,0,0,0,1,1,212,21.2,1,10,5,5,7.2,18399,17001,1700.1,1659,1933,0
8497,1886,2653,1602.5,16025,19176,7.4,5,5,7,208,20.8,0,0,0,1,1,219,21.9,1,1,1,1,6.6,16523,14139,1413.9,-2653,-1886,1
8498,-287,255,1784.9,17849,18632,7.2,10,10,5,184,18.4,0,0,0,1,0,210,21.0,0,9,12,12,6.8,18377,18136,1813.6,-255,287,1
8499,-145,-28,1775.6,17756,18320,7.0,10,10,12,201,20.1,1,1,1,0,0,219,21.9,0,5,8,8,7.0,18348,17901,1790.1,28,145,1
8500,5241,3129,1915.1,19151,19146,7.4,10,10,11,220,22.0,0,0,1,0,1,196,19.6,2,3,2,2,6.4,16017,13910,1391.0,-3129,-5241,1
8501,2975,2627,1729.8,17298,18556,7.2,8,8,7,225,22.5,2,1,1,0,0,211,21.1,0,3,2,2,6.4,15929,14323,1432.3,-2627,-2975,0
8502,1419,1036,1774.0,17740,18658,7.0,7,7,9,252,25.2,0,0,1,0,1,215,21.5,2,7,6,6,6.8,17622,16321,1632.1,-1036,-1419,0
8503,-2286,-926,1482.6,14826,17334,6.8,4,4,3,206,20.6,1,1,0,1,0,232,23.2,0,6,6,6,6.8,18260,17112,1711.2,926,2286,0
8504,1551,1481,1669.5,16695,19112,7.2,5,5,6,257,25.7,1,1,1,0,0,224,22.4,0,3,3,3,6.8,17631,15144,1514.4,-1481,-1551,0
8505,-2738,-1759,1525.9,15259,17346,6.6,3,3,5,206,20.6,0,0,1,0,1,251,25.1,1,10,8,8,7.2,19105,17997,1799.7,1759,2738,0
8506,-1318,-627,1629.4,16294,17489,6.8,7,7,5,182,18.2,1,0,0,1,0,237,23.7,0,7,8,8,6.8,18116,17612,1761.2,627,1318,1
8507,3538,2904,1948.4,19484,20010,7.2,9,9,8,267,26.7,1,0,0,1,1,230,23.0,1,4,4,4,6.6,17106,15946,1594.6,-2904,-3538,1
8508,-3217,-1601,1498.3,14983,17248,7.0,3,3,3,203,20.3,0,0,0,1,1,223,22.3,2,12,10,10,7.0,18849,18200,1820.0,1601,3217,0
8509,4836,2713,2043.3,20433,19171,7.4,14,14,11,219,21.9,1,1,1,0,0,165,16.5,0,7,7,7,6.4,16458,15597,1559.7,-2713,-4836,1
8510,1489,-192,1825.6,18256,18201,7.0,10,10,11,186,18.6,2,1,1,0,0,247,24.7,0,7,7,7,7.0,18393,16767,1676.7,192,-1489,1
8511,3311,3166,1840.2,18402,20050,7.4,10,10,7,258,25.8,0,0,1,0,1,197,19.7,1,5,4,4,6.6,16884,15091,1509.1,-3166,-3311,1
8512,2008,2714,1753.7,17537,19766,7.2,8,8,10,236,23.6,2,1,1,0,0,210,21.0,0,5,6,6,6.8,17052,15529,1552.9,-2714,-2008,1
8513,-1112,-41,1635.9,16359,17785,6.8,4,4,3,229,22.9,1,0,0,1,1,208,20.8,1,7,7,7,6.8,17826,17471,1747.1,41,1112,1
8514,3840,3165,1926.3,19263,19347,7.4,10,10,13,197,19.7,2,1,1,0,0,204,20.4,0,8,6,6,6.4,16182,15423,1542.3,-3165,-3840,1
8515,-5458,-3613,1514.0,15140,16118,6.8,3,3,2,217,21.7,0,0,0,1,0,215,21.5,1,13,12,12,7.4,19731,20598,2059.8,3613,5458,0
8516,506,-142,1557.4,15574,16955,6.8,5,5,9,206,20.6,1,0,1,0,1,229,22.9,1,2,2,2,6.6,17097,15068,1506.8,142,-506,1
8517,176,789,1729.9,17299,18742,7.0,9,9,6,200,20.0,0,0,1,0,0,221,22.1,0,8,9,9,7.0,17953,17123,1712.3,-789,-176,0
8518,2582,2732,1840.2,18402,19507,7.4,9,9,13,223,22.3,0,0,0,1,1,202,20.2,2,5,5,5,6.8,16775,15820,1582.0,-2732,-2582,1
8519,459,1326,1689.6,16896,18779,7.2,6,6,6,258,25.8,0,0,0,1,1,244,24.4,1,5,5,5,7.0,17453,16437,1643.7,-1326,-459,1
8520,4947,3211,1914.5,19145,19160,7.2,13,13,17,218,21.8,0,0,1,0,1,203,20.3,1,2,4,4,6.2,15949,14198,1419.8,-3211,-4947,0
8521,4759,3279,1843.3,18433,19855,7.2,8,8,8,237,23.7,1,1,1,0,0,183,18.3,1,3,2,2,6.6,16576,13674,1367.4,-3279,-4759,1
8522,-968,-1029,1570.7,15707,16724,6.8,7,7,7,206,20.6,0,0,0,1,1,218,21.8,2,7,8,8,6.8,17753,16675,1667.5,1029,968,0
8523,4294,2560,2088.0,20880,21004,7.4,15,15,16,231,23.1,1,0,0,1,1,216,21.6,1,7,7,7,7.0,18444,16586,1658.6,-2560,-4294,1
8524,-95,194,1780.0,17800,19759,7.2,8,8,8,223,22.3,1,1,1,0,0,232,23.2,0,9,9,9,7.0,19565,17895,1789.5,-194,95,1
8525,3781,1033,1958.5,19585,19143,7.2,9,9,8,244,24.4,1,1,1,0,0,201,20.1,0,7,6,6,7.0,18110,15804,1580.4,-1033,-3781,0
8526,-1704,-1787,1483.6,14836,17216,6.8,2,2,2,210,21.0,0,0,0,1,0,226,22.6,0,5,6,6,7.4,19003,16540,1654.0,1787,1704,1
8527,-729,-192,1733.4,17334,16960,6.8,8,8,9,213,21.3,0,0,0,1,1,219,21.9,1,12,9,9,6.8,17152,18063,1806.3,192,729,1
8528,-274,-192,1498.1,14981,17943,7.2,2,2,2,247,24.7,0,0,0,1,0,214,21.4,0,7,5,5,6.8,18135,15255,1525.5,192,274,1
8529,277,252,1668.4,16684,17360,6.6,8,8,7,205,20.5,0,0,0,1,1,202,20.2,1,9,6,6,6.8,17108,16407,1640.7,-252,-277,1
8530,147,582,1553.3,15533,17431,7.0,7,7,2,186,18.6,0,0,0,1,1,180,18.0,2,9,5,5,6.6,16849,15386,1538.6,-582,-147,0
8531,-1162,-1007,1628.8,16288,18071,6.8,6,6,7,209,20.9,0,0,0,1,0,204,20.4,1,7,9,9,7.0,19078,17450,1745.0,1007,1162,0
8532,3942,2820,1927.6,19276,19395,7.2,10,10,9,218,21.8,1,0,1,0,0,189,18.9,0,6,6,6,6.6,16575,15334,1533.4,-2820,-3942,1
8533,-810,-1226,1673.0,16730,16831,6.6,8,8,15,221,22.1,0,0,1,0,0,204,20.4,0,10,9,9,7.2,18057,17540,1754.0,1226,810,1
8534,-825,-616,1518.4,15184,17480,6.8,4,4,4,201,20.1,0,0,1,0,0,210,21.0,0,4,4,4,7.2,18096,16009,1600.9,616,825,1
8535,-2472,174,1552.3,15523,17886,7.0,4,4,2,228,22.8,0,0,0,1,1,243,24.3,1,5,5,5,7.0,17712,17995,1799.5,-174,2472,1
8536,3018,1320,1807.2,18072,19281,7.2,6,6,6,281,28.1,0,0,1,0,1,223,22.3,1,2,4,4,7.0,17961,15054,1505.4,-1320,-3018,1
8537,-125,-962,1683.9,16839,17851,7.0,9,9,11,192,19.2,2,1,1,0,0,211,21.1,0,5,8,8,7.0,18813,16964,1696.4,962,125,0
8538,-132,-330,1604.7,16047,17256,6.8,6,6,2,218,21.8,0,0,0,1,1,218,21.8,2,4,6,6,6.6,17586,16179,1617.9,330,132,1
8539,-2131,-2173,1384.0,13840,17099,6.8,1,1,1,225,22.5,1,0,0,1,1,264,26.4,1,1,2,2,7.2,19272,15971,1597.1,2173,2131,0
8540,432,1389,1858.8,18588,18787,7.4,10,10,18,205,20.5,1,1,1,0,0,186,18.6,0,12,11,11,6.8,17398,18156,1815.6,-1389,-432,1
8541,1000,885,1730.1,17301,19661,7.4,7,7,5,251,25.1,1,1,1,0,0,220,22.0,0,9,5,5,7.2,18776,16301,1630.1,-885,-1000,1
8542,2925,1304,1766.9,17669,18012,7.0,7,7,9,221,22.1,2,1,1,0,0,219,21.9,0,5,3,3,6.6,16708,14744,1474.4,-1304,-2925,0
8543,-117,815,1678.6,16786,19026,7.2,8,8,9,244,24.4,1,1,0,1,0,223,22.3,1,13,7,7,6.8,18211,16903,1690.3,-815,117,0
8544,-4145,-3714,1380.6,13806,15551,6.4,1,1,0,216,21.6,0,0,0,1,1,232,23.2,2,12,9,9,7.6,19265,17951,1795.1,3714,4145,0
8545,-2483,-1356,1473.5,14735,18050,7.0,3,3,1,213,21.3,0,0,1,0,1,228,22.8,1,10,7,7,7.4,19406,17218,1721.8,1356,2483,1
8546,5224,2715,1805.9,18059,18165,7.0,10,10,16,218,21.8,0,0,1,0,1,200,20.0,1,0,0,0,6.4,15450,12835,1283.5,-2715,-5224,1
8547,-929,-1819,1475.9,14759,17168,6.6,3,3,4,229,22.9,1,0,1,0,1,223,22.3,1,4,4,4,7.0,18987,15688,1568.8,1819,929,0
8548,1219,1641,1580.9,15809,19160,7.0,4,4,4,245,24.5,0,0,0,1,1,244,24.4,1,0,1,1,7.0,17519,14590,1459.0,-1641,-1219,1
8549,533,1451,1688.9,16889,17619,6.6,6,6,6,194,19.4,0,0,0,1,0,220,22.0,1,10,7,7,6.6,16168,16356,1635.6,-1451,-533,1
8550,1355,1403,1871.3,18713,19848,7.2,12,12,11,226,22.6,0,0,1,0,1,196,19.6,1,7,8,8,7.2,18445,17358,1735.8,-1403,-1355,1
8551,-3176,-2235,1581.9,15819,18015,7.0,5,5,4,199,19.9,0,0,0,1,1,222,22.2,1,17,12,12,7.6,20250,18995,1899.5,2235,3176,0
8552,3967,593,1954.7,19547,17353,6.6,13,13,15,207,20.7,1,0,1,0,0,212,21.2,0,5,4,4,6.8,16760,15580,1558.0,-593,-3967,1
8553,2091,2537,1682.7,16827,18478,7.0,6,6,7,252,25.2,0,0,0,1,1,201,20.1,1,5,4,4,6.4,15941,14736,1473.6,-2537,-2091,1
8554,5767,3366,2066.8,20668,20383,7.6,12,12,15,234,23.4,2,1,1,0,0,183,18.3,0,6,3,3,6.8,17017,14901,1490.1,-3366,-5767,0
8555,2974,2777,1846.0,18460,18568,7.0,12,12,16,229,22.9,0,0,1,0,0,185,18.5,0,11,6,6,6.4,15791,15486,1548.6,-2777,-2974,1
8556,-2368,-1240,1606.3,16063,17891,6.8,5,5,5,195,19.5,1,0,0,1,1,233,23.3,1,9,10,10,7.2,19131,18431,1843.1,1240,2368,1
8557,3438,2418,1955.8,19558,20155,7.6,8,8,8,223,22.3,1,0,1,0,1,197,19.7,1,4,5,5,6.8,17737,16120,1612.0,-2418,-3438,1
8558,2461,956,1886.8,18868,19111,7.2,10,10,13,259,25.9,1,0,1,0,1,237,23.7,1,5,5,5,6.8,18155,16407,1640.7,-956,-2461,1
8559,3163,1231,1862.5,18625,19348,7.4,6,6,6,240,24.0,1,0,0,1,1,230,23.0,1,6,4,4,7.0,18117,15462,1546.2,-1231,-3163,1
8560,-95,-1474,1593.0,15930,15779,6.4,5,5,8,210,21.0,0,0,1,0,1,195,19.5,1,9,5,5,6.8,17253,16025,1602.5,1474,95,0
8561,-5654,-2236,1340.1,13401,16144,6.4,1,1,0,222,22.2,0,0,0,1,1,253,25.3,2,11,9,9,7.2,18380,19055,1905.5,2236,5654,0
8562,-696,-1472,1688.9,16889,16862,6.6,8,8,6,198,19.8,1,1,1,0,0,201,20.1,0,6,9,9,7.0,18334,17585,1758.5,1472,696,0
8563,1308,1371,1687.1,16871,19422,7.4,5,5,6,213,21.3,1,1,1,0,0,210,21.0,0,5,3,3,7.0,18051,15563,1556.3,-1371,-1308,1
8564,-2376,-1482,1547.0,15470,17547,7.0,4,4,5,226,22.6,0,0,0,1,1,248,24.8,1,13,8,8,7.4,19029,17846,1784.6,1482,2376,0
8565,-3179,-2074,1590.9,15909,16835,6.8,6,6,8,203,20.3,0,0,1,0,0,253,25.3,1,9,7,7,7.0,18909,19088,1908.8,2074,3179,1
8566,-444,240,1499.6,14996,16984,6.6,3,3,7,221,22.1,1,0,0,1,1,197,19.7,1,8,4,4,6.6,16744,15440,1544.0,-240,444,0
8567,2989,1250,1879.1,18791,18424,6.8,8,8,7,254,25.4,1,1,1,0,0,188,18.8,0,10,6,6,6.8,17174,15802,1580.2,-1250,-2989,1
8568,-1134,940,1580.5,15805,18656,7.2,6,6,7,216,21.6,0,0,0,1,1,239,23.9,1,9,6,6,7.0,17716,16939,1693.9,-940,1134,0
8569,-862,931,1754.1,17541,18201,7.0,8,8,11,216,21.6,1,1,0,1,0,219,21.9,0,16,10,10,7.0,17270,18403,1840.3,-931,862,1
8570,-2696,-2455,1443.9,14439,17416,6.8,0,0,0,264,26.4,1,1,0,1,0,250,25.0,0,9,6,6,7.4,19871,17135,1713.5,2455,2696,1
8571,-4843,-2306,1493.9,14939,17241,6.8,4,4,1,195,19.5,0,0,1,0,1,227,22.7,2,17,9,9,7.0,19547,19782,1978.2,2306,4843,0
8572,2348,2115,1939.9,19399,17635,6.8,13,13,15,226,22.6,1,0,1,0,1,192,19.2,1,4,8,8,6.4,15520,17051,1705.1,-2115,-2348,1
8573,-2939,-2323,1466.7,14667,16353,6.6,2,2,2,230,23.0,0,0,0,1,0,246,24.6,0,7,6,6,7.2,18676,17606,1760.6,2323,2939,0
8574,3168,2910,1780.2,17802,19007,7.2,10,10,8,222,22.2,1,0,1,0,0,198,19.8,0,5,3,3,6.6,16097,14634,1463.4,-2910,-3168,1
8575,2200,1607,1844.6,18446,19613,7.4,9,9,7,216,21.6,0,0,1,0,1,218,21.8,1,8,6,6,6.8,18006,16246,1624.6,-1607,-2200,0
8576,-1219,-737,1577.9,15779,17436,6.8,6,6,8,186,18.6,0,0,0,1,1,242,24.2,2,10,7,7,7.2,18173,16998,1699.8,737,1219,0
8577,-2240,-4314,1469.5,14695,16615,6.8,2,2,3,222,22.2,0,0,1,0,1,249,24.9,1,2,7,7,7.4,20929,16935,1693.5,4314,2240,0
8578,-2855,-1603,1420.6,14206,17314,7.0,1,1,0,218,21.8,1,0,0,1,1,228,22.8,1,8,8,8,7.0,18917,17061,1706.1,1603,2855,1
8579,5887,4222,1996.7,19967,19474,7.0,11,11,12,246,24.6,1,1,1,0,0,209,20.9,0,2,2,2,6.2,15252,14080,1408.0,-4222,-5887,1
8580,2115,-207,1728.4,17284,16215,6.4,5,5,5,185,18.5,2,1,1,0,0,215,21.5,0,4,4,4,6.4,16422,15169,1516.9,207,-2115,1
8581,-1668,-866,1542.4,15424,16777,6.6,5,5,2,218,21.8,1,1,0,1,0,191,19.1,0,10,8,8,7.2,17643,17092,1709.2,866,1668,1
8582,-1829,-1132,1672.9,16729,16290,6.4,8,8,3,198,19.8,0,0,1,0,1,202,20.2,1,16,12,12,7.0,17422,18558,1855.8,1132,1829,0
8583,-1989,-1299,1545.0,15450,17448,6.8,6,6,3,207,20.7,0,0,0,1,0,213,21.3,0,9,9,9,7.2,18747,17439,1743.9,1299,1989,0
8584,1519,1104,1681.4,16814,18759,7.2,6,6,8,231,23.1,2,1,0,1,0,234,23.4,0,2,2,2,7.0,17655,15295,1529.5,-1104,-1519,1
8585,2627,1759,1823.0,18230,20125,7.4,8,8,8,246,24.6,2,1,1,0,0,241,24.1,0,4,4,4,7.0,18366,15603,1560.3,-1759,-2627,1
8586,2198,10,1684.3,16843,17489,6.6,8,8,8,204,20.4,1,1,1,0,0,206,20.6,1,3,4,4,6.8,17479,14645,1464.5,-10,-2198,1
8587,-2437,-1355,1791.6,17916,17579,6.8,10,10,7,182,18.2,1,1,1,0,0,175,17.5,0,16,14,14,7.4,18934,20353,2035.3,1355,2437,0
8588,-3075,-2008,1731.8,17318,17449,7.0,10,10,11,212,21.2,0,0,0,1,1,214,21.4,2,16,15,15,7.4,19457,20393,2039.3,2008,3075,0
8589,1824,1556,1860.8,18608,19209,7.4,12,12,17,215,21.5,1,1,0,1,0,222,22.2,0,6,7,7,7.0,17653,16784,1678.4,-1556,-1824,1
8590,2171,960,1624.0,16240,16345,6.6,6,6,8,200,20.0,0,0,1,0,0,193,19.3,0,5,3,3,6.2,15385,14069,1406.9,-960,-2171,1
8591,2700,1463,2010.9,20109,18733,7.2,11,11,17,211,21.1,1,0,0,1,0,231,23.1,0,9,8,8,6.8,17270,17409,1740.9,-1463,-2700,1
8592,-588,-1142,1597.7,15977,16880,6.8,6,6,8,206,20.6,1,1,0,1,0,220,22.0,0,10,8,8,7.0,18022,16565,1656.5,1142,588,0
8593,-6887,-5573,1451.1,14511,14800,6.2,3,3,5,158,15.8,1,0,0,1,1,248,24.8,1,19,16,16,7.4,20373,21398,2139.8,5573,6887,0
8594,1170,1415,1625.0,16250,18390,7.2,5,5,5,208,20.8,1,1,0,1,0,205,20.5,0,5,4,4,6.6,16975,15080,1508.0,-1415,-1170,1
8595,-342,-623,1642.7,16427,18982,7.0,4,4,5,250,25.0,2,1,1,0,0,247,24.7,0,5,5,5,7.2,19605,16769,1676.9,623,342,0
8596,1235,-270,1839.8,18398,17918,6.8,9,9,16,202,20.2,0,0,1,0,1,197,19.7,1,15,11,11,7.0,18188,17163,1716.3,270,-1235,1
8597,-1080,-1362,1524.0,15240,17092,6.8,4,4,7,196,19.6,1,1,0,1,0,220,22.0,0,6,7,7,7.0,18454,16320,1632.0,1362,1080,1
8598,1371,2221,1726.2,17262,18939,7.0,6,6,5,222,22.2,0,0,0,1,1,195,19.5,1,7,6,6,6.6,16718,15891,1589.1,-2221,-1371,1
8599,-944,-1054,1480.4,14804,17557,7.0,2,2,1,233,23.3,1,1,1,0,0,222,22.2,0,5,4,4,7.0,18611,15748,1574.8,1054,944,1
8600,-3640,-3482,1492.1,14921,15556,6.4,3,3,2,196,19.6,0,0,0,1,1,210,21.0,1,16,12,12,7.2,19038,18561,1856.1,3482,3640,0
8601,-3825,-1386,1552.3,15523,16556,6.6,7,7,8,179,17.9,1,0,0,1,1,217,21.7,1,16,12,12,7.2,17942,19348,1934.8,1386,3825,0
8602,598,-456,1662.3,16623,18012,7.0,6,6,8,243,24.3,1,1,0,1,0,224,22.4,1,1,4,4,7.0,18468,16025,1602.5,456,-598,1
8603,4266,2076,2107.0,21070,19275,7.2,14,14,20,219,21.9,1,0,1,0,1,191,19.1,1,10,8,8,7.0,17199,16804,1680.4,-2076,-4266,1
8604,-28,-28,1690.7,16907,18706,7.2,7,7,8,213,21.3,1,1,1,0,0,227,22.7,0,10,8,8,7.0,18734,16935,1693.5,28,28,0
8605,2647,2948,1800.3,18003,18657,7.0,11,11,16,213,21.3,1,1,1,0,0,187,18.7,0,7,6,6,6.6,15709,15356,1535.6,-2948,-2647,1
8606,-1565,-173,1712.4,17124,17615,6.8,7,7,10,228,22.8,1,1,0,1,0,173,17.3,0,18,11,11,7.0,17788,18689,1868.9,173,1565,0
8607,3667,1610,1909.9,19099,18143,7.0,16,16,18,183,18.3,2,1,1,0,0,200,20.0,0,6,5,5,6.4,16533,15432,1543.2,-1610,-3667,1
8608,-450,-849,1553.8,15538,18054,6.8,4,4,2,223,22.3,0,0,1,0,0,189,18.9,0,6,5,5,7.2,18903,15988,1598.8,849,450,1
8609,-1108,-570,1558.3,15583,17671,7.0,4,4,3,210,21.0,1,0,0,1,1,215,21.5,1,13,7,7,7.0,18241,16691,1669.1,570,1108,0
8610,1093,770,1698.2,16982,17597,6.8,10,10,17,187,18.7,0,0,0,1,0,222,22.2,0,4,6,6,6.6,16827,15889,1588.9,-770,-1093,1
8611,-982,1441,1623.8,16238,17694,6.8,7,7,10,202,20.2,0,0,0,1,1,185,18.5,1,10,8,8,6.6,16253,17220,1722.0,-1441,982,0
8612,109,1368,1664.1,16641,19419,7.2,6,6,9,202,20.2,0,0,1,0,1,217,21.7,1,7,5,5,6.8,18051,16532,1653.2,-1368,-109,0
8613,1166,1899,1731.8,17318,19732,7.4,9,9,11,221,22.1,0,0,0,1,0,225,22.5,0,4,5,5,7.0,17833,16152,1615.2,-1899,-1166,1
8614,-370,-1681,1643.8,16438,17815,7.0,7,7,7,214,21.4,1,1,0,1,0,234,23.4,1,7,6,6,7.4,19496,16808,1680.8,1681,370,0
8615,656,553,1608.1,16081,18269,7.0,6,6,3,232,23.2,1,1,1,0,0,205,20.5,0,5,4,4,7.0,17716,15425,1542.5,-553,-656,1
8616,1421,1097,1638.5,16385,18788,7.0,5,5,8,222,22.2,0,0,0,1,1,215,21.5,1,4,2,2,7.0,17691,14964,1496.4,-1097,-1421,1
8617,1176,1300,1711.3,17113,18861,7.4,8,8,7,245,24.5,0,0,1,0,1,225,22.5,1,6,5,5,7.0,17561,15937,1593.7,-1300,-1176,0
8618,-6869,-6365,1301.6,13016,13166,5.6,2,2,3,167,16.7,0,0,0,1,1,243,24.3,2,6,7,7,7.2,19531,19885,1988.5,6365,6869,0
8619,-1117,-764,1586.3,15863,17499,7.0,5,5,6,228,22.8,0,0,1,0,1,213,21.3,1,13,9,9,7.0,18263,16980,1698.0,764,1117,0
8620,1895,-224,1784.3,17843,17948,7.0,5,5,6,243,24.3,2,1,1,0,0,207,20.7,0,6,6,6,7.0,18172,15948,1594.8,224,-1895,1
8621,936,-497,1642.1,16421,16972,6.4,6,6,7,207,20.7,1,0,1,0,1,231,23.1,1,3,3,3,7.2,17469,15485,1548.5,497,-936,1
8622,-1257,-91,1573.9,15739,18212,7.0,2,2,2,256,25.6,0,0,0,1,1,234,23.4,1,10,7,7,6.8,18303,16996,1699.6,91,1257,0
8623,267,162,1718.1,17181,18170,6.8,7,7,8,231,23.1,0,0,1,0,1,220,22.0,2,9,7,7,6.8,18008,16914,1691.4,-162,-267,0
8624,131,-613,1653.4,16534,18294,7.2,5,5,6,260,26.0,1,1,0,1,0,233,23.3,0,5,4,4,7.0,18907,16403,1640.3,613,-131,0
8625,2139,547,1808.4,18084,19140,7.2,6,6,7,228,22.8,1,1,0,1,0,201,20.1,1,5,6,6,7.0,18593,15945,1594.5,-547,-2139,0
8626,525,44,1709.4,17094,17903,6.8,7,7,11,205,20.5,1,1,0,1,0,225,22.5,0,6,6,6,7.0,17859,16569,1656.9,-44,-525,1
8627,4335,1377,1891.1,18911,18311,6.8,10,10,14,205,20.5,1,1,1,0,0,192,19.2,1,4,3,3,6.6,16934,14576,1457.6,-1377,-4335,0
8628,4184,3694,1892.8,18928,19725,7.4,13,13,13,227,22.7,1,0,1,0,0,180,18.0,0,2,3,3,6.6,16031,14744,1474.4,-3694,-4184,1
8629,3362,2634,1926.6,19266,19920,7.4,12,12,13,236,23.6,1,0,1,0,0,204,20.4,0,6,5,5,6.8,17286,15904,1590.4,-2634,-3362,1
8630,-2534,-3031,1441.5,14415,17028,6.8,1,1,1,238,23.8,0,0,0,1,0,233,23.3,0,7,7,7,7.4,20059,16949,1694.9,3031,2534,0
8631,4805,3808,1998.7,19987,19679,7.2,15,15,12,194,19.4,1,0,1,0,1,194,19.4,1,4,4,4,6.4,15871,15182,1518.2,-3808,-4805,1
8632,1259,1454,1846.4,18464,18681,7.0,11,11,11,234,23.4,1,1,1,0,0,192,19.2,0,10,9,9,6.8,17227,17205,1720.5,-1454,-1259,1
8633,1299,879,1746.7,17467,19153,7.2,7,7,11,244,24.4,0,0,1,0,0,241,24.1,0,5,5,5,7.0,18274,16168,1616.8,-879,-1299,0
8634,-1592,-2117,1468.6,14686,17187,7.0,3,3,2,228,22.8,1,0,0,1,1,247,24.7,1,3,5,5,7.2,19304,16278,1627.8,2117,1592,0
8635,1360,2274,1720.2,17202,19917,7.4,6,6,6,229,22.9,1,1,1,0,0,220,22.0,0,3,3,3,7.0,17643,15842,1584.2,-2274,-1360,1
8636,-866,388,1581.0,15810,18914,7.2,5,5,5,208,20.8,0,0,0,1,1,253,25.3,1,3,5,5,6.8,18526,16676,1667.6,-388,866,1
8637,3634,3559,1888.6,18886,20642,7.2,8,8,9,240,24.0,0,0,0,1,0,175,17.5,0,7,5,5,6.8,17083,15252,1525.2,-3559,-3634,1
8638,1401,85,1666.8,16668,18572,7.2,4,4,5,261,26.1,0,0,1,0,0,203,20.3,0,4,3,3,7.2,18487,15267,1526.7,-85,-1401,1
8639,-4192,-3984,1379.4,13794,15813,6.4,2,2,2,190,19.0,0,0,0,1,1,220,22.0,1,9,11,11,7.2,19797,17986,1798.6,3984,4192,0
8640,4641,2291,1929.2,19292,18153,7.2,12,12,13,210,21.0,0,0,1,0,1,172,17.2,1,5,5,5,6.6,15862,14651,1465.1,-2291,-4641,1
8641,2253,772,1700.4,17004,17216,6.4,9,9,9,185,18.5,1,1,1,0,0,163,16.3,0,3,6,6,6.6,16444,14751,1475.1,-772,-2253,0
8642,3203,1830,1723.1,17231,17207,6.6,7,7,9,240,24.0,2,1,1,0,0,186,18.6,0,2,2,2,6.2,15377,14028,1402.8,-1830,-3203,1
8643,4656,3776,1938.3,19383,21403,7.6,8,8,5,271,27.1,2,1,1,0,0,249,24.9,0,0,1,1,6.8,17627,14727,1472.7,-3776,-4656,1
8644,161,130,1641.7,16417,17202,6.8,7,7,8,205,20.5,1,1,1,0,0,209,20.9,0,11,6,6,6.8,17072,16256,1625.6,-130,-161,1
8645,-65,-433,1728.1,17281,18317,7.2,6,6,10,228,22.8,0,0,0,1,1,246,24.6,1,6,6,6,7.2,18750,17346,1734.6,433,65,1
8646,-2539,-1637,1519.5,15195,16429,6.6,5,5,5,187,18.7,0,0,0,1,0,223,22.3,0,5,7,7,6.6,18066,17734,1773.4,1637,2539,0
8647,-2623,-3436,1509.1,15091,14181,6.2,6,6,8,172,17.2,0,0,1,0,1,211,21.1,1,15,10,10,6.8,17617,17714,1771.4,3436,2623,1
8648,2724,2170,1845.6,18456,19034,7.2,11,11,17,214,21.4,1,1,1,0,0,218,21.8,0,7,4,4,6.6,16864,15732,1573.2,-2170,-2724,1
8649,2177,186,1719.6,17196,18109,7.0,7,7,12,204,20.4,1,1,1,0,0,237,23.7,0,0,2,2,7.0,17923,15019,1501.9,-186,-2177,1
8650,-2840,-1360,1553.4,15534,15681,6.2,5,5,4,209,20.9,0,0,0,1,0,198,19.8,0,11,11,11,7.0,17041,18374,1837.4,1360,2840,0
8651,-2718,-1000,1506.7,15067,17908,6.8,5,5,6,201,20.1,1,0,0,1,1,238,23.8,1,8,6,6,7.0,18908,17785,1778.5,1000,2718,0
8652,-2783,-2017,1529.5,15295,15416,6.4,6,6,6,157,15.7,1,1,1,0,0,213,21.3,1,5,8,8,6.6,17433,18078,1807.8,2017,2783,0
8653,-939,-2597,1850.1,18501,17881,6.8,8,8,12,207,20.7,0,0,0,1,1,214,21.4,1,15,12,12,7.2,20478,19440,1944.0,2597,939,0
8654,-3770,-2959,1511.9,15119,16068,6.4,4,4,3,201,20.1,0,0,0,1,0,213,21.3,0,12,10,10,7.0,19027,18889,1888.9,2959,3770,0
8655,-3442,-2915,1529.4,15294,16497,6.4,4,4,3,202,20.2,0,0,1,0,0,221,22.1,0,16,11,11,7.2,19412,18736,1873.6,2915,3442,0
8656,3236,3464,1809.9,18099,18678,7.4,10,10,10,203,20.3,1,0,1,0,0,163,16.3,0,3,6,6,6.2,15214,14863,1486.3,-3464,-3236,1
8657,382,-64,1679.0,16790,17505,7.0,7,7,9,193,19.3,0,0,1,0,0,208,20.8,0,12,8,8,7.0,17569,16408,1640.8,64,-382,1
8658,2135,1898,1746.7,17467,18794,7.0,6,6,6,238,23.8,0,0,1,0,0,194,19.4,0,6,5,5,6.8,16896,15332,1533.2,-1898,-2135,1
8659,-524,468,1633.8,16338,18577,7.0,6,6,0,223,22.3,1,0,0,1,1,209,20.9,1,11,7,7,7.0,18109,16862,1686.2,-468,524,0
8660,-3033,-3775,1547.1,15471,15785,6.4,4,4,7,192,19.2,1,1,1,0,0,207,20.7,0,13,10,10,7.4,19560,18504,1850.4,3775,3033,1
8661,-3441,-1732,1432.2,14322,16812,6.4,3,3,3,186,18.6,1,1,0,1,0,227,22.7,1,9,7,7,7.0,18544,17763,1776.3,1732,3441,0
8662,3360,1693,1826.6,18266,19178,7.2,9,9,10,254,25.4,1,1,1,0,0,235,23.5,0,2,3,3,6.8,17485,14906,1490.6,-1693,-3360,1
8663,8553,4873,2269.7,22697,21092,7.6,16,16,15,254,25.4,1,1,1,0,0,166,16.6,0,2,3,3,6.4,16219,14144,1414.4,-4873,-8553,1
8664,-571,-401,1653.8,16538,17488,6.8,7,7,9,204,20.4,0,0,1,0,1,222,22.2,1,12,9,9,6.8,17889,17109,1710.9,401,571,1
8665,-2027,-114,1637.3,16373,18479,7.2,6,6,5,221,22.1,0,0,0,1,1,235,23.5,2,9,8,8,7.0,18593,18400,1840.0,114,2027,0
8666,-29,-781,1502.9,15029,16462,6.6,3,3,7,244,24.4,0,0,1,0,1,207,20.7,1,4,4,4,6.8,17243,15058,1505.8,781,29,1
8667,-709,-658,1541.2,15412,17055,6.6,5,5,6,180,18.0,1,1,0,1,0,231,23.1,1,3,5,5,6.8,17713,16121,1612.1,658,709,0
8668,707,-788,1647.8,16478,18363,7.0,7,7,4,224,22.4,0,0,1,0,1,225,22.5,1,3,5,5,7.2,19151,15771,1577.1,788,-707,1
8669,2435,1239,1748.8,17488,19282,7.2,6,6,4,243,24.3,0,0,1,0,0,237,23.7,0,3,3,3,7.0,18043,15053,1505.3,-1239,-2435,0
8670,2627,1326,1810.5,18105,18937,7.0,9,9,12,254,25.4,0,0,1,0,0,216,21.6,0,2,4,4,6.8,17611,15478,1547.8,-1326,-2627,0
8671,1968,1173,1746.5,17465,18926,7.2,12,12,11,176,17.6,1,1,1,0,0,197,19.7,0,3,5,5,6.8,17753,15497,1549.7,-1173,-1968,1
8672,-665,-337,1473.5,14735,18220,7.0,1,1,1,234,23.4,0,0,0,1,1,227,22.7,1,3,3,3,7.0,18557,15400,1540.0,337,665,0
8673,-2930,-1894,1452.9,14529,17127,6.6,1,1,1,218,21.8,1,0,0,1,0,207,20.7,0,17,10,10,7.2,19021,17459,1745.9,1894,2930,1
8674,-5821,-3230,1431.1,14311,17028,6.8,2,2,0,217,21.7,1,0,0,1,1,251,25.1,1,11,10,10,7.2,20258,20132,2013.2,3230,5821,0
8675,-2497,-2400,1482.0,14820,17885,7.0,2,2,4,211,21.1,2,1,1,0,0,260,26.0,0,12,7,7,7.6,20285,17317,1731.7,2400,2497,1
8676,8863,5411,2370.1,23701,21188,7.8,15,15,24,239,23.9,2,1,1,0,0,197,19.7,0,2,3,3,6.4,15777,14838,1483.8,-5411,-8863,1
8677,-1823,-810,1507.8,15078,17979,7.0,3,3,1,219,21.9,0,0,0,1,1,225,22.5,1,9,7,7,7.0,18789,16901,1690.1,810,1823,0
8678,1147,254,1584.4,15844,17574,6.8,4,4,3,225,22.5,1,0,0,1,1,186,18.6,1,3,3,3,6.8,17320,14697,1469.7,-254,-1147,1
8679,-4177,-1640,1428.5,14285,16387,6.6,4,4,2,182,18.2,2,1,0,1,0,209,20.9,0,21,11,11,7.0,18027,18462,1846.2,1640,4177,0
8680,-2600,-2112,1559.6,15596,15360,6.2,6,6,7,197,19.7,1,1,0,1,0,185,18.5,1,7,9,9,6.6,17472,18196,1819.6,2112,2600,1
8681,2696,2452,1808.9,18089,19431,7.0,10,10,7,235,23.5,1,1,1,0,0,196,19.6,0,4,4,4,6.6,16979,15393,1539.3,-2452,-2696,1
8682,3413,2303,1832.0,18320,19311,7.0,8,8,2,268,26.8,2,1,1,0,0,151,15.1,0,7,5,5,6.6,17008,14907,1490.7,-2303,-3413,1
8683,-5369,-5193,1283.7,12837,15086,6.2,0,0,0,196,19.6,0,0,0,1,1,242,24.2,2,10,10,10,7.2,20279,18206,1820.6,5193,5369,0
8684,-153,-1105,1613.5,16135,17299,6.6,7,7,11,216,21.6,1,1,1,0,0,241,24.1,0,7,6,6,7.0,18404,16288,1628.8,1105,153,0
8685,-5031,-5211,1359.9,13599,15596,6.4,1,1,1,229,22.9,0,0,0,1,0,241,24.1,0,6,9,9,7.6,20807,18630,1863.0,5211,5031,0
8686,-1461,-799,1473.2,14732,17531,6.8,2,2,3,210,21.0,0,0,0,1,1,240,24.0,1,6,5,5,7.2,18330,16193,1619.3,799,1461,1
8687,-522,-1373,1552.9,15529,17787,6.6,3,3,5,237,23.7,0,0,0,1,1,222,22.2,1,2,5,5,7.0,19160,16051,1605.1,1373,522,0
8688,257,-1125,1590.9,15909,17578,6.8,6,6,6,208,20.8,1,1,1,0,0,233,23.3,0,0,3,3,6.8,18703,15652,1565.2,1125,-257,0
8689,1496,1458,1595.3,15953,18137,6.8,6,6,6,207,20.7,0,0,1,0,1,201,20.1,1,5,2,2,6.8,16679,14457,1445.7,-1458,-1496,0
8690,-1354,-798,1786.7,17867,17671,6.6,9,9,13,218,21.8,0,0,0,1,0,214,21.4,0,23,12,12,7.2,18469,19221,1922.1,798,1354,0
8691,-683,-676,1632.4,16324,17343,7.0,5,5,8,216,21.6,0,0,1,0,0,248,24.8,0,5,6,6,7.0,18019,17007,1700.7,676,683,0
8692,-6892,-5371,1300.6,13006,14750,6.0,1,1,1,201,20.1,0,0,0,1,1,233,23.3,2,12,8,8,7.2,20121,19898,1989.8,5371,6892,0
8693,-2163,-739,1616.5,16165,17638,6.6,4,4,7,220,22.0,0,0,0,1,1,213,21.3,1,18,9,9,7.0,18377,18328,1832.8,739,2163,0
8694,-4462,-3453,1420.5,14205,15571,6.4,4,4,5,204,20.4,1,1,0,1,0,269,26.9,0,7,7,7,7.0,19024,18667,1866.7,3453,4462,0
8695,-2059,-2345,1688.2,16882,17922,6.8,6,6,8,204,20.4,0,0,1,0,0,220,22.0,0,14,11,11,7.4,20267,18941,1894.1,2345,2059,1
8696,-1682,-563,1487.1,14871,16941,6.8,5,5,2,180,18.0,0,0,0,1,1,191,19.1,1,9,7,7,6.8,17504,16553,1655.3,563,1682,1
8697,8027,7621,2086.0,20860,21006,7.4,12,12,10,268,26.8,2,1,1,0,0,165,16.5,0,3,2,2,5.8,13385,12833,1283.3,-7621,-8027,1
8698,995,1649,1537.9,15379,18530,7.0,2,2,4,238,23.8,0,0,1,0,0,232,23.2,0,1,1,1,6.6,16881,14384,1438.4,-1649,-995,1
8699,1012,191,1581.4,15814,17846,7.0,5,5,6,240,24.0,1,1,1,0,0,229,22.9,0,1,2,2,6.8,17655,14802,1480.2,-191,-1012,1
8700,-1287,-6,1725.2,17252,18777,7.0,9,9,12,205,20.5,0,0,0,1,0,217,21.7,0,9,10,10,7.2,18783,18539,1853.9,6,1287,0
8701,359,-772,1645.1,16451,16842,6.6,8,8,7,191,19.1,0,0,1,0,0,195,19.5,0,6,6,6,7.0,17614,16092,1609.2,772,-359,0
8702,803,490,1699.1,16991,16213,6.6,10,10,13,180,18.0,0,0,0,1,0,177,17.7,0,13,8,8,6.4,15723,16188,1618.8,-490,-803,1
8703,-3426,-2539,1469.5,14695,17395,6.8,2,2,2,223,22.3,1,1,0,1,0,236,23.6,0,10,9,9,7.4,19934,18121,1812.1,2539,3426,0
8704,1315,1402,1633.3,16333,18597,7.2,4,4,4,244,24.4,0,0,1,0,0,206,20.6,1,4,4,4,7.0,17195,15018,1501.8,-1402,-1315,1
8705,1171,-841,1787.5,17875,17347,6.8,9,9,10,212,21.2,0,0,1,0,0,190,19.0,0,11,8,8,7.2,18188,16704,1670.4,841,-1171,1
8706,3970,2818,1891.2,18912,20086,7.4,9,9,6,244,24.4,1,1,0,1,0,210,21.0,0,5,5,5,6.6,17268,14942,1494.2,-2818,-3970,1
8707,482,617,1679.1,16791,17929,7.0,5,5,4,225,22.5,0,0,0,1,1,207,20.7,1,5,7,7,6.8,17312,16309,1630.9,-617,-482,1
8708,-2090,-2188,1519.8,15198,17307,6.8,4,4,1,214,21.4,1,0,1,0,1,222,22.2,1,7,7,7,7.2,19495,17288,1728.8,2188,2090,0
8709,2052,1084,1815.6,18156,19293,7.4,10,10,11,238,23.8,0,0,1,0,0,240,24.0,0,4,6,6,6.8,18209,16104,1610.4,-1084,-2052,1
8710,3770,1556,1833.4,18334,19209,7.0,8,8,9,232,23.2,0,0,0,1,1,195,19.5,1,2,3,3,6.8,17653,14564,1456.4,-1556,-3770,1
8711,-849,-603,1605.4,16054,17023,6.6,6,6,9,202,20.2,0,0,1,0,1,215,21.5,1,7,7,7,6.8,17626,16903,1690.3,603,849,0
8712,1656,95,1827.1,18271,18004,6.8,8,8,6,223,22.3,1,0,1,0,1,226,22.6,1,6,7,7,7.0,17909,16615,1661.5,-95,-1656,1
8713,-2328,-1524,1564.5,15645,16821,6.8,5,5,3,203,20.3,0,0,0,1,1,209,20.9,1,13,11,11,6.8,18345,17973,1797.3,1524,2328,0
8714,4677,4588,1781.6,17816,20228,7.2,6,6,3,244,24.4,1,1,1,0,0,216,21.6,0,0,0,0,6.6,15640,13139,1313.9,-4588,-4677,1
8715,724,2025,1523.7,15237,17965,7.0,4,4,4,205,20.5,1,1,0,1,0,206,20.6,1,4,3,3,6.2,15940,14513,1451.3,-2025,-724,1
8716,1154,971,1574.0,15740,17908,7.0,5,5,5,220,22.0,1,0,1,0,1,225,22.5,1,3,3,3,6.8,16937,14586,1458.6,-971,-1154,1
8717,919,-36,1594.9,15949,17392,6.6,6,6,7,198,19.8,1,1,0,1,0,211,21.1,0,2,2,2,6.8,17428,15030,1503.0,36,-919,0
8718,160,999,1725.0,17250,18870,7.2,7,7,7,255,25.5,0,0,0,1,0,231,23.1,0,5,7,7,6.8,17871,17090,1709.0,-999,-160,1
8719,-347,-2753,1719.1,17191,17267,6.8,7,7,8,206,20.6,1,1,1,0,0,212,21.2,0,11,7,7,7.6,20020,17538,1753.8,2753,347,0
8720,3122,3276,1751.2,17512,20540,7.4,5,5,5,283,28.3,0,0,0,1,1,244,24.4,1,1,1,1,6.6,17264,14390,1439.0,-3276,-3122,1
8721,-761,-10,1533.6,15336,17953,7.0,3,3,1,253,25.3,0,0,1,0,0,219,21.9,1,5,4,4,6.8,17963,16097,1609.7,10,761,0
8722,-6445,-4329,1414.3,14143,15352,6.2,3,3,1,205,20.5,1,1,0,1,0,209,20.9,1,14,14,14,7.4,19681,20588,2058.8,4329,6445,0
8723,262,611,1609.2,16092,18020,6.8,5,5,4,222,22.2,0,0,1,0,1,191,19.1,1,7,5,5,6.8,17409,15830,1583.0,-611,-262,1
8724,1014,850,1750.5,17505,19027,7.2,8,8,4,236,23.6,1,0,1,0,1,201,20.1,1,5,7,7,7.0,18177,16491,1649.1,-850,-1014,1
8725,-1022,-1253,1500.5,15005,17143,6.8,4,4,4,213,21.3,0,0,1,0,1,230,23.0,2,7,6,6,7.0,18396,16027,1602.7,1253,1022,0
8726,-4907,-2701,1518.9,15189,17359,7.0,5,5,5,195,19.5,0,0,0,1,1,250,25.0,1,8,11,11,7.4,20060,20096,2009.6,2701,4907,0
8727,1978,1936,1694.5,16945,18652,7.4,8,8,8,218,21.8,0,0,0,1,0,188,18.8,0,7,5,5,6.6,16716,14967,1496.7,-1936,-1978,0
8728,1032,-617,1826.9,18269,16542,6.4,12,12,20,198,19.8,0,0,1,0,0,202,20.2,0,9,10,10,6.8,17159,17237,1723.7,617,-1032,0
8729,2799,2965,1669.7,16697,19455,7.4,4,4,3,235,23.5,1,0,0,1,1,200,20.0,1,3,2,2,6.8,16490,13898,1389.8,-2965,-2799,1
8730,-2967,-4209,1517.9,15179,16562,6.8,4,4,5,220,22.0,1,1,1,0,0,266,26.6,0,7,8,8,7.6,20771,18146,1814.6,4209,2967,0
8731,-1770,-1276,1466.4,14664,16863,6.8,3,3,1,218,21.8,1,1,1,0,0,219,21.9,1,4,4,4,7.0,18139,16434,1643.4,1276,1770,0
8732,1825,243,1737.5,17375,17881,7.0,6,6,5,225,22.5,1,1,1,0,0,199,19.9,0,8,5,5,7.0,17638,15550,1555.0,-243,-1825,1
8733,2764,2121,1752.4,17524,18825,7.0,9,9,8,258,25.8,1,1,0,1,0,208,20.8,0,3,4,4,6.4,16704,14760,1476.0,-2121,-2764,1
8734,1324,1692,1803.3,18033,18634,7.2,10,10,9,201,20.1,0,0,0,1,0,185,18.5,1,8,8,8,6.8,16942,16709,1670.9,-1692,-1324,1
8735,2690,2514,1888.0,18880,19278,7.0,9,9,9,235,23.5,0,0,1,0,1,193,19.3,1,9,7,7,6.6,16764,16190,1619.0,-2514,-2690,1
8736,1520,1168,1875.1,18751,19155,7.2,10,10,17,232,23.2,1,1,0,1,0,232,23.2,0,8,6,6,6.8,17987,17231,1723.1,-1168,-1520,1
8737,-830,-448,1615.0,16150,18167,6.8,6,6,4,213,21.3,1,0,0,1,0,226,22.6,0,5,7,7,7.0,18615,16980,1698.0,448,830,1
8738,-4147,-3023,1376.9,13769,15094,6.2,3,3,2,174,17.4,1,1,1,0,0,217,21.7,0,7,9,9,7.0,18117,17916,1791.6,3023,4147,0
8739,-947,1016,1520.2,15202,18246,7.0,4,4,1,240,24.0,1,1,0,1,0,231,23.1,0,7,5,5,6.8,17230,16149,1614.9,-1016,947,1
8740,-3695,-4018,1488.5,14885,15463,6.4,5,5,7,170,17.0,1,1,0,1,0,241,24.1,1,8,10,10,7.2,19481,18580,1858.0,4018,3695,0
8741,-1252,-1190,1584.7,15847,16305,6.6,7,7,6,199,19.9,0,0,0,1,0,231,23.1,1,6,6,6,6.6,17495,17099,1709.9,1190,1252,0
8742,1371,1179,1670.8,16708,19294,7.2,7,7,8,212,21.2,0,0,1,0,0,238,23.8,0,4,4,4,6.8,18115,15337,1533.7,-1179,-1371,1
8743,1767,1408,1778.8,17788,18965,7.0,7,7,8,248,24.8,2,1,1,0,0,221,22.1,0,4,5,5,7.0,17557,16021,1602.1,-1408,-1767,1
8744,1605,755,1698.8,16988,17774,6.6,9,9,9,213,21.3,0,0,1,0,1,203,20.3,2,4,5,5,6.6,17019,15383,1538.3,-755,-1605,1
8745,8532,5876,2204.9,22049,19632,7.4,13,13,13,243,24.3,1,1,1,0,0,165,16.5,0,2,3,3,5.8,13756,13517,1351.7,-5876,-8532,1
8746,-753,-299,1675.2,16752,18525,7.0,7,7,11,226,22.6,0,0,1,0,0,225,22.5,0,6,9,9,7.0,18824,17505,1750.5,299,753,1
8747,4446,3448,1831.8,18318,19194,7.2,9,9,8,228,22.8,2,1,1,0,0,188,18.8,0,4,2,2,6.4,15746,13872,1387.2,-3448,-4446,1
8748,-3142,-2633,1465.5,14655,16541,6.6,4,4,7,208,20.8,0,0,0,1,0,216,21.6,1,17,8,8,7.2,19174,17797,1779.7,2633,3142,0
8749,-2695,-2572,1432.1,14321,15077,6.0,5,5,4,167,16.7,0,0,0,1,0,181,18.1,0,10,8,8,7.0,17649,17016,1701.6,2572,2695,1
8750,-4603,-2667,1443.4,14434,15829,6.6,4,4,4,183,18.3,0,0,0,1,1,212,21.2,2,11,8,8,7.0,18496,19037,1903.7,2667,4603,0
8751,1454,1187,1891.0,18910,18538,7.2,12,12,10,203,20.3,1,1,1,0,0,185,18.5,0,14,9,9,7.0,17351,17456,1745.6,-1187,-1454,0
8752,-312,-473,1574.0,15740,17449,7.0,5,5,5,206,20.6,1,1,0,1,0,229,22.9,0,5,4,4,6.8,17922,16052,1605.2,473,312,0
8753,-491,-1417,1542.8,15428,16724,6.8,6,6,5,201,20.1,0,0,1,0,1,211,21.1,1,4,5,5,6.8,18141,15919,1591.9,1417,491,0
8754,124,-46,1557.7,15577,17244,6.8,5,5,7,207,20.7,0,0,0,1,1,220,22.0,2,5,4,4,6.8,17290,15453,1545.3,46,-124,0
8755,-1008,-810,1728.2,17282,17712,7.0,8,8,10,222,22.2,1,0,1,0,1,220,22.0,1,7,11,11,7.0,18522,18290,1829.0,810,1008,0
8756,1121,836,1700.9,17009,17881,6.8,7,7,10,222,22.2,1,1,0,1,0,228,22.8,0,4,5,5,6.8,17045,15888,1588.8,-836,-1121,1
8757,-2154,-2348,1634.5,16345,17662,6.8,6,6,5,209,20.9,0,0,0,1,0,225,22.5,0,13,13,13,7.4,20010,18499,1849.9,2348,2154,0
8758,-1711,-1086,1614.2,16142,17532,7.2,5,5,7,237,23.7,0,0,0,1,1,195,19.5,2,12,9,9,7.2,18618,17853,1785.3,1086,1711,1
8759,1144,944,1883.9,18839,18977,7.2,13,13,14,189,18.9,1,1,1,0,0,228,22.8,0,7,7,7,7.0,18033,17695,1769.5,-944,-1144,0
8760,2414,2407,1757.0,17570,18349,7.2,11,11,10,226,22.6,1,1,1,0,0,219,21.9,0,5,4,4,6.4,15942,15156,1515.6,-2407,-2414,1
8761,-2627,-2458,1526.5,15265,14533,6.0,7,7,8,161,16.1,0,0,0,1,0,218,21.8,0,16,10,10,6.6,16991,17892,1789.2,2458,2627,0
8762,-353,-280,1558.1,15581,18847,7.0,3,3,2,233,23.3,2,1,0,1,0,228,22.8,0,4,5,5,7.4,19127,15934,1593.4,280,353,1
8763,1232,1358,1651.4,16514,18198,7.2,7,7,7,211,21.1,0,0,0,1,1,215,21.5,1,3,5,5,6.6,16840,15282,1528.2,-1358,-1232,0
8764,1071,644,1612.7,16127,18248,6.8,4,4,3,235,23.5,2,1,1,0,0,212,21.2,0,4,4,4,6.6,17604,15056,1505.6,-644,-1071,1
8765,2233,3109,1783.1,17831,19052,7.2,10,10,10,198,19.8,1,1,0,1,0,204,20.4,0,9,6,6,6.6,15943,15598,1559.8,-3109,-2233,1
8766,4376,4106,1700.2,17002,19584,7.2,6,6,5,227,22.7,1,1,1,0,0,184,18.4,0,0,0,0,6.2,15478,12626,1262.6,-4106,-4376,1
8767,1931,2084,1693.1,16931,19352,7.2,6,6,4,222,22.2,0,0,0,1,0,222,22.2,0,1,1,1,6.8,17268,15000,1500.0,-2084,-1931,1
8768,2669,2743,1926.7,19267,19780,7.2,11,11,11,257,25.7,0,0,1,0,1,205,20.5,2,4,5,5,6.6,17037,16598,1659.8,-2743,-2669,1
8769,2596,1052,1759.3,17593,17874,7.0,10,10,11,190,19.0,1,1,1,0,0,207,20.7,0,5,4,4,6.6,16822,14997,1499.7,-1052,-2596,1
8770,1081,1757,1695.0,16950,18151,7.0,9,9,6,218,21.8,0,0,0,1,1,183,18.3,1,8,6,6,6.4,16394,15869,1586.9,-1757,-1081,1
8771,-2523,-2080,1382.9,13829,16293,6.4,4,4,2,171,17.1,0,0,1,0,1,222,22.2,1,6,6,6,6.8,18373,16352,1635.2,2080,2523,0
8772,1207,-488,1647.8,16478,17590,6.8,5,5,6,254,25.4,0,0,1,0,1,212,21.2,2,6,3,3,7.2,18078,15271,1527.1,488,-1207,0
8773,1106,1309,1633.8,16338,19137,7.2,5,5,4,234,23.4,1,1,0,1,0,228,22.8,0,1,3,3,6.8,17828,15232,1523.2,-1309,-1106,1
8774,-266,-613,1497.2,14972,17357,6.8,4,4,6,201,20.1,1,1,0,1,0,233,23.3,1,4,3,3,7.0,17970,15238,1523.8,613,266,1
8775,1069,1104,1615.2,16152,18649,7.0,6,6,6,228,22.8,1,1,0,1,0,238,23.8,0,2,2,2,6.8,17545,15083,1508.3,-1104,-1069,1
8776,1710,1298,1720.9,17209,17808,6.8,7,7,4,229,22.9,1,1,0,1,0,166,16.6,0,5,8,8,6.4,16510,15499,1549.9,-1298,-1710,0
8777,-100,-120,1708.4,17084,17884,7.0,7,7,7,224,22.4,0,0,0,1,1,207,20.7,1,10,8,8,7.0,18004,17184,1718.4,120,100,0
8778,-556,-442,1507.3,15073,17942,7.2,3,3,2,198,19.8,0,0,1,0,1,226,22.6,1,3,5,5,7.2,18384,15629,1562.9,442,556,1
8779,-274,304,1779.5,17795,18920,7.4,11,11,9,164,16.4,0,0,1,0,0,237,23.7,0,9,9,9,7.0,18616,18069,1806.9,-304,274,1
8780,-554,174,1640.4,16404,18053,6.8,6,6,3,231,23.1,0,0,0,1,1,204,20.4,2,9,9,9,6.8,17879,16958,1695.8,-174,554,0
8781,-542,-1235,1511.9,15119,18065,6.8,4,4,3,211,21.1,0,0,1,0,1,224,22.4,1,4,6,6,7.4,19300,15661,1566.1,1235,542,0
8782,1753,963,1777.0,17770,17974,7.0,8,8,11,228,22.8,0,0,0,1,0,233,23.3,0,6,5,5,6.8,17011,16017,1601.7,-963,-1753,1
8783,-1718,-1922,1521.2,15212,17204,6.8,3,3,2,202,20.2,0,0,1,0,0,201,20.1,1,8,6,6,7.0,19126,16930,1693.0,1922,1718,0
8784,-1980,-1595,1578.1,15781,17614,6.8,5,5,3,203,20.3,1,1,1,0,0,228,22.8,0,11,9,9,7.2,19209,17761,1776.1,1595,1980,0
8785,-645,-1495,1552.4,15524,17326,6.6,3,3,2,217,21.7,1,0,0,1,1,200,20.0,1,5,6,6,7.2,18821,16169,1616.9,1495,645,0
8786,-1174,-778,1547.3,15473,17556,6.8,7,7,4,195,19.5,0,0,0,1,0,221,22.1,0,5,6,6,7.2,18334,16647,1664.7,778,1174,1
8787,1179,-675,1803.4,18034,17170,6.8,10,10,10,211,21.1,0,0,1,0,0,222,22.2,0,11,9,9,7.0,17845,16855,1685.5,675,-1179,0
8788,1308,1296,1664.6,16646,17451,7.0,8,8,9,188,18.8,1,1,1,0,0,227,22.7,1,7,5,5,6.4,16155,15338,1533.8,-1296,-1308,1
8789,1340,1318,1818.5,18185,19320,7.0,10,10,7,213,21.3,1,1,1,0,0,216,21.6,0,4,7,7,6.8,18002,16845,1684.5,-1318,-1340,0
8790,-983,-1574,1576.1,15761,18094,7.0,3,3,3,239,23.9,0,0,1,0,1,218,21.8,1,11,6,6,7.2,19668,16744,1674.4,1574,983,0
8791,855,2880,1624.3,16243,19006,7.4,5,5,2,245,24.5,2,1,1,0,0,204,20.4,0,4,3,3,6.4,16126,15388,1538.8,-2880,-855,1
8792,3023,2115,1890.9,18909,18843,7.2,8,8,10,237,23.7,1,0,0,1,1,211,21.1,1,7,6,6,6.6,16728,15886,1588.6,-2115,-3023,0
8793,-426,-1055,1701.4,17014,17257,6.6,8,8,8,221,22.1,0,0,0,1,0,204,20.4,0,8,8,8,6.8,18312,17440,1744.0,1055,426,0
8794,1991,2474,1882.0,18820,19789,7.4,12,12,10,207,20.7,2,1,1,0,0,207,20.7,0,7,7,7,6.8,17315,16829,1682.9,-2474,-1991,1
8795,3149,1513,1825.7,18257,19371,7.0,8,8,7,246,24.6,1,1,1,0,0,227,22.7,0,1,4,4,6.8,17858,15108,1510.8,-1513,-3149,1
8796,-5214,-3160,1386.0,13860,16122,6.4,1,1,0,203,20.3,0,0,1,0,0,233,23.3,1,10,9,9,7.2,19282,19074,1907.4,3160,5214,0
8797,-763,395,1494.2,14942,17678,6.6,4,4,4,200,20.0,0,0,0,1,1,241,24.1,1,9,4,4,6.8,17283,15705,1570.5,-395,763,1
8798,-2129,-1542,1405.6,14056,16342,6.6,3,3,3,193,19.3,0,0,0,1,1,217,21.7,1,12,7,7,7.0,17884,16185,1618.5,1542,2129,0
8799,2361,2489,1853.4,18534,19784,7.2,11,11,10,208,20.8,1,1,0,1,0,233,23.3,0,6,4,4,6.8,17295,16173,1617.3,-2489,-2361,1
8800,-1209,-1556,1611.8,16118,17602,6.8,6,6,4,200,20.0,1,1,1,0,0,251,25.1,0,7,8,8,7.4,19158,17327,1732.7,1556,1209,0
8801,1046,815,1713.5,17135,19139,7.4,5,5,7,242,24.2,1,0,0,1,1,233,23.3,1,6,5,5,7.0,18324,16089,1608.9,-815,-1046,1
8802,-1809,-1431,1529.3,15293,17145,6.8,4,4,4,192,19.2,1,0,0,1,1,215,21.5,1,11,7,7,7.0,18576,17102,1710.2,1431,1809,0
8803,-2286,-3935,1555.5,15555,15866,6.4,5,5,5,200,20.0,0,0,1,0,1,220,22.0,1,7,9,9,7.6,19801,17841,1784.1,3935,2286,0
8804,3079,2098,1990.7,19907,20865,7.6,13,13,11,231,23.1,0,0,0,1,1,186,18.6,1,7,7,7,7.0,18767,16828,1682.8,-2098,-3079,1
8805,-3101,-2897,1559.3,15593,16199,6.8,4,4,4,204,20.4,1,1,0,1,0,223,22.3,0,8,10,10,7.0,19096,18694,1869.4,2897,3101,1
8806,713,851,1630.5,16305,18828,7.0,5,5,7,191,19.1,1,1,1,0,0,229,22.9,0,2,3,3,6.8,17977,15592,1559.2,-851,-713,1
8807,1108,19,1634.4,16344,19039,7.2,5,5,7,238,23.8,0,0,1,0,1,244,24.4,2,1,3,3,7.0,19020,15236,1523.6,-19,-1108,1
8808,4747,2924,1886.3,18863,19070,7.2,10,10,5,228,22.8,1,1,0,1,0,189,18.9,0,5,3,3,6.6,16146,14116,1411.6,-2924,-4747,1
8809,3160,2461,1826.6,18266,19333,7.2,10,10,11,239,23.9,1,1,1,0,0,206,20.6,0,6,4,4,6.8,16872,15106,1510.6,-2461,-3160,1
8810,-2377,-2338,1452.8,14528,16573,6.8,2,2,2,203,20.3,0,0,1,0,1,251,25.1,1,5,6,6,7.2,18911,16905,1690.5,2338,2377,0
8811,1254,-81,1713.1,17131,17701,6.6,7,7,6,229,22.9,1,0,1,0,1,199,19.9,1,3,6,6,6.8,17782,15877,1587.7,81,-1254,1
8812,5784,4755,1927.3,19273,18465,7.2,12,12,18,226,22.6,1,1,0,1,0,168,16.8,0,2,2,2,6.0,13710,13489,1348.9,-4755,-5784,1
8813,1019,1368,1555.5,15555,19127,7.2,4,4,1,254,25.4,0,0,0,1,1,217,21.7,1,2,2,2,7.0,17759,14536,1453.6,-1368,-1019,1
8814,2520,3200,1826.5,18265,19323,7.2,10,10,9,204,20.4,1,1,1,0,0,163,16.3,1,7,8,8,6.4,16123,15745,1574.5,-3200,-2520,1
8815,1184,848,1534.3,15343,17430,7.0,5,5,6,210,21.0,1,1,1,0,0,213,21.3,0,3,3,3,6.4,16582,14159,1415.9,-848,-1184,1
8816,4089,3372,1863.1,18631,19460,7.4,12,12,14,245,24.5,0,0,1,0,1,193,19.3,1,4,3,3,6.4,16088,14542,1454.2,-3372,-4089,1
8817,-1300,-1355,1724.5,17245,17559,6.8,8,8,9,207,20.7,0,0,1,0,1,244,24.4,1,8,8,8,7.0,18914,18545,1854.5,1355,1300,0
8818,32,-952,1767.0,17670,18217,7.0,9,9,7,201,20.1,0,0,1,0,0,247,24.7,0,9,8,8,7.4,19169,17638,1763.8,952,-32,1
8819,2690,236,1810.0,18100,18030,7.0,7,7,6,197,19.7,0,0,1,0,0,211,21.1,1,3,3,3,6.8,17794,15410,1541.0,-236,-2690,1
8820,2282,1265,1749.9,17499,18873,7.4,8,8,11,217,21.7,1,1,0,1,0,237,23.7,0,2,2,2,7.0,17608,15217,1521.7,-1265,-2282,1
8821,-896,-393,1694.0,16940,18041,7.0,9,9,11,191,19.1,1,1,1,0,0,235,23.5,0,8,8,8,7.0,18434,17836,1783.6,393,896,0
8822,2873,1850,1796.0,17960,17948,7.0,7,7,9,226,22.6,0,0,1,0,1,193,19.3,1,9,5,5,6.4,16098,15087,1508.7,-1850,-2873,1
8823,-1960,-709,1563.7,15637,16547,6.6,5,5,4,205,20.5,0,0,0,1,1,223,22.3,1,8,7,7,6.8,17256,17597,1759.7,709,1960,0
8824,2673,2723,1872.6,18726,20142,7.4,9,9,4,257,25.7,1,1,1,0,0,196,19.6,0,11,6,6,6.8,17419,16053,1605.3,-2723,-2673,1
8825,1091,1084,1724.4,17244,18750,7.2,6,6,11,221,22.1,0,0,1,0,1,235,23.5,2,12,6,6,6.8,17666,16153,1615.3,-1084,-1091,1
8826,-2755,-869,1503.8,15038,17122,6.8,5,5,2,194,19.4,1,1,0,1,0,218,21.8,0,11,9,9,6.8,17991,17793,1779.3,869,2755,1
8827,-905,-29,1749.0,17490,18680,7.2,8,8,8,198,19.8,0,0,0,1,1,196,19.6,1,12,10,10,7.2,18709,18395,1839.5,29,905,0
8828,-2046,-691,1597.0,15970,17608,6.8,7,7,4,196,19.6,0,0,0,1,0,226,22.6,0,10,10,10,7.0,18299,18016,1801.6,691,2046,0
8829,1527,1629,1643.5,16435,19956,7.4,4,4,3,250,25.0,1,1,0,1,0,228,22.8,0,0,1,1,7.0,18327,14908,1490.8,-1629,-1527,1
8830,1975,812,1756.2,17562,17442,6.6,9,9,8,203,20.3,0,0,0,1,1,208,20.8,1,5,5,5,6.6,16630,15587,1558.7,-812,-1975,1
8831,-1739,-838,1678.6,16786,16781,6.6,7,7,8,189,18.9,0,0,0,1,1,196,19.6,1,16,11,11,7.0,17619,18525,1852.5,838,1739,0
8832,4939,2073,1819.3,18193,18289,7.0,7,7,5,225,22.5,0,0,1,0,0,175,17.5,0,0,1,1,6.6,16216,13254,1325.4,-2073,-4939,0
8833,-717,-997,1606.1,16061,17642,7.0,4,4,2,230,23.0,0,0,1,0,1,236,23.6,1,8,7,7,7.0,18639,16778,1677.8,997,717,0
8834,-1567,505,1751.7,17517,19291,7.4,10,10,10,179,17.9,0,0,0,1,0,219,21.9,0,13,12,12,7.0,18786,19084,1908.4,-505,1567,0
8835,3650,2712,1769.6,17696,18389,7.2,7,7,12,223,22.3,1,1,1,0,0,237,23.7,0,1,1,1,6.2,15677,14046,1404.6,-2712,-3650,1
8836,-2930,136,1577.7,15777,17772,7.0,6,6,5,215,21.5,0,0,1,0,1,215,21.5,1,8,11,11,6.8,17636,18707,1870.7,-136,2930,0
8837,-5290,-3110,1449.4,14494,15666,6.6,5,5,3,181,18.1,0,0,0,1,1,192,19.2,1,14,17,17,7.2,18776,19784,1978.4,3110,5290,0
8838,2957,1677,1838.5,18385,19050,7.2,8,8,8,244,24.4,1,1,1,0,0,210,21.0,0,6,4,4,6.8,17373,15428,1542.8,-1677,-2957,0
8839,-66,815,1508.1,15081,17777,6.8,3,3,3,206,20.6,0,0,1,0,0,215,21.5,0,6,3,3,7.0,16962,15147,1514.7,-815,66,0
8840,1713,1391,1670.2,16702,17865,6.8,7,7,8,203,20.3,0,0,1,0,0,228,22.8,0,6,3,3,6.6,16474,14989,1498.9,-1391,-1713,1
8841,1784,1193,1748.1,17481,19040,7.4,6,6,5,248,24.8,1,0,0,1,1,216,21.6,1,3,4,4,7.0,17847,15697,1569.7,-1193,-1784,1
8842,214,1568,1644.5,16445,18995,7.0,7,7,7,224,22.4,0,0,1,0,0,215,21.5,0,5,6,6,6.8,17427,16231,1623.1,-1568,-214,1
8843,-3214,-2195,1438.7,14387,15777,6.4,5,5,4,158,15.8,0,0,0,1,1,226,22.6,2,10,7,7,7.0,17972,17601,1760.1,2195,3214,0
8844,4062,2618,1826.1,18261,19979,7.4,5,5,5,248,24.8,2,1,1,0,0,228,22.8,0,0,0,0,6.8,17361,14199,1419.9,-2618,-4062,1
8845,4296,3034,2015.1,20151,20475,7.4,11,11,6,261,26.1,2,1,1,0,0,173,17.3,0,9,5,5,6.8,17441,15855,1585.5,-3034,-4296,1
8846,319,1559,1623.2,16232,18631,7.0,7,7,7,200,20.0,1,0,1,0,1,224,22.4,1,4,5,5,6.8,17072,15913,1591.3,-1559,-319,1
8847,-2217,-715,1377.5,13775,17208,7.0,1,1,0,206,20.6,0,0,0,1,1,242,24.2,1,6,6,6,6.8,17923,15992,1599.2,715,2217,1
8848,-916,190,1477.1,14771,17669,6.8,3,3,4,234,23.4,1,1,0,1,0,242,24.2,0,5,3,3,6.8,17479,15687,1568.7,-190,916,0
8849,982,682,1553.8,15538,18222,6.8,2,2,2,264,26.4,1,0,1,0,1,258,25.8,1,1,1,1,6.8,17540,14556,1455.6,-682,-982,1
8850,993,425,1939.0,19390,18011,7.2,12,12,22,200,20.0,0,0,0,1,0,190,19.0,0,12,10,10,7.0,17586,18397,1839.7,-425,-993,0
8851,-912,-739,1647.4,16474,17494,6.8,6,6,8,209,20.9,1,1,0,1,0,244,24.4,1,12,6,6,7.0,18233,17386,1738.6,739,912,1
8852,4538,3583,1926.7,19267,20141,7.6,11,11,13,230,23.0,1,1,1,0,0,201,20.1,0,3,3,3,6.4,16558,14729,1472.9,-3583,-4538,1
8853,-1761,-226,1636.7,16367,17910,7.0,6,6,5,218,21.8,0,0,1,0,1,233,23.3,2,4,6,6,7.0,18136,18128,1812.8,226,1761,0
8854,-1826,-3,1606.6,16066,18218,6.8,7,7,8,195,19.5,1,0,0,1,1,183,18.3,1,11,9,9,7.0,18221,17892,1789.2,3,1826,1
8855,-1967,-1292,1479.0,14790,16619,6.4,3,3,3,217,21.7,0,0,0,1,1,204,20.4,1,11,8,8,7.0,17911,16757,1675.7,1292,1967,0
8856,-2984,-1466,1441.7,14417,17488,7.0,1,1,1,237,23.7,0,0,0,1,1,248,24.8,1,10,6,6,7.0,18954,17401,1740.1,1466,2984,0
8857,94,1896,1636.5,16365,18280,6.8,6,6,3,195,19.5,0,0,0,1,1,191,19.1,1,8,8,8,6.6,16384,16271,1627.1,-1896,-94,0
8858,-206,-363,1664.7,16647,17867,6.6,7,7,9,214,21.4,1,0,1,0,1,238,23.8,1,10,6,6,7.0,18230,16853,1685.3,363,206,1
8859,-2588,-497,1505.8,15058,17113,6.8,3,3,3,223,22.3,1,1,0,1,0,223,22.3,0,3,7,7,6.8,17610,17646,1764.6,497,2588,0
8860,5113,4028,2041.9,20419,20428,7.6,10,10,9,246,24.6,1,0,0,1,1,186,18.6,1,5,5,5,6.6,16400,15306,1530.6,-4028,-5113,0
8861,586,348,1622.4,16224,18284,6.8,5,5,6,254,25.4,1,1,1,0,0,245,24.5,0,3,3,3,6.8,17936,15638,1563.8,-348,-586,0
8862,-577,-2221,1633.8,16338,16019,6.4,8,8,9,191,19.1,1,1,1,0,0,204,20.4,0,5,6,6,7.2,18240,16915,1691.5,2221,577,0
8863,4380,3242,1955.7,19557,18070,7.0,10,10,7,191,19.1,2,1,1,0,0,184,18.4,0,4,2,2,6.0,14828,15177,1517.7,-3242,-4380,1
8864,-2858,-520,1412.5,14125,16758,6.6,4,4,1,170,17.0,0,0,0,1,1,224,22.4,1,9,7,7,7.0,17278,16983,1698.3,520,2858,0
8865,-712,977,1512.5,15125,17843,6.6,3,3,2,197,19.7,0,0,0,1,1,216,21.6,1,9,5,5,6.8,16866,15837,1583.7,-977,712,1
8866,-2526,-1811,1729.7,17297,18422,7.0,7,7,11,228,22.8,0,0,1,0,1,221,22.1,2,11,10,10,7.4,20233,19823,1982.3,1811,2526,0
8867,-222,17,1643.7,16437,16958,6.8,7,7,6,195,19.5,1,1,1,0,0,208,20.8,0,12,9,9,6.8,16941,16659,1665.9,-17,222,1
8868,-1544,-792,1568.9,15689,16026,6.6,5,5,5,187,18.7,0,0,0,1,1,180,18.0,1,6,7,7,6.6,16818,17233,1723.3,792,1544,1
8869,127,-941,1628.1,16281,17598,6.8,5,5,7,216,21.6,0,0,0,1,1,194,19.4,2,10,7,7,7.0,18539,16154,1615.4,941,-127,1
8870,1579,-171,1746.4,17464,18187,7.0,10,10,11,217,21.7,0,0,1,0,1,205,20.5,1,5,4,4,6.8,18358,15885,1588.5,171,-1579,1
8871,5201,1656,1997.8,19978,19500,7.4,9,9,8,251,25.1,1,0,1,0,1,179,17.9,1,2,4,4,7.0,17844,14777,1477.7,-1656,-5201,1
8872,3680,2530,1814.2,18142,18432,7.2,10,10,15,224,22.4,1,1,1,0,0,190,19.0,0,1,2,2,6.6,15902,14462,1446.2,-2530,-3680,1
8873,4941,3427,1837.5,18375,19454,7.2,8,8,6,222,22.2,2,1,1,0,0,200,20.0,0,2,1,1,6.6,16027,13434,1343.4,-3427,-4941,1
8874,479,350,1650.7,16507,18941,7.0,6,6,5,216,21.6,0,0,0,1,0,212,21.2,0,6,6,6,7.2,18591,16028,1602.8,-350,-479,1
8875,-1093,-1958,1498.8,14988,15830,6.4,3,3,6,214,21.4,1,1,0,1,0,237,23.7,0,4,4,4,6.8,17788,16081,1608.1,1958,1093,1
8876,2,-365,1620.3,16203,18321,7.0,5,5,4,228,22.8,1,1,0,1,0,228,22.8,0,6,5,5,7.0,18686,16201,1620.1,365,-2,0
8877,1958,2380,1652.2,16522,18641,7.0,5,5,5,236,23.6,0,0,0,1,0,195,19.5,0,5,4,4,6.6,16261,14564,1456.4,-2380,-1958,1
8878,1898,274,1830.6,18306,16973,6.6,12,12,11,214,21.4,0,0,1,0,1,197,19.7,1,10,7,7,6.4,16699,16408,1640.8,-274,-1898,0
8879,-81,-1466,1757.3,17573,17180,7.0,10,10,10,205,20.5,0,0,1,0,1,227,22.7,1,6,8,8,7.0,18646,17654,1765.4,1466,81,0
8880,3073,1928,1782.7,17827,19215,7.2,8,8,4,229,22.9,2,1,1,0,0,182,18.2,0,2,3,3,6.8,17287,14754,1475.4,-1928,-3073,1
8881,-320,-120,1618.2,16182,17560,7.0,5,5,3,204,20.4,1,1,1,0,0,195,19.5,0,11,9,9,7.0,17680,16502,1650.2,120,320,0
8882,-1069,-298,1530.9,15309,17455,6.8,3,3,3,245,24.5,1,1,0,1,0,241,24.1,0,5,5,5,6.8,17753,16378,1637.8,298,1069,0
8883,366,1230,1559.4,15594,17492,7.0,4,4,8,233,23.3,0,0,0,1,1,205,20.5,1,4,5,5,6.8,16262,15228,1522.8,-1230,-366,0
8884,1899,896,1834.0,18340,18533,7.0,10,10,12,201,20.1,0,0,1,0,0,198,19.8,0,9,9,9,6.8,17637,16441,1644.1,-896,-1899,1
8885,1389,490,1748.6,17486,17915,7.2,6,6,7,215,21.5,2,1,0,1,0,198,19.8,0,5,5,5,6.8,17425,16097,1609.7,-490,-1389,1
8886,-1165,729,1691.1,16911,17768,6.6,8,8,8,207,20.7,0,0,1,0,0,201,20.1,0,11,9,9,6.6,17039,18076,1807.6,-729,1165,1
8887,2002,301,1810.7,18107,18102,7.0,7,7,5,236,23.6,1,0,1,0,0,217,21.7,0,6,5,5,6.6,17801,16105,1610.5,-301,-2002,0
8888,-360,658,1664.9,16649,18909,7.2,7,7,4,230,23.0,0,0,0,1,0,203,20.3,0,13,9,9,6.8,18251,17009,1700.9,-658,360,0
8889,4100,4903,1832.2,18322,20963,7.4,9,9,7,258,25.8,0,0,1,0,0,204,20.4,0,1,3,3,6.4,16060,14222,1422.2,-4903,-4100,1
8890,629,-887,1736.6,17366,17609,6.8,9,9,6,213,21.3,1,1,1,0,0,223,22.3,0,4,5,5,7.0,18496,16737,1673.7,887,-629,0
8891,-1287,-746,1498.4,14984,18050,7.0,3,3,0,235,23.5,1,0,0,1,1,237,23.7,1,3,6,6,7.0,18796,16271,1627.1,746,1287,0
8892,3107,2132,1894.5,18945,18908,7.0,11,11,15,241,24.1,0,0,0,1,0,199,19.9,0,9,5,5,6.8,16776,15838,1583.8,-2132,-3107,1
8893,1051,1224,1785.1,17851,19947,7.4,8,8,6,257,25.7,0,0,0,1,1,247,24.7,1,4,5,5,7.2,18723,16800,1680.0,-1224,-1051,0
8894,-1920,-3055,1690.0,16900,16827,6.8,7,7,8,161,16.1,0,0,0,1,1,225,22.5,1,8,10,10,7.2,19882,18820,1882.0,3055,1920,0
8895,-1899,-2290,1492.3,14923,17661,7.0,3,3,4,229,22.9,0,0,0,1,0,244,24.4,0,4,4,4,7.2,19951,16822,1682.2,2290,1899,0
8896,-3951,-2608,1479.0,14790,16593,6.6,5,5,3,185,18.5,0,0,1,0,1,225,22.5,1,15,11,11,7.2,19201,18741,1874.1,2608,3951,0
8897,1977,1635,1803.5,18035,18668,7.0,7,7,7,250,25.0,0,0,1,0,0,183,18.3,0,13,6,6,6.8,17033,16058,1605.8,-1635,-1977,1
8898,577,1371,1719.3,17193,18554,7.4,6,6,7,257,25.7,1,1,1,0,0,228,22.8,0,8,7,7,6.8,17183,16616,1661.6,-1371,-577,1
8899,5452,4510,1953.6,19536,20584,7.6,13,13,11,217,21.7,0,0,1,0,0,178,17.8,0,3,3,3,6.4,16074,14084,1408.4,-4510,-5452,1
8900,1415,1951,1644.4,16444,18995,7.4,5,5,7,229,22.9,2,1,0,1,0,225,22.5,0,3,2,2,6.8,17044,15029,1502.9,-1951,-1415,0
8901,-7314,-6034,1317.7,13177,15610,6.2,1,1,2,177,17.7,0,0,0,1,1,258,25.8,1,13,11,11,7.8,21644,20491,2049.1,6034,7314,0
8902,2032,1193,1756.4,17564,15596,6.6,13,13,20,167,16.7,1,1,1,0,0,170,17.0,0,10,8,8,6.0,14403,15532,1553.2,-1193,-2032,1
8903,-1125,-1326,1728.1,17281,17509,7.0,10,10,12,203,20.3,1,1,1,0,0,229,22.9,1,6,8,8,7.0,18835,18406,1840.6,1326,1125,0
8904,-60,1347,1581.8,15818,17864,6.8,4,4,7,233,23.3,0,0,0,1,1,186,18.6,1,13,7,7,6.6,16517,15878,1587.8,-1347,60,0
8905,-1656,-1363,1620.8,16208,18110,7.0,5,5,8,218,21.8,0,0,0,1,1,242,24.2,1,7,7,7,7.2,19473,17864,1786.4,1363,1656,0
8906,507,510,1717.4,17174,18458,7.0,6,6,3,231,23.1,1,0,1,0,1,233,23.3,1,5,5,5,7.0,17948,16667,1666.7,-510,-507,0
8907,2536,746,1792.0,17920,18730,7.0,10,10,11,224,22.4,1,1,0,1,0,220,22.0,0,5,5,5,7.0,17984,15384,1538.4,-746,-2536,1
8908,-1019,-361,1588.2,15882,18675,7.2,6,6,5,198,19.8,1,1,0,1,0,240,24.0,0,5,7,7,7.0,19036,16901,1690.1,361,1019,1
8909,-1603,-809,1580.1,15801,17010,6.6,6,6,6,209,20.9,0,0,0,1,1,204,20.4,2,12,11,11,7.0,17819,17404,1740.4,809,1603,0
8910,3412,2086,1886.6,18866,19651,7.4,10,10,13,252,25.2,0,0,1,0,0,207,20.7,0,8,5,5,7.0,17565,15454,1545.4,-2086,-3412,0
8911,-1903,-2537,1405.6,14056,16260,6.6,1,1,1,223,22.3,2,1,1,0,0,231,23.1,0,3,4,4,7.0,18797,15959,1595.9,2537,1903,0
8912,-2266,-2047,1587.6,15876,17206,6.8,5,5,4,224,22.4,1,1,0,1,0,221,22.1,1,9,10,10,7.2,19253,18142,1814.2,2047,2266,0
8913,62,1348,1556.7,15567,18798,7.0,3,3,2,232,23.2,1,0,1,0,0,237,23.7,0,5,3,3,7.0,17450,15505,1550.5,-1348,-62,0
8914,-3456,-1429,1597.9,15979,16648,6.8,5,5,8,190,19.0,0,0,0,1,1,189,18.9,2,15,11,11,7.0,18077,19435,1943.5,1429,3456,0
8915,768,505,1639.8,16398,17974,6.6,6,6,4,236,23.6,1,1,0,1,0,218,21.8,0,5,5,5,7.0,17469,15630,1563.0,-505,-768,0
8916,-1050,89,1572.1,15721,18756,7.2,4,4,3,213,21.3,1,0,1,0,1,238,23.8,1,6,4,4,7.2,18667,16771,1677.1,-89,1050,0
8917,-3427,-1792,1420.6,14206,16793,6.6,2,2,1,200,20.0,0,0,0,1,1,253,25.3,1,7,8,8,7.0,18585,17633,1763.3,1792,3427,0
8918,6672,3761,2084.4,20844,18777,7.2,15,15,18,250,25.0,1,1,1,0,0,171,17.1,1,4,5,5,6.0,15016,14172,1417.2,-3761,-6672,1
8919,2087,2578,1742.8,17428,19729,7.2,8,8,9,220,22.0,1,1,1,0,0,229,22.9,0,2,3,3,6.8,17151,15341,1534.1,-2578,-2087,1
8920,2053,1126,1687.9,16879,18526,7.2,7,7,10,211,21.1,0,0,0,1,1,232,23.2,1,3,2,2,6.8,17400,14826,1482.6,-1126,-2053,1
8921,2394,-1292,1742.2,17422,17192,6.8,8,8,9,211,21.1,1,1,1,0,0,210,21.0,0,3,2,2,7.0,18484,15028,1502.8,1292,-2394,1
8922,-112,233,1525.5,15255,18312,7.0,3,3,3,228,22.8,0,0,0,1,0,234,23.4,0,3,3,3,7.0,18079,15367,1536.7,-233,112,0
8923,-1712,-394,1697.8,16978,19145,7.2,6,6,8,205,20.5,1,1,0,1,0,208,20.8,0,16,9,9,7.4,19539,18690,1869.0,394,1712,0
8924,-2550,-1985,1573.8,15738,16512,6.6,6,6,9,188,18.8,1,1,0,1,0,224,22.4,0,6,9,9,7.0,18497,18288,1828.8,1985,2550,0
8925,899,295,1707.9,17079,18150,7.0,9,9,8,203,20.3,0,0,0,1,1,225,22.5,1,7,6,6,7.0,17855,16180,1618.0,-295,-899,0
8926,-294,-1277,1476.1,14761,17655,7.0,1,1,1,230,23.0,0,0,1,0,0,193,19.3,0,4,4,4,7.2,18932,15055,1505.5,1277,294,1
8927,4999,3308,1972.4,19724,20621,7.8,12,12,10,263,26.3,1,1,1,0,0,148,14.8,1,4,4,4,6.6,17313,14725,1472.5,-3308,-4999,1
8928,2143,1315,1747.9,17479,19021,7.2,8,8,12,243,24.3,1,1,1,0,0,203,20.3,0,4,3,3,7.0,17706,15336,1533.6,-1315,-2143,0
8929,3175,1975,2034.4,20344,18646,7.0,16,16,17,193,19.3,2,1,0,1,0,162,16.2,0,11,10,10,6.6,16671,17169,1716.9,-1975,-3175,1
8930,-2506,-1979,1514.1,15141,18537,7.2,2,2,2,230,23.0,0,0,0,1,1,250,25.0,1,9,6,6,7.6,20516,17647,1764.7,1979,2506,0
8931,848,463,1579.3,15793,17950,6.8,4,4,5,246,24.6,0,0,0,1,1,210,21.0,1,3,3,3,7.0,17487,14945,1494.5,-463,-848,0
8932,-2026,-1235,1565.3,15653,16241,6.6,6,6,4,203,20.3,0,0,1,0,1,216,21.6,1,14,9,9,7.0,17476,17679,1767.9,1235,2026,1
8933,813,487,1583.6,15836,18174,7.0,5,5,4,223,22.3,1,1,1,0,0,219,21.9,0,3,3,3,6.8,17687,15023,1502.3,-487,-813,1
8934,-110,-1469,1467.3,14673,16034,6.4,4,4,4,183,18.3,0,0,1,0,1,214,21.4,2,3,2,2,6.8,17503,14783,1478.3,1469,110,1
8935,3134,1069,1827.0,18270,18656,7.0,10,10,11,249,24.9,0,0,1,0,1,217,21.7,1,1,4,4,7.0,17587,15136,1513.6,-1069,-3134,1
8936,965,1856,1936.2,19362,17316,6.6,13,13,19,195,19.5,0,0,1,0,0,180,18.0,1,20,12,12,6.4,15460,18397,1839.7,-1856,-965,0
8937,40,1340,1582.0,15820,17954,6.8,5,5,6,200,20.0,1,1,1,0,0,212,21.2,0,8,6,6,6.6,16614,15780,1578.0,-1340,-40,0
8938,961,-900,1658.3,16583,17825,6.8,5,5,5,219,21.9,1,1,1,0,0,234,23.4,1,2,3,3,7.0,18725,15622,1562.2,900,-961,1
8939,3958,3881,1855.8,18558,19625,7.2,9,9,6,269,26.9,1,1,1,0,0,194,19.4,1,4,3,3,6.4,15744,14600,1460.0,-3881,-3958,1
8940,1814,73,1747.7,17477,19006,7.0,6,6,7,232,23.2,0,0,1,0,1,210,21.0,1,4,4,4,7.0,18933,15663,1566.3,-73,-1814,1
8941,-3469,-1687,1493.5,14935,18365,7.0,3,3,2,198,19.8,0,0,1,0,1,263,26.3,2,9,7,7,7.2,20052,18404,1840.4,1687,3469,1
8942,3548,3559,1920.3,19203,20047,7.4,14,14,10,220,22.0,1,0,1,0,1,204,20.4,1,7,6,6,6.6,16488,15655,1565.5,-3559,-3548,1
8943,882,450,1670.1,16701,17820,6.8,6,6,3,237,23.7,0,0,1,0,0,192,19.2,0,5,6,6,6.8,17370,15819,1581.9,-450,-882,1
8944,1530,-1195,1752.9,17529,17038,6.8,13,13,19,138,13.8,1,0,1,0,1,243,24.3,1,2,3,3,6.8,18233,15999,1599.9,1195,-1530,0
8945,-3212,-1661,1526.4,15264,16327,6.4,4,4,5,208,20.8,0,0,0,1,0,217,21.7,0,10,8,8,7.0,17988,18476,1847.6,1661,3212,0
8946,1518,1874,1740.3,17403,19112,7.4,8,8,7,215,21.5,1,1,1,0,0,192,19.2,0,9,6,6,6.6,17238,15885,1588.5,-1874,-1518,0
8947,-1006,-1606,1550.0,15500,17374,6.8,4,4,2,218,21.8,1,0,1,0,1,221,22.1,1,5,6,6,7.2,18980,16506,1650.6,1606,1006,1
8948,-3117,-3799,1288.6,12886,14091,6.0,2,2,5,165,16.5,0,0,0,1,1,206,20.6,1,4,5,5,6.8,17890,16003,1600.3,3799,3117,0
8949,3170,2080,1778.0,17780,18440,7.2,6,6,7,221,22.1,1,1,1,0,0,213,21.3,0,4,3,3,6.4,16360,14610,1461.0,-2080,-3170,1
8950,-1822,-1467,1563.2,15632,18400,7.0,3,3,2,232,23.2,0,0,0,1,1,244,24.4,2,6,7,7,7.4,19867,17454,1745.4,1467,1822,1
8951,-726,-1249,1623.0,16230,17203,6.8,6,6,5,190,19.0,1,1,1,0,0,230,23.0,0,12,7,7,7.2,18452,16956,1695.6,1249,726,1
8952,1342,1886,1534.6,15346,18388,7.0,4,4,4,232,23.2,1,1,0,1,0,206,20.6,0,2,2,2,6.6,16502,14004,1400.4,-1886,-1342,1
8953,1464,925,1571.8,15718,17991,7.0,3,3,4,250,25.0,1,1,1,0,0,215,21.5,0,4,2,2,6.6,17066,14254,1425.4,-925,-1464,0
8954,2387,1411,1762.0,17620,19434,7.0,6,6,9,233,23.3,1,1,1,0,0,201,20.1,0,7,4,4,6.8,18023,15233,1523.3,-1411,-2387,1
8955,-4629,-3393,1495.8,14958,16993,6.8,4,4,4,207,20.7,0,0,0,1,1,239,23.9,1,16,13,13,7.4,20386,19587,1958.7,3393,4629,0
8956,-2846,-1964,1402.5,14025,16510,6.6,2,2,2,205,20.5,0,0,0,1,1,218,21.8,1,4,6,6,6.8,18474,16871,1687.1,1964,2846,0
8957,85,-706,1565.6,15656,17844,7.0,4,4,3,227,22.7,2,1,1,0,0,217,21.7,0,3,3,3,7.0,18550,15571,1557.1,706,-85,1
8958,-4473,-2976,1715.5,17155,16245,6.6,9,9,10,183,18.3,0,0,1,0,1,214,21.4,2,16,14,14,7.0,19221,21628,2162.8,2976,4473,0
8959,859,2681,1659.5,16595,18940,7.2,8,8,7,210,21.0,1,1,1,0,0,203,20.3,0,7,3,3,6.4,16259,15736,1573.6,-2681,-859,1
8960,-428,5,1728.3,17283,16810,6.6,9,9,13,205,20.5,1,1,1,0,0,213,21.3,1,7,8,8,6.6,16805,17711,1771.1,-5,428,1
8961,-4104,-3458,1538.8,15388,15598,6.4,5,5,9,179,17.9,0,0,0,1,0,264,26.4,0,8,8,8,7.2,19056,19492,1949.2,3458,4104,0
8962,354,248,1779.7,17797,17892,7.0,11,11,9,191,19.1,1,0,1,0,0,198,19.8,0,11,10,10,6.8,17644,17443,1744.3,-248,-354,0
8963,959,2183,1717.0,17170,18110,7.0,6,6,6,243,24.3,0,0,0,1,0,194,19.4,0,10,7,7,6.4,15927,16211,1621.1,-2183,-959,1
8964,1970,804,1672.9,16729,18725,7.0,4,4,5,227,22.7,0,0,1,0,0,228,22.8,0,2,2,2,6.8,17921,14759,1475.9,-804,-1970,1
8965,-618,-669,1742.4,17424,18146,7.2,8,8,6,224,22.4,0,0,1,0,0,223,22.3,0,8,9,9,7.0,18815,18042,1804.2,669,618,0
8966,106,-1098,1691.2,16912,17022,6.8,8,8,12,213,21.3,2,1,1,0,0,179,17.9,0,6,7,7,7.0,18120,16806,1680.6,1098,-106,0
8967,4146,3141,1942.6,19426,18749,6.8,12,12,18,218,21.8,1,0,1,0,1,191,19.1,1,8,6,6,6.4,15608,15280,1528.0,-3141,-4146,0
8968,39,-1075,1606.2,16062,17907,6.8,5,5,5,195,19.5,0,0,1,0,1,237,23.7,1,3,4,4,7.2,18982,16023,1602.3,1075,-39,0
8969,2367,1946,1744.0,17440,18208,7.0,7,7,4,197,19.7,1,0,0,1,1,178,17.8,1,3,4,4,6.6,16262,15073,1507.3,-1946,-2367,1
8970,-2111,-1607,1527.3,15273,16831,6.6,3,3,3,227,22.7,0,0,1,0,1,218,21.8,1,11,11,11,6.8,18438,17384,1738.4,1607,2111,0
8971,-528,1756,1657.1,16571,19112,7.2,5,5,5,212,21.2,0,0,0,1,1,210,21.0,2,7,6,6,6.6,17356,17099,1709.9,-1756,528,1
8972,4424,4969,1920.4,19204,20182,7.2,10,10,9,228,22.8,1,0,1,0,1,187,18.7,1,8,5,5,6.4,15213,14780,1478.0,-4969,-4424,1
8973,262,-414,1521.0,15210,17457,6.8,2,2,2,222,22.2,0,0,1,0,1,216,21.6,2,5,4,4,7.0,17871,14948,1494.8,414,-262,0
8974,777,576,1719.0,17190,17552,6.8,6,6,7,226,22.6,0,0,1,0,0,190,19.0,0,9,8,8,6.6,16976,16413,1641.3,-576,-777,0
8975,468,370,1683.9,16839,18230,7.0,6,6,4,222,22.2,0,0,0,1,1,211,21.1,1,8,6,6,6.8,17860,16371,1637.1,-370,-468,0
8976,-3408,-1490,1455.2,14552,16760,6.6,3,3,2,222,22.2,0,0,0,1,1,228,22.8,2,5,7,7,7.0,18250,17960,1796.0,1490,3408,0
8977,4424,2663,1935.9,19359,19182,7.2,10,10,13,243,24.3,1,1,0,1,0,189,18.9,0,5,4,4,6.8,16519,14935,1493.5,-2663,-4424,1
8978,-76,1720,1604.3,16043,18113,7.0,6,6,4,213,21.3,2,1,1,0,0,206,20.6,0,8,6,6,6.6,16393,16119,1611.9,-1720,76,1
8979,-5601,-4942,1572.3,15723,15978,6.4,5,5,4,196,19.6,0,0,0,1,1,210,21.0,1,22,16,16,7.6,20920,21324,2132.4,4942,5601,0
8980,870,703,1792.4,17924,18749,7.0,6,6,9,248,24.8,0,0,0,1,0,241,24.1,0,9,6,6,6.8,18046,17054,1705.4,-703,-870,0
8981,904,1043,1583.3,15833,18396,7.2,4,4,2,250,25.0,1,0,1,0,1,213,21.3,1,3,3,3,6.8,17353,14929,1492.9,-1043,-904,1
8982,1814,1762,1669.1,16691,19203,7.4,6,6,7,226,22.6,1,0,1,0,0,214,21.4,0,3,3,3,6.8,17441,14877,1487.7,-1762,-1814,1
8983,166,-436,1530.1,15301,18098,7.0,1,1,3,249,24.9,0,0,1,0,1,230,23.0,1,0,1,1,6.8,18534,15135,1513.5,436,-166,0
8984,-1211,-2257,1613.2,16132,17360,7.0,7,7,6,207,20.7,0,0,1,0,0,244,24.4,1,9,8,8,7.2,19617,17343,1734.3,2257,1211,0
8985,1941,846,1751.3,17513,18336,7.2,7,7,7,228,22.8,0,0,1,0,0,188,18.8,1,5,6,6,6.6,17490,15572,1557.2,-846,-1941,0
8986,990,1798,1710.8,17108,18548,7.0,7,7,9,230,23.0,1,1,0,1,0,218,21.8,0,6,6,6,6.6,16750,16118,1611.8,-1798,-990,1
8987,2614,2285,1717.8,17178,18411,7.0,6,6,8,234,23.4,2,1,0,1,0,170,17.0,0,2,5,5,6.4,16126,14564,1456.4,-2285,-2614,1
8988,-342,-2245,1451.1,14511,16462,6.6,3,3,3,212,21.2,0,0,0,1,1,212,21.2,1,1,4,4,7.4,18707,14853,1485.3,2245,342,0
8989,-6134,-4660,1319.9,13199,15949,6.2,1,1,1,173,17.3,1,0,0,1,0,255,25.5,0,13,11,11,7.6,20609,19333,1933.3,4660,6134,0
8990,-1661,-1259,1710.7,17107,17665,6.8,6,6,12,215,21.5,0,0,0,1,1,239,23.9,2,4,5,5,7.0,18924,18768,1876.8,1259,1661,1
8991,-6086,-3112,1473.1,14731,15155,6.2,6,6,3,154,15.4,0,0,0,1,0,237,23.7,0,20,16,16,7.0,18267,20817,2081.7,3112,6086,0
8992,-2601,-3694,1493.7,14937,16417,6.8,4,4,6,211,21.1,0,0,1,0,1,232,23.2,2,8,7,7,7.4,20111,17538,1753.8,3694,2601,0
8993,-3586,-2271,1334.0,13340,15466,6.2,1,1,1,223,22.3,0,0,0,1,1,189,18.9,1,16,10,10,6.8,17737,16926,1692.6,2271,3586,0
8994,3920,3302,1968.4,19684,20073,7.4,9,9,11,217,21.7,1,0,0,1,1,219,21.9,1,3,4,4,6.6,16771,15764,1576.4,-3302,-3920,1
8995,-1912,-2257,1546.1,15461,17683,6.8,2,2,2,206,20.6,0,0,0,1,1,243,24.3,2,7,7,7,7.2,19940,17373,1737.3,2257,1912,0
8996,203,411,1470.0,14700,17577,6.8,3,3,1,234,23.4,1,1,1,0,0,253,25.3,0,0,2,2,6.8,17166,14497,1449.7,-411,-203,1
8997,17,-403,1702.6,17026,18231,7.0,5,5,5,213,21.3,1,1,0,1,0,218,21.8,1,6,7,7,7.0,18634,17009,1700.9,403,-17,0
8998,1273,1061,1535.7,15357,17204,6.8,4,4,9,200,20.0,1,1,0,1,0,239,23.9,0,2,1,1,6.4,16143,14084,1408.4,-1061,-1273,1
8999,1023,19,1749.8,17498,17932,7.0,9,9,9,200,20.0,0,0,1,0,0,196,19.6,1,6,7,7,6.8,17913,16475,1647.5,-19,-1023,1
9000,-3371,-2094,1514.0,15140,15745,6.4,5,5,3,198,19.8,0,0,0,1,1,217,21.7,1,15,12,12,7.0,17839,18511,1851.1,2094,3371,0
9001,455,524,1639.8,16398,17450,7.0,5,5,7,218,21.8,1,1,0,1,0,184,18.4,0,10,5,5,6.6,16926,15943,1594.3,-524,-455,1
9002,891,1054,1697.2,16972,18007,7.0,8,8,7,184,18.4,1,1,1,0,0,196,19.6,0,7,7,7,6.6,16953,16081,1608.1,-1054,-891,1
9003,3361,3545,1777.7,17777,19414,7.4,9,9,5,238,23.8,0,0,1,0,0,208,20.8,0,1,2,2,6.4,15869,14416,1441.6,-3545,-3361,1
9004,2813,1222,1618.4,16184,18007,7.0,5,5,4,223,22.3,1,1,1,0,0,210,21.0,0,0,0,0,6.6,16785,13371,1337.1,-1222,-2813,1
9005,-3803,-4020,1408.5,14085,15408,6.4,2,2,2,220,22.0,0,0,0,1,1,245,24.5,2,4,9,9,7.2,19428,17888,1788.8,4020,3803,0
9006,-3179,-2574,1394.4,13944,15850,6.6,3,3,7,185,18.5,0,0,0,1,1,230,23.0,1,7,8,8,7.0,18424,17123,1712.3,2574,3179,0
9007,913,14,1673.0,16730,17875,7.0,5,5,9,246,24.6,1,0,0,1,0,205,20.5,0,6,5,5,6.8,17861,15817,1581.7,-14,-913,1
9008,-2328,-1153,1450.7,14507,16400,6.4,2,2,4,215,21.5,1,1,0,1,0,189,18.9,1,7,7,7,6.8,17553,16835,1683.5,1153,2328,0
9009,-3392,-2116,1432.7,14327,16104,6.6,4,4,6,194,19.4,0,0,0,1,1,223,22.3,1,7,8,8,6.8,18220,17719,1771.9,2116,3392,0
9010,171,1158,1704.8,17048,18361,7.0,8,8,8,230,23.0,1,1,0,1,0,185,18.5,0,10,10,10,6.8,17203,16877,1687.7,-1158,-171,0
9011,1119,-12,1610.3,16103,17909,7.0,4,4,4,238,23.8,0,0,1,0,0,245,24.5,0,0,2,2,6.8,17921,14984,1498.4,12,-1119,0
9012,-3036,-2088,1641.3,16413,18104,6.8,5,5,6,225,22.5,0,0,0,1,1,251,25.1,1,8,10,10,7.4,20192,19449,1944.9,2088,3036,1
9013,2195,554,1812.2,18122,19174,7.2,9,9,6,233,23.3,1,0,1,0,0,200,20.0,0,4,5,5,7.2,18620,15927,1592.7,-554,-2195,1
9014,-1030,-319,1716.6,17166,17136,6.8,11,11,11,165,16.5,0,0,0,1,0,203,20.3,1,8,13,13,6.6,17455,18196,1819.6,319,1030,1
9015,607,-1168,1507.9,15079,15930,6.6,3,3,5,212,21.2,1,0,1,0,1,210,21.0,1,5,3,3,6.8,17098,14472,1447.2,1168,-607,0
9016,2343,-1514,1876.6,18766,17630,6.8,8,8,6,216,21.6,1,0,1,0,1,202,20.2,1,13,7,7,7.2,19144,16423,1642.3,1514,-2343,1
9017,-4177,-2986,1380.2,13802,15735,6.4,1,1,3,212,21.2,0,0,1,0,1,247,24.7,1,9,8,8,7.0,18721,17979,1797.9,2986,4177,0
9018,1223,2123,1604.4,16044,18612,7.0,4,4,3,237,23.7,1,1,0,1,0,231,23.1,1,3,3,3,6.6,16489,14821,1482.1,-2123,-1223,1
9019,-6147,-1215,1453.5,14535,16907,6.6,2,2,3,195,19.5,0,0,0,1,1,189,18.9,2,21,14,14,7.0,18122,20682,2068.2,1215,6147,0
9020,-865,-480,1693.6,16936,16881,6.6,8,8,7,209,20.9,2,1,0,1,0,188,18.8,0,12,11,11,7.0,17361,17801,1780.1,480,865,0
9021,-974,-1306,1608.2,16082,17246,6.6,5,5,4,220,22.0,0,0,1,0,0,228,22.8,0,9,7,7,6.8,18552,17056,1705.6,1306,974,0
9022,3454,1882,1834.6,18346,18224,7.0,10,10,11,228,22.8,0,0,1,0,1,192,19.2,2,5,4,4,6.6,16342,14892,1489.2,-1882,-3454,1
9023,546,680,1943.7,19437,18500,7.0,16,16,16,188,18.8,2,1,0,1,0,191,19.1,0,10,13,13,7.0,17820,18891,1889.1,-680,-546,1
9024,-1580,358,1614.5,16145,19030,7.2,8,8,8,192,19.2,1,0,0,1,1,224,22.4,1,7,8,8,7.2,18672,17725,1772.5,-358,1580,0
9025,1825,996,1660.0,16600,18185,7.2,6,6,7,238,23.8,1,1,1,0,0,228,22.8,0,4,3,3,6.8,17189,14775,1477.5,-996,-1825,1
9026,901,144,1794.4,17944,17835,7.0,11,11,12,214,21.4,0,0,0,1,0,230,23.0,0,5,6,6,6.8,17691,17043,1704.3,-144,-901,0
9027,-3435,-1632,1443.9,14439,16062,6.4,5,5,3,171,17.1,0,0,0,1,1,230,23.0,1,6,7,7,6.8,17694,17874,1787.4,1632,3435,1
9028,-3688,-2808,1500.8,15008,17439,6.8,3,3,3,214,21.4,0,0,0,1,1,258,25.8,1,9,7,7,7.4,20247,18696,1869.6,2808,3688,1
9029,-1033,-104,1526.2,15262,17524,6.6,2,2,4,232,23.2,0,0,1,0,1,211,21.1,1,10,7,7,7.0,17628,16295,1629.5,104,1033,0
9030,1947,1867,1630.5,16305,18269,7.0,7,7,4,217,21.7,1,1,1,0,0,180,18.0,0,2,3,3,6.6,16402,14358,1435.8,-1867,-1947,1
9031,-4561,-5031,1390.8,13908,12798,5.4,3,3,4,167,16.7,0,0,1,0,1,187,18.7,1,20,13,13,7.0,17829,18469,1846.9,5031,4561,0
9032,3255,1724,1755.4,17554,19243,7.2,8,8,11,204,20.4,1,1,1,0,0,211,21.1,0,1,2,2,6.8,17519,14299,1429.9,-1724,-3255,0
9033,-3333,-2568,1554.3,15543,15357,6.4,7,7,8,193,19.3,0,0,0,1,0,234,23.4,0,12,10,10,7.0,17925,18876,1887.6,2568,3333,0
9034,3272,1914,1751.9,17519,19252,7.2,8,8,12,222,22.2,1,1,1,0,0,232,23.2,0,0,0,0,6.6,17338,14247,1424.7,-1914,-3272,1
9035,1655,2014,1778.8,17788,17625,7.0,11,11,11,178,17.8,2,1,1,0,0,195,19.5,0,12,7,7,6.4,15611,16133,1613.3,-2014,-1655,1
9036,-112,-198,1726.1,17261,17685,6.8,8,8,14,219,21.9,0,0,0,1,1,221,22.1,1,8,7,7,7.0,17883,17373,1737.3,198,112,1
9037,-220,67,1631.3,16313,17999,6.8,5,5,5,234,23.4,1,0,1,0,1,232,23.2,1,5,4,4,7.2,17932,16533,1653.3,-67,220,0
9038,-4538,-2876,1277.4,12774,15643,6.6,0,0,0,199,19.9,0,0,0,1,1,250,25.0,1,13,7,7,6.8,18519,17312,1731.2,2876,4538,0
9039,-1515,-4,1600.3,16003,18376,7.2,4,4,3,229,22.9,0,0,0,1,1,219,21.9,2,11,9,9,7.2,18380,17518,1751.8,4,1515,0
9040,-1851,-1875,1547.2,15472,17032,6.8,7,7,6,181,18.1,1,1,1,0,0,211,21.1,0,4,7,7,7.2,18907,17323,1732.3,1875,1851,0
9041,601,-303,1669.7,16697,19148,7.0,4,4,5,233,23.3,1,0,0,1,1,230,23.0,1,9,6,6,7.2,19451,16096,1609.6,303,-601,1
9042,878,460,1706.5,17065,18597,7.0,8,8,12,229,22.9,1,1,1,0,0,204,20.4,0,8,7,7,6.8,18137,16187,1618.7,-460,-878,1
9043,405,11,1537.4,15374,17614,7.0,4,4,5,221,22.1,0,0,0,1,0,205,20.5,0,3,4,4,6.8,17603,14969,1496.9,-11,-405,0
9044,1667,1183,1788.2,17882,17930,6.8,8,8,9,205,20.5,2,1,0,1,0,194,19.4,0,9,8,8,6.8,16747,16215,1621.5,-1183,-1667,1
9045,2197,1516,1780.3,17803,18782,7.0,5,5,5,242,24.2,0,0,1,0,0,228,22.8,0,8,5,5,6.8,17266,15606,1560.6,-1516,-2197,1
9046,-2775,-2872,1654.8,16548,17321,6.8,7,7,12,192,19.2,1,0,0,1,1,220,22.0,1,10,12,12,7.4,20193,19323,1932.3,2872,2775,0
9047,4483,3132,1943.3,19433,18610,7.0,14,14,9,213,21.3,1,1,1,0,0,176,17.6,0,5,5,5,6.4,15478,14950,1495.0,-3132,-4483,1
9048,1837,458,1779.0,17790,17688,6.8,8,8,7,190,19.0,1,1,1,0,0,176,17.6,1,4,4,4,6.8,17230,15953,1595.3,-458,-1837,1
9049,-2317,-1800,1471.9,14719,16802,6.6,4,4,7,200,20.0,1,1,1,0,0,194,19.4,1,10,10,10,7.0,18602,17036,1703.6,1800,2317,0
9050,-1517,-62,1641.8,16418,17424,6.8,7,7,3,199,19.9,0,0,0,1,1,211,21.1,1,14,10,10,6.8,17486,17935,1793.5,62,1517,0
9051,-418,-611,1656.6,16566,18441,7.2,5,5,9,216,21.6,0,0,0,1,1,208,20.8,1,4,7,7,7.2,19052,16984,1698.4,611,418,0
9052,5305,382,2035.6,20356,17899,7.0,9,9,13,225,22.5,1,0,1,0,1,184,18.4,1,10,5,5,7.0,17517,15051,1505.1,-382,-5305,1
9053,85,1243,1852.4,18524,18597,7.0,10,10,8,194,19.4,1,0,0,1,1,182,18.2,1,14,10,10,6.6,17354,18439,1843.9,-1243,-85,0
9054,2790,3073,1750.7,17507,19641,7.2,7,7,8,250,25.0,2,1,1,0,0,209,20.9,0,3,3,3,6.6,16568,14717,1471.7,-3073,-2790,1
9055,300,-568,1677.4,16774,18465,7.2,8,8,6,240,24.0,2,1,1,0,0,231,23.1,0,5,4,4,7.4,19033,16474,1647.4,568,-300,0
9056,-564,-298,1552.7,15527,18231,6.8,3,3,2,223,22.3,1,0,0,1,1,246,24.6,1,7,4,4,7.0,18529,16091,1609.1,298,564,0
9057,-3597,-2757,1415.4,14154,17350,6.8,2,2,1,206,20.6,1,0,0,1,1,243,24.3,1,5,8,8,7.2,20107,17751,1775.1,2757,3597,0
9058,-2003,-1370,1478.3,14783,18120,7.0,1,1,2,248,24.8,0,0,0,1,0,264,26.4,0,6,4,4,7.0,19490,16786,1678.6,1370,2003,1
9059,1263,590,1807.0,18070,19549,7.2,8,8,7,237,23.7,1,1,0,1,0,205,20.5,0,9,6,6,7.4,18959,16807,1680.7,-590,-1263,1
9060,-808,-266,1568.9,15689,17178,6.6,6,6,9,171,17.1,1,1,0,1,0,211,21.1,0,9,7,7,6.8,17444,16497,1649.7,266,808,0
9061,989,755,1709.0,17090,18470,7.2,9,9,10,216,21.6,1,1,1,0,0,213,21.3,0,5,6,6,6.8,17715,16101,1610.1,-755,-989,0
9062,-2527,-1697,1452.4,14524,16989,6.4,1,1,0,234,23.4,1,1,1,0,0,238,23.8,1,7,5,5,7.0,18686,17051,1705.1,1697,2527,0
9063,1559,131,1549.6,15496,16404,6.6,3,3,4,238,23.8,1,1,1,0,0,197,19.7,1,3,2,2,6.6,16273,13937,1393.7,-131,-1559,0
9064,2455,2080,1797.2,17972,19649,7.4,8,8,7,254,25.4,0,0,1,0,0,214,21.4,0,3,4,4,6.8,17569,15517,1551.7,-2080,-2455,1
9065,-2588,-1355,1512.4,15124,16323,6.6,4,4,5,185,18.5,0,0,0,1,0,217,21.7,0,9,8,8,6.8,17678,17712,1771.2,1355,2588,0
9066,992,-861,1678.4,16784,18335,7.2,4,4,7,267,26.7,0,0,1,0,1,224,22.4,1,5,4,4,7.2,19196,15792,1579.2,861,-992,1
9067,-3948,-4655,1415.7,14157,15002,6.0,4,4,3,158,15.8,1,0,0,1,1,243,24.3,1,5,13,13,7.4,19657,18105,1810.5,4655,3948,0
9068,3611,2136,1929.6,19296,18995,7.4,12,12,10,222,22.2,1,1,0,1,0,180,18.0,0,7,5,5,6.8,16859,15685,1568.5,-2136,-3611,1
9069,8151,5114,2213.4,22134,20809,7.6,15,15,23,234,23.4,1,1,1,0,0,176,17.6,0,6,4,4,6.2,15695,13983,1398.3,-5114,-8151,1
9070,2355,884,1873.4,18734,19093,7.2,13,13,12,187,18.7,0,0,0,1,1,200,20.0,1,8,9,9,6.8,18209,16379,1637.9,-884,-2355,1
9071,3410,2524,1791.4,17914,18528,7.0,7,7,6,240,24.0,1,1,1,0,0,187,18.7,0,7,4,4,6.4,16004,14504,1450.4,-2524,-3410,1
9072,1017,547,1789.2,17892,18432,7.0,10,10,12,197,19.7,0,0,0,1,1,201,20.1,1,7,7,7,7.0,17885,16875,1687.5,-547,-1017,1
9073,6763,6488,1996.9,19969,19752,7.2,13,13,13,255,25.5,1,0,0,1,0,192,19.2,0,2,2,2,5.8,13264,13206,1320.6,-6488,-6763,1
9074,-1497,-1252,1625.0,16250,17320,6.8,4,4,4,236,23.6,1,1,1,0,0,225,22.5,0,13,8,8,7.2,18572,17747,1774.7,1252,1497,0
9075,29,-1552,1585.0,15850,15600,6.2,5,5,7,210,21.0,1,1,1,0,0,222,22.2,0,8,6,6,6.6,17152,15821,1582.1,1552,-29,0
9076,1110,-225,1650.5,16505,18233,6.8,6,6,4,245,24.5,1,1,0,1,0,212,21.2,0,3,4,4,7.4,18458,15395,1539.5,225,-1110,0
9077,3447,1976,1874.1,18741,19102,7.2,9,9,16,243,24.3,1,0,1,0,1,210,21.0,1,6,3,3,6.8,17126,15294,1529.4,-1976,-3447,0
9078,-530,485,1705.1,17051,17619,7.0,8,8,10,208,20.8,0,0,0,1,1,191,19.1,1,9,10,10,6.8,17134,17581,1758.1,-485,530,0
9079,4798,5096,1893.6,18936,19738,7.2,10,10,12,253,25.3,1,1,1,0,0,176,17.6,0,5,5,5,6.0,14642,14138,1413.8,-5096,-4798,1
9080,-259,-576,1555.1,15551,15956,6.4,7,7,7,176,17.6,0,0,0,1,0,173,17.3,0,6,6,6,6.6,16532,15810,1581.0,576,259,0
9081,-411,374,1645.5,16455,18317,7.2,6,6,4,217,21.7,1,1,1,0,0,215,21.5,0,14,8,8,7.2,17943,16866,1686.6,-374,411,0
9082,-310,570,1735.7,17357,18388,7.0,10,10,12,191,19.1,1,1,1,0,0,194,19.4,1,9,8,8,7.2,17818,17667,1766.7,-570,310,0
9083,929,1008,1629.3,16293,18893,7.0,6,6,5,229,22.9,1,0,0,1,0,227,22.7,0,5,4,4,7.0,17885,15364,1536.4,-1008,-929,0
9084,1568,2039,1654.1,16541,17961,6.8,6,6,5,211,21.1,1,1,1,0,0,208,20.8,0,5,4,4,6.6,15922,14973,1497.3,-2039,-1568,1
9085,5099,2567,1947.7,19477,18390,7.2,9,9,11,224,22.4,0,0,1,0,1,176,17.6,1,3,4,4,6.2,15823,14378,1437.8,-2567,-5099,1
9086,-462,542,1633.1,16331,18927,7.2,4,4,5,246,24.6,1,1,0,1,0,273,27.3,0,8,5,5,6.8,18385,16793,1679.3,-542,462,1
9087,-3032,-1859,1611.5,16115,17647,7.0,7,7,4,193,19.3,0,0,0,1,0,243,24.3,0,7,12,12,7.2,19506,19147,1914.7,1859,3032,0
9088,-134,-146,1657.5,16575,18673,7.0,6,6,6,233,23.3,0,0,1,0,1,242,24.2,1,6,5,5,7.2,18819,16709,1670.9,146,134,0
9089,-106,-827,1516.1,15161,17135,6.6,5,5,5,174,17.4,0,0,1,0,1,207,20.7,1,5,5,5,6.8,17962,15267,1526.7,827,106,0
9090,-971,-1447,1509.7,15097,17461,7.0,3,3,6,226,22.6,2,1,0,1,0,253,25.3,0,2,2,2,7.2,18908,16068,1606.8,1447,971,0
9091,-594,-1344,1651.4,16514,17281,6.8,7,7,8,216,21.6,2,1,0,1,0,242,24.2,0,11,6,6,7.0,18625,17108,1710.8,1344,594,0
9092,5120,3137,1977.0,19770,19116,7.2,11,11,16,232,23.2,0,0,1,0,1,191,19.1,2,2,2,2,6.4,15979,14650,1465.0,-3137,-5120,1
9093,1963,781,1791.5,17915,19615,7.0,9,9,8,225,22.5,1,1,1,0,0,258,25.8,0,1,4,4,7.2,18834,15952,1595.2,-781,-1963,1
9094,296,1046,1645.0,16450,18742,7.2,5,5,4,222,22.2,0,0,0,1,1,220,22.0,2,8,5,5,7.0,17696,16154,1615.4,-1046,-296,1
9095,1201,695,1600.7,16007,17907,6.8,6,6,5,221,22.1,0,0,1,0,1,209,20.9,1,3,3,3,6.8,17212,14806,1480.6,-695,-1201,0
9096,334,145,1655.2,16552,18731,7.2,4,4,4,227,22.7,2,1,1,0,0,225,22.5,0,9,5,5,6.8,18586,16218,1621.8,-145,-334,0
9097,259,473,1575.0,15750,16898,6.8,5,5,4,216,21.6,0,0,0,1,0,200,20.0,0,6,5,5,6.6,16425,15491,1549.1,-473,-259,0
9098,3035,3792,1716.2,17162,20178,7.6,7,7,6,249,24.9,2,1,1,0,0,170,17.0,0,3,4,4,6.6,16386,14127,1412.7,-3792,-3035,1
9099,-1223,-1046,1774.3,17743,17923,7.0,10,10,9,194,19.4,2,1,0,1,0,198,19.8,0,10,13,13,7.2,18969,18966,1896.6,1046,1223,0
9100,625,-873,1552.7,15527,16705,6.4,5,5,5,185,18.5,1,1,1,0,0,226,22.6,0,2,4,4,7.0,17578,14902,1490.2,873,-625,0
9101,-2017,-659,1558.5,15585,18357,7.2,4,4,4,216,21.6,0,0,0,1,0,220,22.0,0,12,9,9,7.2,19016,17602,1760.2,659,2017,0
9102,2439,2360,1702.6,17026,18847,6.8,7,7,5,254,25.4,1,0,0,1,0,230,23.0,0,2,2,2,6.6,16487,14587,1458.7,-2360,-2439,1
9103,-549,-323,1614.9,16149,18253,7.0,6,6,7,217,21.7,1,1,1,0,0,233,23.3,0,5,5,5,6.8,18576,16698,1669.8,323,549,1
9104,-3675,-2454,1372.8,13728,17193,6.8,1,1,2,204,20.4,0,0,0,1,0,240,24.0,0,5,6,6,7.2,19647,17403,1740.3,2454,3675,0
9105,3034,1983,1800.3,18003,20207,7.4,8,8,7,248,24.8,1,1,0,1,0,211,21.1,0,2,3,3,7.0,18224,14969,1496.9,-1983,-3034,1
9106,787,-575,1649.7,16497,17789,7.0,7,7,10,201,20.1,1,1,1,0,0,232,23.2,0,2,6,6,7.0,18364,15710,1571.0,575,-787,1
9107,846,-28,1766.6,17666,17054,6.4,9,9,10,195,19.5,0,0,0,1,0,247,24.7,0,8,6,6,6.8,17082,16820,1682.0,28,-846,0
9108,-927,-200,1671.1,16711,17375,7.0,6,6,8,217,21.7,1,0,1,0,1,229,22.9,1,10,9,9,6.8,17575,17638,1763.8,200,927,1
9109,-599,-288,1541.4,15414,17454,6.8,5,5,5,208,20.8,1,1,1,0,0,218,21.8,0,5,6,6,6.8,17742,16013,1601.3,288,599,0
9110,1734,1173,1937.2,19372,18078,7.0,13,13,17,201,20.1,0,0,0,1,1,195,19.5,1,17,10,10,6.6,16905,17638,1763.8,-1173,-1734,0
9111,-5324,-2914,1520.7,15207,16955,6.6,4,4,6,213,21.3,0,0,0,1,1,205,20.5,2,12,12,12,7.2,19869,20531,2053.1,2914,5324,0
9112,-4552,-4208,1637.8,16378,16097,6.4,7,7,11,189,18.9,0,0,0,1,1,234,23.4,1,20,15,15,7.4,20305,20930,2093.0,4208,4552,1
9113,1828,2134,1668.3,16683,19168,7.2,7,7,9,223,22.3,1,1,1,0,0,224,22.4,0,4,2,2,6.8,17034,14855,1485.5,-2134,-1828,1
9114,324,2076,1721.5,17215,18989,7.0,7,7,7,256,25.6,1,0,0,1,0,234,23.4,0,13,7,7,6.6,16913,16891,1689.1,-2076,-324,1
9115,-1885,-210,1717.7,17177,18796,6.8,7,7,7,228,22.8,0,0,0,1,1,236,23.6,1,10,9,9,7.2,19006,19062,1906.2,210,1885,0
9116,724,241,1768.2,17682,17214,6.6,9,9,13,195,19.5,1,1,1,0,0,229,22.9,0,9,7,7,6.6,16973,16958,1695.8,-241,-724,0
9117,-645,426,1674.4,16744,19007,7.0,10,10,10,183,18.3,0,0,0,1,0,224,22.4,0,3,6,6,7.0,18581,17389,1738.9,-426,645,0
9118,2554,2046,1781.2,17812,19113,7.0,8,8,10,234,23.4,1,0,0,1,1,212,21.2,1,4,5,5,6.6,17067,15258,1525.8,-2046,-2554,0
9119,-1390,-446,1497.1,14971,17477,6.6,1,1,1,255,25.5,0,0,0,1,1,226,22.6,2,4,6,6,6.8,17923,16361,1636.1,446,1390,0
9120,-399,-1348,1743.2,17432,17080,7.0,7,7,13,200,20.0,1,1,0,1,0,203,20.3,0,11,9,9,7.0,18428,17831,1783.1,1348,399,0
9121,-85,1665,1534.1,15341,18065,6.8,3,3,3,215,21.5,1,0,0,1,1,202,20.2,1,9,5,5,6.6,16400,15426,1542.6,-1665,85,1
9122,4111,2823,1735.7,17357,19151,7.2,6,6,6,234,23.4,0,0,1,0,1,208,20.8,1,0,1,1,6.6,16328,13246,1324.6,-2823,-4111,1
9123,-1356,-501,1474.7,14747,18401,6.8,2,2,2,245,24.5,0,0,0,1,1,261,26.1,1,3,4,4,7.0,18902,16103,1610.3,501,1356,0
9124,71,-679,1536.8,15368,16039,6.4,6,6,9,169,16.9,1,1,0,1,0,198,19.8,0,2,5,5,6.4,16718,15297,1529.7,679,-71,0
9125,393,111,1593.1,15931,17840,7.0,5,5,5,231,23.1,1,1,1,0,0,255,25.5,0,3,2,2,6.8,17729,15538,1553.8,-111,-393,1
9126,809,645,1718.8,17188,17474,6.6,8,8,5,229,22.9,0,0,0,1,0,191,19.1,1,10,8,8,6.6,16829,16379,1637.9,-645,-809,0
9127,1126,549,1773.7,17737,18873,7.0,7,7,12,220,22.0,1,1,0,1,0,228,22.8,0,10,6,6,7.2,18324,16611,1661.1,-549,-1126,1
9128,-1243,-1261,1502.4,15024,17340,7.0,4,4,3,217,21.7,1,1,0,1,0,221,22.1,1,6,4,4,7.0,18601,16267,1626.7,1261,1243,1
9129,3745,1627,1965.9,19659,19474,7.2,12,12,11,241,24.1,1,0,0,1,0,230,23.0,0,6,5,5,7.0,17847,15914,1591.4,-1627,-3745,1
9130,1269,739,1756.2,17562,18086,6.8,8,8,8,203,20.3,1,0,1,0,1,199,19.9,1,9,7,7,6.8,17347,16293,1629.3,-739,-1269,0
9131,-4267,-2746,1452.7,14527,16646,6.4,3,3,5,221,22.1,1,1,0,1,0,238,23.8,1,8,8,8,7.2,19392,18794,1879.4,2746,4267,0
9132,-1749,-1247,1450.9,14509,16800,6.8,3,3,6,191,19.1,0,0,0,1,1,251,25.1,2,3,2,2,6.8,18047,16258,1625.8,1247,1749,0
9133,4128,3128,1865.0,18650,20053,7.4,9,9,8,234,23.4,1,0,1,0,0,243,24.3,0,2,2,2,6.6,16925,14522,1452.2,-3128,-4128,1
9134,656,-439,1581.8,15818,16786,6.6,7,7,8,205,20.5,0,0,1,0,0,200,20.0,0,3,4,4,6.8,17225,15162,1516.2,439,-656,1
9135,-1324,-615,1555.0,15550,17793,6.8,5,5,4,218,21.8,1,0,0,1,1,257,25.7,1,7,5,5,6.8,18408,16874,1687.4,615,1324,0
9136,791,1064,1665.5,16655,18948,7.2,7,7,9,208,20.8,0,0,1,0,1,212,21.2,2,6,5,5,6.8,17884,15864,1586.4,-1064,-791,0
9137,-3075,-244,1479.0,14790,18612,6.8,2,2,2,223,22.3,0,0,0,1,1,266,26.6,1,7,6,6,7.0,18856,17865,1786.5,244,3075,1
9138,2864,3193,1775.5,17755,19403,7.2,7,7,10,254,25.4,0,0,1,0,0,221,22.1,0,3,3,3,6.4,16210,14891,1489.1,-3193,-2864,1
9139,2038,1029,1797.3,17973,17436,7.0,8,8,7,223,22.3,2,1,1,0,0,207,20.7,0,6,5,5,6.4,16407,15935,1593.5,-1029,-2038,1
9140,-2061,-2046,1456.6,14566,16031,6.4,5,5,10,182,18.2,1,0,1,0,1,200,20.0,1,7,6,6,7.0,18077,16627,1662.7,2046,2061,0
9141,544,-289,1598.3,15983,17134,6.8,5,5,8,219,21.9,1,1,1,0,0,218,21.8,0,6,4,4,6.8,17423,15439,1543.9,289,-544,1
9142,-693,-919,1565.5,15655,17386,6.8,6,6,4,203,20.3,1,1,0,1,0,234,23.4,0,5,5,5,7.0,18305,16348,1634.8,919,693,0
9143,3047,1616,1784.0,17840,18356,6.8,8,8,7,233,23.3,0,0,1,0,1,229,22.9,1,3,3,3,6.6,16740,14793,1479.3,-1616,-3047,1
9144,-599,192,1601.8,16018,18223,7.2,4,4,3,215,21.5,2,1,1,0,0,242,24.2,0,10,5,5,6.8,18031,16617,1661.7,-192,599,0
9145,-3247,-3783,1371.9,13719,15044,6.4,1,1,1,213,21.3,0,0,0,1,1,237,23.7,2,5,6,6,7.2,18827,16966,1696.6,3783,3247,1
9146,1703,1809,1763.3,17633,18808,7.2,9,9,9,206,20.6,0,0,0,1,0,210,21.0,0,7,6,6,6.8,16999,15930,1593.0,-1809,-1703,1
9147,1189,-821,1755.2,17552,16611,6.8,6,6,12,201,20.1,0,0,1,0,0,191,19.1,1,5,6,6,6.8,17432,16363,1636.3,821,-1189,1
9148,3424,1464,2023.6,20236,18074,6.8,16,16,14,203,20.3,1,1,1,0,0,169,16.9,0,6,7,7,6.6,16610,16812,1681.2,-1464,-3424,1
9149,-2564,-1959,1455.8,14558,17024,6.8,2,2,4,206,20.6,1,1,0,1,0,222,22.2,1,8,7,7,7.2,18983,17122,1712.2,1959,2564,1
9150,-401,-439,1508.0,15080,18378,7.0,4,4,3,208,20.8,1,1,0,1,0,232,23.2,0,3,3,3,7.4,18817,15481,1548.1,439,401,0
9151,6703,5604,1962.1,19621,19733,7.6,10,10,12,209,20.9,1,0,1,0,0,140,14.0,0,2,2,2,5.8,14129,12918,1291.8,-5604,-6703,1
9152,24,-286,1597.0,15970,18425,7.0,3,3,3,245,24.5,0,0,0,1,0,249,24.9,0,1,5,5,6.8,18711,15946,1594.6,286,-24,1
9153,-460,935,1558.1,15581,18725,7.0,4,4,2,239,23.9,1,1,0,1,0,223,22.3,1,4,5,5,7.0,17790,16041,1604.1,-935,460,0
9154,6968,4379,2127.8,21278,20007,7.4,13,13,14,253,25.3,0,0,1,0,1,185,18.5,1,2,3,3,6.6,15628,14310,1431.0,-4379,-6968,1
9155,1963,804,1735.2,17352,18631,6.8,6,6,8,257,25.7,1,1,1,0,0,210,21.0,0,7,3,3,6.8,17827,15389,1538.9,-804,-1963,1
9156,-1041,-1114,1528.9,15289,16623,7.0,4,4,6,210,21.0,1,0,1,0,1,196,19.6,1,5,7,7,6.8,17737,16330,1633.0,1114,1041,1
9157,2979,1183,1781.9,17819,19319,7.2,7,7,6,236,23.6,1,0,1,0,1,223,22.3,1,1,2,2,7.0,18136,14840,1484.0,-1183,-2979,1
9158,1489,604,1672.3,16723,17883,7.0,7,7,9,233,23.3,1,0,1,0,0,228,22.8,0,3,3,3,7.0,17279,15234,1523.4,-604,-1489,1
9159,2374,1332,1785.7,17857,19272,7.2,8,8,11,239,23.9,1,1,1,0,0,239,23.9,0,3,4,4,7.0,17940,15483,1548.3,-1332,-2374,0
9160,1523,-576,1694.0,16940,16731,6.8,7,7,10,232,23.2,1,0,1,0,1,185,18.5,1,6,5,5,6.8,17307,15417,1541.7,576,-1523,0
9161,977,1247,1705.9,17059,18302,7.0,9,9,9,214,21.4,1,1,0,1,0,203,20.3,0,5,6,6,6.6,17055,16082,1608.2,-1247,-977,0
9162,-416,-1639,1559.3,15593,17750,6.6,4,4,5,225,22.5,0,0,1,0,1,221,22.1,1,6,6,6,7.2,19389,16009,1600.9,1639,416,0
9163,519,1436,1707.4,17074,18861,7.2,6,6,12,242,24.2,0,0,0,1,1,232,23.2,1,7,5,5,6.6,17425,16555,1655.5,-1436,-519,1
9164,59,-305,1646.6,16466,16798,6.8,7,7,4,185,18.5,0,0,1,0,1,210,21.0,2,10,6,6,7.0,17103,16407,1640.7,305,-59,1
9165,4305,2244,1908.2,19082,18970,7.2,12,12,11,226,22.6,2,1,0,1,0,216,21.6,0,2,3,3,6.6,16726,14777,1477.7,-2244,-4305,1
9166,-33,-998,1696.1,16961,17778,6.8,6,6,8,238,23.8,1,1,1,0,0,213,21.3,1,4,6,6,7.0,18776,16994,1699.4,998,33,1
9167,874,-554,1686.4,16864,18195,7.0,5,5,4,247,24.7,0,0,1,0,1,232,23.2,2,5,5,5,7.2,18749,15990,1599.0,554,-874,0
9168,-2824,-2021,1498.8,14988,16513,6.6,5,5,6,200,20.0,0,0,0,1,0,222,22.2,0,10,9,9,6.8,18534,17812,1781.2,2021,2824,0
9169,845,1049,1888.6,18886,18539,7.2,13,13,13,188,18.8,0,0,0,1,0,214,21.4,0,7,10,10,7.0,17490,18041,1804.1,-1049,-845,1
9170,-713,-897,1522.3,15223,17348,6.8,2,2,6,213,21.3,0,0,1,0,0,228,22.8,0,3,6,6,6.8,18245,15936,1593.6,897,713,1
9171,402,890,1594.7,15947,18280,7.0,5,5,6,219,21.9,2,1,0,1,0,237,23.7,0,3,3,3,7.0,17390,15545,1554.5,-890,-402,1
9172,-2485,-1570,1447.3,14473,17358,6.8,4,4,1,185,18.5,0,0,1,0,1,263,26.3,1,2,5,5,7.2,18928,16958,1695.8,1570,2485,0
9173,1746,2273,1721.4,17214,19173,7.0,7,7,5,235,23.5,1,1,1,0,0,205,20.5,0,6,4,4,6.8,16900,15468,1546.8,-2273,-1746,0
9174,-4152,-1948,1451.5,14515,16542,6.6,3,3,6,175,17.5,0,0,0,1,1,253,25.3,1,14,9,9,7.0,18490,18667,1866.7,1948,4152,0
9175,-1846,-1362,1546.3,15463,16652,6.8,7,7,8,161,16.1,1,1,0,1,0,194,19.4,1,3,6,6,7.0,18014,17309,1730.9,1362,1846,0
9176,-4481,-1530,1503.2,15032,16564,6.6,4,4,7,203,20.3,0,0,0,1,1,245,24.5,1,19,10,10,7.0,18094,19513,1951.3,1530,4481,0
9177,-4686,-2937,1497.9,14979,16961,6.6,4,4,4,194,19.4,0,0,0,1,1,208,20.8,1,13,13,13,7.4,19898,19665,1966.5,2937,4686,0
9178,-1336,-1242,1386.3,13863,17182,6.8,1,1,2,219,21.9,0,0,0,1,1,226,22.6,1,1,2,2,7.0,18424,15199,1519.9,1242,1336,0
9179,2112,2566,1573.6,15736,18522,7.2,4,4,7,216,21.6,0,0,1,0,1,197,19.7,1,2,1,1,6.6,15956,13624,1362.4,-2566,-2112,1
9180,455,-1138,1597.8,15978,17338,6.8,5,5,5,225,22.5,0,0,1,0,0,191,19.1,0,7,6,6,7.0,18476,15523,1552.3,1138,-455,0
9181,2746,1975,1840.0,18400,18909,7.2,9,9,10,221,22.1,0,0,1,0,1,164,16.4,1,10,7,7,6.6,16934,15654,1565.4,-1975,-2746,0
9182,-4673,-1225,1557.3,15573,18078,6.8,6,6,6,194,19.4,2,1,0,1,0,246,24.6,0,10,10,10,7.2,19303,20246,2024.6,1225,4673,0
9183,-1949,-1983,1552.0,15520,17369,7.0,4,4,7,207,20.7,1,1,0,1,0,230,23.0,1,10,6,6,7.2,19352,17469,1746.9,1983,1949,0
9184,-4081,-1994,1336.7,13367,15834,6.4,2,2,3,157,15.7,0,0,1,0,1,216,21.6,1,11,9,9,7.2,17828,17448,1744.8,1994,4081,0
9185,2159,2100,1768.7,17687,18625,6.8,10,10,7,213,21.3,1,1,0,1,0,180,18.0,0,5,5,5,6.8,16525,15528,1552.8,-2100,-2159,1
9186,16,-639,1766.3,17663,16879,6.6,11,11,8,193,19.3,0,0,0,1,1,227,22.7,2,6,8,8,7.0,17518,17647,1764.7,639,-16,1
9187,-1701,-771,1610.8,16108,16262,6.4,6,6,5,211,21.1,0,0,0,1,0,190,19.0,0,16,10,10,6.8,17033,17809,1780.9,771,1701,0
9188,-780,-1068,1469.7,14697,16968,6.6,3,3,5,229,22.9,1,1,0,1,0,236,23.6,1,3,3,3,7.0,18036,15477,1547.7,1068,780,1
9189,-2793,83,1510.6,15106,17323,7.0,5,5,4,200,20.0,0,0,0,1,0,215,21.5,1,12,9,9,6.8,17240,17899,1789.9,-83,2793,0
9190,1426,524,1617.5,16175,16320,6.6,7,7,12,202,20.2,0,0,1,0,0,204,20.4,0,2,3,3,6.6,15796,14749,1474.9,-524,-1426,0
9191,1876,1668,1878.7,18787,18529,7.0,10,10,10,231,23.1,1,1,1,0,0,203,20.3,0,10,8,8,6.8,16861,16911,1691.1,-1668,-1876,1
9192,2338,1009,1746.0,17460,17575,7.0,9,9,10,217,21.7,0,0,0,1,0,192,19.2,1,3,3,3,6.6,16566,15122,1512.2,-1009,-2338,1
9193,606,533,1683.5,16835,17752,6.8,9,9,5,200,20.0,1,0,0,1,0,211,21.1,0,6,5,5,6.8,17219,16229,1622.9,-533,-606,0
9194,-780,63,1735.1,17351,16649,6.6,8,8,11,204,20.4,2,1,0,1,0,193,19.3,0,14,10,10,6.8,16586,18131,1813.1,-63,780,0
9195,1211,751,1641.2,16412,17900,7.0,6,6,4,235,23.5,0,0,1,0,1,249,24.9,1,2,2,2,6.6,17149,15201,1520.1,-751,-1211,1
9196,-1964,-963,1504.0,15040,18066,6.8,5,5,8,197,19.7,1,0,0,1,0,260,26.0,0,4,4,4,7.2,19029,17004,1700.4,963,1964,1
9197,1006,1171,1629.3,16293,17793,6.8,5,5,3,218,21.8,0,0,0,1,1,207,20.7,1,5,4,4,6.6,16622,15287,1528.7,-1171,-1006,0
9198,444,1056,1624.9,16249,18007,6.8,6,6,5,221,22.1,1,1,0,1,0,213,21.3,1,4,4,4,7.0,16951,15805,1580.5,-1056,-444,0
9199,-961,-725,1531.2,15312,18210,7.0,2,2,2,250,25.0,1,1,0,1,0,250,25.0,0,3,4,4,7.2,18935,16273,1627.3,725,961,1
9200,1804,1547,1643.2,16432,18560,7.0,6,6,6,240,24.0,1,1,1,0,0,200,20.0,0,3,3,3,6.8,17013,14628,1462.8,-1547,-1804,1
9201,2696,3081,1812.2,18122,20449,7.4,8,8,10,247,24.7,2,1,1,0,0,222,22.2,0,3,3,3,6.8,17368,15426,1542.6,-3081,-2696,1
9202,-605,-782,1622.3,16223,17056,6.8,6,6,7,196,19.6,0,0,0,1,1,203,20.3,1,7,9,9,7.0,17838,16828,1682.8,782,605,0
9203,-1114,-417,1632.6,16326,17923,6.8,6,6,7,236,23.6,1,1,0,1,0,241,24.1,0,12,8,8,7.0,18340,17440,1744.0,417,1114,0
9204,-1958,-1775,1356.1,13561,16518,6.6,0,0,0,220,22.0,0,0,0,1,1,223,22.3,1,4,5,5,7.0,18293,15519,1551.9,1775,1958,0
9205,-453,659,1589.7,15897,18131,6.8,5,5,3,219,21.9,0,0,0,1,1,188,18.8,1,10,6,6,7.0,17472,16350,1635.0,-659,453,1
9206,-1205,-1042,1600.5,16005,17346,6.6,6,6,6,188,18.8,1,0,0,1,1,232,23.2,1,6,8,8,7.2,18388,17210,1721.0,1042,1205,0
9207,-393,-2719,1590.7,15907,16474,6.6,5,5,6,211,21.1,1,1,1,0,0,211,21.1,0,9,6,6,7.0,19193,16300,1630.0,2719,393,0
9208,3422,1091,1744.0,17440,18112,7.0,9,9,12,213,21.3,0,0,1,0,0,216,21.6,0,1,2,2,6.8,17021,14018,1401.8,-1091,-3422,0
9209,-3234,-2889,1425.7,14257,17053,6.6,1,1,2,230,23.0,0,0,0,1,0,247,24.7,0,9,5,5,7.2,19942,17491,1749.1,2889,3234,0
9210,-4307,-2260,1572.3,15723,15809,6.4,7,7,11,159,15.9,0,0,0,1,0,253,25.3,1,13,10,10,7.0,18069,20030,2003.0,2260,4307,0
9211,-3264,-1507,1481.7,14817,16953,6.4,2,2,1,212,21.2,0,0,0,1,1,211,21.1,1,11,10,10,7.0,18460,18081,1808.1,1507,3264,0
9212,-388,-1004,1471.3,14713,17547,7.0,0,0,0,261,26.1,0,0,0,1,1,264,26.4,1,1,1,1,7.0,18551,15101,1510.1,1004,388,0
9213,52,554,1631.9,16319,17353,6.6,6,6,11,214,21.4,0,0,0,1,0,235,23.5,1,6,6,6,6.6,16799,16267,1626.7,-554,-52,0
9214,1058,527,1829.4,18294,18581,7.4,10,10,14,204,20.4,1,1,0,1,0,210,21.0,0,12,8,8,7.0,18054,17236,1723.6,-527,-1058,0
9215,-3505,-1473,1441.5,14415,17890,6.8,3,3,2,213,21.3,0,0,0,1,1,226,22.6,1,9,7,7,7.2,19363,17920,1792.0,1473,3505,0
9216,2031,1004,1763.4,17634,16665,6.6,10,10,17,193,19.3,0,0,1,0,0,196,19.6,0,6,6,6,6.4,15661,15603,1560.3,-1004,-2031,0
9217,2436,2608,1706.2,17062,20216,7.2,6,6,7,235,23.5,1,1,0,1,0,203,20.3,1,3,2,2,7.0,17608,14626,1462.6,-2608,-2436,1
9218,1769,2294,1909.8,19098,18390,7.0,12,12,20,230,23.0,0,0,1,0,1,166,16.6,1,14,9,9,6.4,16096,17329,1732.9,-2294,-1769,0
9219,-1133,-714,1723.7,17237,18392,7.0,8,8,8,213,21.3,0,0,1,0,1,196,19.6,1,12,12,12,7.4,19106,18370,1837.0,714,1133,0
9220,1864,1877,1809.3,18093,18871,7.4,10,10,8,222,22.2,0,0,1,0,1,189,18.9,1,7,6,6,6.6,16994,16229,1622.9,-1877,-1864,1
9221,273,-1195,1627.6,16276,17546,6.6,7,7,9,215,21.5,0,0,1,0,0,196,19.6,1,2,7,7,7.2,18741,16003,1600.3,1195,-273,0
9222,1450,763,1647.1,16471,17952,6.8,6,6,6,246,24.6,0,0,1,0,0,200,20.0,0,3,5,5,6.8,17189,15021,1502.1,-763,-1450,1
9223,-4370,-4504,1524.6,15246,15419,6.4,6,6,5,151,15.1,0,0,1,0,1,235,23.5,1,12,11,11,7.2,19923,19616,1961.6,4504,4370,0
9224,3761,1269,1865.6,18656,19071,7.2,8,8,10,229,22.9,1,0,0,1,0,241,24.1,0,2,2,2,6.6,17802,14895,1489.5,-1269,-3761,1
9225,1341,-85,1695.1,16951,18681,7.2,5,5,5,270,27.0,2,1,1,0,0,254,25.4,0,1,1,1,7.2,18766,15610,1561.0,85,-1341,1
9226,1299,8,1783.0,17830,18550,7.0,7,7,8,214,21.4,0,0,0,1,1,217,21.7,2,4,5,5,7.2,18542,16531,1653.1,-8,-1299,1
9227,-2107,-1458,1688.6,16886,16618,6.6,11,11,13,172,17.2,0,0,1,0,1,189,18.9,1,8,8,8,7.2,18076,18993,1899.3,1458,2107,0
9228,385,-1446,1612.2,16122,17673,6.8,4,4,5,223,22.3,1,1,1,0,0,240,24.0,1,2,3,3,7.2,19119,15737,1573.7,1446,-385,0
9229,4507,2090,1936.7,19367,19595,7.2,7,7,7,259,25.9,0,0,1,0,1,202,20.2,1,2,6,6,6.8,17505,14860,1486.0,-2090,-4507,1
9230,6790,4889,2002.7,20027,19439,7.2,9,9,8,257,25.7,1,0,1,0,1,165,16.5,1,4,2,2,6.2,14550,13237,1323.7,-4889,-6790,1
9231,1680,473,1978.4,19784,18582,7.0,12,12,16,241,24.1,1,0,1,0,0,197,19.7,0,16,10,10,7.0,18109,18104,1810.4,-473,-1680,0
9232,-769,891,1511.8,15118,18628,7.2,3,3,3,222,22.2,1,1,0,1,0,208,20.8,1,9,5,5,7.0,17737,15887,1588.7,-891,769,1
9233,2254,1870,1619.5,16195,17940,7.0,6,6,6,214,21.4,0,0,1,0,0,193,19.3,0,1,3,3,6.2,16070,13941,1394.1,-1870,-2254,1
9234,699,753,1542.3,15423,18333,6.8,2,2,2,227,22.7,0,0,0,1,1,232,23.2,1,3,2,2,6.8,17580,14724,1472.4,-753,-699,1
9235,3242,2227,1817.4,18174,18815,7.0,9,9,8,232,23.2,0,0,1,0,1,191,19.1,1,7,5,5,6.8,16588,14932,1493.2,-2227,-3242,0
9236,1535,220,1664.9,16649,17555,7.0,7,7,6,212,21.2,0,0,1,0,1,222,22.2,2,4,4,4,7.0,17335,15114,1511.4,-220,-1535,1
9237,-141,222,1681.8,16818,16998,6.6,9,9,9,208,20.8,0,0,1,0,1,164,16.4,1,11,8,8,6.8,16776,16959,1695.9,-222,141,1
9238,-3567,-1828,1582.9,15829,17626,6.8,5,5,8,236,23.6,0,0,0,1,1,234,23.4,2,11,10,10,7.2,19454,19396,1939.6,1828,3567,0
9239,-557,625,1560.4,15604,18013,7.0,3,3,3,227,22.7,0,0,0,1,1,216,21.6,2,6,4,4,6.8,17388,16161,1616.1,-625,557,0
9240,-2597,-1718,1492.7,14927,16195,6.4,4,4,3,195,19.5,0,0,0,1,1,221,22.1,1,10,11,11,7.0,17913,17524,1752.4,1718,2597,1
9241,-820,-575,1624.7,16247,17790,6.8,5,5,4,189,18.9,0,0,1,0,1,222,22.2,1,6,7,7,7.0,18365,17067,1706.7,575,820,1
9242,4235,3837,2007.0,20070,20194,7.2,14,14,11,211,21.1,1,1,1,0,0,188,18.8,0,8,5,5,6.6,16357,15835,1583.5,-3837,-4235,1
9243,180,-192,1616.6,16166,17990,7.0,5,5,6,198,19.8,0,0,1,0,1,212,21.2,1,2,4,4,7.0,18182,15986,1598.6,192,-180,0
9244,-1092,-324,1563.0,15630,18378,7.0,3,3,2,254,25.4,0,0,0,1,0,264,26.4,0,7,5,5,7.0,18702,16722,1672.2,324,1092,0
9245,2858,1988,1874.4,18744,18677,6.8,8,8,11,210,21.0,1,1,1,0,0,174,17.4,0,7,7,7,6.8,16689,15886,1588.6,-1988,-2858,1
9246,-2234,-1264,1581.5,15815,18120,7.0,5,5,4,202,20.2,0,0,1,0,1,258,25.8,2,8,9,9,7.4,19384,18049,1804.9,1264,2234,0
9247,-766,-577,1624.6,16246,17593,7.0,6,6,6,193,19.3,0,0,1,0,1,204,20.4,1,9,7,7,7.2,18170,17012,1701.2,577,766,1
9248,-662,-951,1570.1,15701,17899,7.0,5,5,4,212,21.2,0,0,1,0,1,243,24.3,2,3,6,6,7.0,18850,16363,1636.3,951,662,0
9249,-2370,-2104,1602.4,16024,17294,7.0,8,8,5,212,21.2,0,0,0,1,1,194,19.4,1,10,12,12,7.4,19398,18394,1839.4,2104,2370,0
9250,-4311,-2532,1553.9,15539,17438,6.8,6,6,2,202,20.2,0,0,1,0,1,234,23.4,1,14,13,13,7.4,19970,19850,1985.0,2532,4311,0
9251,4090,2523,1903.8,19038,20256,7.4,11,11,8,252,25.2,1,1,1,0,0,214,21.4,0,3,2,2,7.0,17733,14948,1494.8,-2523,-4090,1
9252,-2828,-1814,1449.2,14492,16087,6.4,5,5,10,176,17.6,1,1,1,0,0,217,21.7,1,4,7,7,6.6,17901,17320,1732.0,1814,2828,1
9253,-1810,-2661,1519.3,15193,17054,6.8,3,3,6,232,23.2,0,0,1,0,1,235,23.5,1,2,8,8,7.0,19715,17003,1700.3,2661,1810,0
9254,-4968,-4165,1336.2,13362,15531,6.4,4,4,0,155,15.5,0,0,1,0,1,240,24.0,1,4,8,8,7.2,19696,18330,1833.0,4165,4968,0
9255,-196,-282,1483.2,14832,17330,7.0,1,1,1,228,22.8,1,1,1,0,0,226,22.6,0,4,3,3,7.0,17612,15028,1502.8,282,196,1
9256,2946,1011,1766.4,17664,17554,7.0,9,9,12,221,22.1,1,1,1,0,0,236,23.6,0,4,2,2,6.6,16543,14718,1471.8,-1011,-2946,1
9257,307,2085,1704.6,17046,19783,7.4,6,6,8,217,21.7,1,1,0,1,0,256,25.6,0,7,7,7,7.0,17698,16739,1673.9,-2085,-307,1
9258,1916,632,1598.4,15984,18306,6.8,3,3,3,261,26.1,0,0,1,0,0,224,22.4,0,0,0,0,6.8,17674,14068,1406.8,-632,-1916,0
9259,1212,77,1874.8,18748,17354,6.8,12,12,18,195,19.5,0,0,1,0,1,193,19.3,1,8,9,9,7.0,17277,17536,1753.6,-77,-1212,1
9260,1901,1126,1673.3,16733,19698,7.2,5,5,6,231,23.1,0,0,1,0,1,239,23.9,2,1,1,1,7.0,18572,14832,1483.2,-1126,-1901,1
9261,-4032,-2866,1541.7,15417,15374,6.4,6,6,12,154,15.4,1,1,0,1,0,232,23.2,0,11,12,12,7.0,18240,19449,1944.9,2866,4032,0
9262,2617,1172,1830.2,18302,18149,7.2,10,10,7,215,21.5,1,1,1,0,0,178,17.8,1,4,6,6,6.8,16977,15685,1568.5,-1172,-2617,0
9263,-251,560,1547.1,15471,18349,6.8,3,3,2,219,21.9,0,0,0,1,0,255,25.5,0,7,3,3,7.0,17789,15722,1572.2,-560,251,1
9264,1094,287,1661.2,16612,17712,6.8,6,6,11,218,21.8,1,1,1,0,0,221,22.1,0,4,4,4,6.8,17425,15518,1551.8,-287,-1094,1
9265,1235,1010,1660.1,16601,18618,7.0,6,6,3,242,24.2,0,0,1,0,0,201,20.1,0,5,4,4,6.8,17608,15366,1536.6,-1010,-1235,1
9266,5302,3045,1815.9,18159,16870,6.6,9,9,13,217,21.7,2,1,1,0,0,147,14.7,0,2,1,1,6.0,13825,12857,1285.7,-3045,-5302,1
9267,-5426,-3115,1469.0,14690,15168,6.4,5,5,9,188,18.8,0,0,0,1,1,245,24.5,1,9,7,7,7.0,18283,20116,2011.6,3115,5426,0
9268,2609,681,1696.3,16963,18341,7.0,9,9,9,245,24.5,0,0,1,0,1,209,20.9,1,2,3,3,7.0,17660,14354,1435.4,-681,-2609,1
9269,-89,-953,1611.6,16116,16953,6.8,5,5,4,233,23.3,0,0,1,0,1,213,21.3,1,3,8,8,6.8,17906,16205,1620.5,953,89,0
9270,-3588,-1795,1534.1,15341,15896,6.4,5,5,5,188,18.8,0,0,0,1,1,230,23.0,1,13,12,12,6.6,17691,18929,1892.9,1795,3588,0
9271,-2115,-2872,1417.7,14177,15427,6.4,2,2,2,196,19.6,0,0,0,1,1,200,20.0,1,18,8,8,7.0,18299,16292,1629.2,2872,2115,0
9272,1589,-197,1730.8,17308,18538,7.2,7,7,11,213,21.3,0,0,1,0,1,232,23.2,2,1,4,4,7.0,18735,15719,1571.9,197,-1589,0
9273,628,-558,1575.8,15758,16906,6.4,4,4,5,211,21.1,0,0,1,0,1,205,20.5,1,9,5,5,6.8,17464,15130,1513.0,558,-628,0
9274,-604,-1254,1727.5,17275,16684,6.8,8,8,14,204,20.4,1,1,1,0,0,186,18.6,0,16,10,10,7.0,17938,17879,1787.9,1254,604,0
9275,-1861,-1195,1650.5,16505,17778,6.6,7,7,4,206,20.6,1,1,1,0,0,221,22.1,0,11,10,10,7.0,18973,18366,1836.6,1195,1861,0
9276,2774,1134,1809.3,18093,18506,7.2,8,8,13,238,23.8,0,0,1,0,1,230,23.0,1,3,3,3,6.8,17372,15319,1531.9,-1134,-2774,0
9277,-1323,-1025,1593.9,15939,16482,6.6,7,7,5,205,20.5,0,0,0,1,0,167,16.7,0,6,9,9,6.8,17507,17262,1726.2,1025,1323,0
9278,-832,541,1445.7,14457,18824,7.0,0,0,0,230,23.0,1,1,0,1,0,267,26.7,0,1,1,1,7.0,18283,15289,1528.9,-541,832,0
9279,5418,3077,2092.0,20920,19263,7.2,11,11,12,243,24.3,1,0,0,1,0,173,17.3,0,8,5,5,6.8,16186,15502,1550.2,-3077,-5418,1
9280,3060,2469,1668.8,16688,19162,7.2,7,7,8,233,23.3,0,0,1,0,1,222,22.2,1,0,0,0,6.8,16693,13628,1362.8,-2469,-3060,1
9281,-2304,31,1487.3,14873,17781,6.8,2,2,1,205,20.5,0,0,0,1,1,238,23.8,1,9,7,7,7.0,17750,17177,1717.7,-31,2304,0
9282,-1396,-92,1525.9,15259,17666,7.0,4,4,4,214,21.4,0,0,0,1,1,250,25.0,1,7,7,7,6.6,17758,16655,1665.5,92,1396,0
9283,3738,4262,1809.6,18096,19349,7.2,10,10,9,242,24.2,1,1,1,0,0,198,19.8,0,4,3,3,6.4,15087,14358,1435.8,-4262,-3738,1
9284,1184,-80,1615.3,16153,17913,6.8,5,5,5,227,22.7,1,0,1,0,1,208,20.8,1,3,3,3,7.0,17993,14969,1496.9,80,-1184,1
9285,2346,751,1903.6,19036,19444,7.2,7,7,10,248,24.8,1,0,1,0,1,197,19.7,1,14,9,9,7.4,18693,16690,1669.0,-751,-2346,1
9286,-275,-739,1778.8,17788,17829,6.8,10,10,12,159,15.9,0,0,0,1,0,212,21.2,0,7,11,11,7.0,18568,18063,1806.3,739,275,0
9287,1558,785,1653.2,16532,18420,7.2,8,8,6,229,22.9,0,0,1,0,0,206,20.6,1,2,3,3,7.0,17635,14974,1497.4,-785,-1558,1
9288,-750,-276,1574.2,15742,17970,7.0,3,3,4,214,21.4,0,0,1,0,1,232,23.2,1,6,6,6,7.2,18246,16492,1649.2,276,750,0
9289,1479,2350,1596.0,15960,18912,7.4,4,4,0,253,25.3,0,0,1,0,0,228,22.8,0,3,3,3,6.4,16562,14481,1448.1,-2350,-1479,1
9290,-1850,-1016,1613.2,16132,18331,6.8,6,6,6,199,19.9,0,0,0,1,1,243,24.3,1,9,8,8,7.4,19347,17982,1798.2,1016,1850,0
9291,620,874,1735.0,17350,18836,7.2,9,9,10,202,20.2,0,0,1,0,0,211,21.1,0,8,8,8,6.6,17962,16730,1673.0,-874,-620,0
9292,-3866,-1987,1387.5,13875,16394,6.6,3,3,2,209,20.9,0,0,0,1,1,227,22.7,1,10,8,8,7.2,18381,17741,1774.1,1987,3866,0
9293,1089,33,1496.9,14969,17547,6.8,1,1,1,252,25.2,1,0,0,1,0,212,21.2,0,0,1,1,6.8,17514,13880,1388.0,-33,-1089,1
9294,827,1271,1719.5,17195,18590,7.2,9,9,6,178,17.8,2,1,0,1,0,201,20.1,0,7,7,7,6.8,17319,16368,1636.8,-1271,-827,1
9295,-1374,-1041,1534.7,15347,17655,7.0,4,4,3,234,23.4,0,0,1,0,1,238,23.8,2,7,5,5,6.8,18696,16721,1672.1,1041,1374,0
9296,3943,4243,1829.0,18290,20250,7.6,10,10,13,248,24.8,1,1,0,1,0,200,20.0,0,4,3,3,6.4,16007,14347,1434.7,-4243,-3943,1
9297,543,1065,1617.6,16176,18728,7.2,5,5,5,221,22.1,1,0,0,1,0,257,25.7,0,4,3,3,6.8,17663,15633,1563.3,-1065,-543,0
9298,-1106,-1434,1614.8,16148,15943,6.8,6,6,7,200,20.0,1,1,1,0,0,216,21.6,1,9,6,6,6.6,17377,17254,1725.4,1434,1106,0
9299,-1011,-309,1561.2,15612,18702,7.0,3,3,4,214,21.4,2,1,1,0,0,239,23.9,0,6,4,4,7.2,19011,16623,1662.3,309,1011,1
9300,1039,589,1610.4,16104,17890,7.0,5,5,7,231,23.1,1,0,0,1,1,205,20.5,1,3,4,4,6.8,17301,15065,1506.5,-589,-1039,1
9301,-3616,-3352,1537.2,15372,16833,6.8,8,8,8,161,16.1,0,0,0,1,1,248,24.8,1,4,9,9,7.6,20185,18988,1898.8,3352,3616,0
9302,217,709,1569.4,15694,18453,6.8,4,4,5,242,24.2,0,0,0,1,1,214,21.4,1,4,4,4,7.0,17744,15477,1547.7,-709,-217,0
9303,1641,1439,1757.8,17578,18250,7.2,9,9,11,209,20.9,1,0,0,1,0,175,17.5,0,10,7,7,7.0,16811,15937,1593.7,-1439,-1641,1
9304,1990,-86,1843.6,18436,18039,7.0,10,10,11,209,20.9,1,1,1,0,0,226,22.6,1,4,5,5,6.8,18125,16446,1644.6,86,-1990,1
9305,273,255,1662.0,16620,18824,7.2,7,7,7,211,21.1,1,0,1,0,1,226,22.6,1,7,4,4,7.0,18569,16347,1634.7,-255,-273,0
9306,1994,2643,1641.9,16419,19317,7.0,5,5,4,248,24.8,2,1,1,0,0,238,23.8,0,3,2,2,6.6,16674,14425,1442.5,-2643,-1994,0
9307,759,2511,1638.4,16384,19826,7.4,5,5,5,229,22.9,0,0,0,1,1,205,20.5,1,7,5,5,6.6,17315,15625,1562.5,-2511,-759,1
9308,-2105,-1066,1533.0,15330,18294,7.0,3,3,3,230,23.0,1,0,0,1,1,225,22.5,1,8,8,8,7.2,19360,17435,1743.5,1066,2105,0
9309,4319,2388,1900.8,19008,19021,7.2,10,10,18,239,23.9,2,1,1,0,0,240,24.0,0,2,1,1,6.6,16633,14689,1468.9,-2388,-4319,1
9310,428,374,1623.8,16238,18854,7.0,5,5,7,260,26.0,0,0,0,1,0,232,23.2,1,1,2,2,7.2,18480,15810,1581.0,-374,-428,0
9311,956,1998,1609.4,16094,17711,6.8,5,5,7,219,21.9,0,0,0,1,0,183,18.3,0,4,4,4,6.6,15713,15138,1513.8,-1998,-956,1
9312,-5206,-1622,1509.9,15099,17734,6.8,5,5,5,156,15.6,0,0,0,1,0,226,22.6,0,8,14,14,7.0,19356,20305,2030.5,1622,5206,0
9313,-5891,-3716,1414.3,14143,16647,6.6,2,2,0,183,18.3,0,0,0,1,1,264,26.4,2,7,10,10,7.4,20363,20034,2003.4,3716,5891,0
9314,-4413,-3109,1438.5,14385,15780,6.4,3,3,4,195,19.5,1,1,0,1,0,234,23.4,1,12,10,10,7.0,18889,18798,1879.8,3109,4413,0
9315,-1680,-1155,1472.5,14725,17291,6.8,3,3,6,204,20.4,0,0,0,1,1,258,25.8,2,3,4,4,7.4,18446,16405,1640.5,1155,1680,0
9316,192,-656,1654.3,16543,18558,7.0,6,6,7,245,24.5,0,0,0,1,1,245,24.5,1,7,5,5,7.2,19214,16351,1635.1,656,-192,0
9317,-1183,-182,1450.5,14505,18139,6.8,2,2,4,230,23.0,0,0,0,1,1,253,25.3,1,4,3,3,7.0,18321,15688,1568.8,182,1183,0
9318,1403,389,1668.1,16681,18270,7.0,7,7,5,265,26.5,0,0,1,0,0,224,22.4,0,5,4,4,7.0,17881,15278,1527.8,-389,-1403,0
9319,-151,-895,1584.4,15844,16801,6.8,6,6,11,197,19.7,0,0,1,0,1,205,20.5,2,5,7,7,6.8,17696,15995,1599.5,895,151,0
9320,380,-245,1584.3,15843,17530,7.0,5,5,7,233,23.3,0,0,1,0,1,221,22.1,1,5,5,5,7.0,17775,15463,1546.3,245,-380,1
9321,3453,1775,1791.3,17913,19102,7.4,9,9,12,218,21.8,1,1,1,0,0,215,21.5,0,2,2,2,6.8,17327,14460,1446.0,-1775,-3453,1
9322,-3443,-1347,1505.7,15057,17267,6.8,3,3,4,218,21.8,0,0,0,1,1,219,21.9,1,10,6,6,7.2,18614,18500,1850.0,1347,3443,0
9323,-2167,-2045,1463.0,14630,16527,6.6,5,5,5,177,17.7,0,0,1,0,1,214,21.4,1,10,9,9,7.0,18572,16797,1679.7,2045,2167,1
9324,152,-722,1615.6,16156,17794,6.8,4,4,4,260,26.0,0,0,1,0,0,249,24.9,0,3,4,4,7.0,18516,16004,1600.4,722,-152,1
9325,-3059,-2718,1335.2,13352,16455,6.6,2,2,1,188,18.8,1,1,0,1,0,252,25.2,1,3,5,5,7.0,19173,16411,1641.1,2718,3059,0
9326,-236,711,1604.2,16042,17865,7.0,4,4,4,240,24.0,1,1,1,0,0,241,24.1,0,8,5,5,6.8,17154,16278,1627.8,-711,236,0
9327,-2178,-1407,1542.0,15420,16996,6.8,5,5,5,176,17.6,1,0,0,1,1,219,21.9,1,7,8,8,7.0,18403,17598,1759.8,1407,2178,1
9328,-1267,427,1508.0,15080,17979,6.8,2,2,0,262,26.2,0,0,0,1,1,255,25.5,2,6,5,5,7.0,17552,16347,1634.7,-427,1267,0
9329,-1035,582,1576.6,15766,18750,7.0,4,4,5,232,23.2,1,1,0,1,0,202,20.2,0,7,7,7,7.0,18168,16801,1680.1,-582,1035,1
9330,4639,3197,2063.9,20639,18457,7.2,11,11,16,207,20.7,1,0,1,0,1,159,15.9,1,10,8,8,6.2,15260,16000,1600.0,-3197,-4639,1
9331,-5508,-3648,1334.5,13345,15982,6.6,0,0,0,230,23.0,0,0,0,1,1,235,23.5,1,10,9,9,7.2,19630,18853,1885.3,3648,5508,0
9332,2370,3795,1771.2,17712,19043,7.0,10,10,9,207,20.7,1,1,0,1,0,186,18.6,0,6,7,7,6.4,15248,15342,1534.2,-3795,-2370,1
9333,3992,2506,1886.6,18866,18926,7.0,11,11,13,225,22.5,1,1,1,0,0,189,18.9,0,3,4,4,6.4,16420,14874,1487.4,-2506,-3992,1
9334,2739,1170,1903.5,19035,19997,7.4,11,11,11,232,23.2,1,1,1,0,0,268,26.8,1,5,4,4,7.2,18827,16296,1629.6,-1170,-2739,1
9335,-2513,-2247,1529.2,15292,17170,6.8,3,3,3,223,22.3,0,0,0,1,1,231,23.1,1,8,9,9,7.2,19417,17805,1780.5,2247,2513,1
9336,1389,894,1508.2,15082,17854,6.8,1,1,1,239,23.9,0,0,1,0,1,209,20.9,1,0,1,1,6.4,16960,13693,1369.3,-894,-1389,1
9337,-1492,-1925,1581.8,15818,16894,6.6,6,6,7,162,16.2,0,0,0,1,1,214,21.4,1,5,8,8,7.2,18819,17310,1731.0,1925,1492,1
9338,-139,-652,1814.5,18145,18705,7.2,11,11,10,211,21.1,1,0,1,0,1,236,23.6,1,8,10,10,7.2,19357,18284,1828.4,652,139,0
9339,943,505,1593.4,15934,18258,7.0,5,5,2,251,25.1,0,0,1,0,1,231,23.1,1,2,3,3,7.0,17753,14991,1499.1,-505,-943,1
9340,2425,824,1784.6,17846,18097,7.0,8,8,12,192,19.2,1,1,1,0,0,215,21.5,1,4,5,5,6.8,17273,15421,1542.1,-824,-2425,1
9341,1128,-45,1702.5,17025,17699,6.8,6,6,9,207,20.7,1,0,1,0,1,226,22.6,1,4,5,5,7.0,17744,15897,1589.7,45,-1128,1
9342,1380,1402,1759.8,17598,18935,7.2,11,11,9,225,22.5,2,1,0,1,0,192,19.2,0,8,8,8,6.8,17533,16218,1621.8,-1402,-1380,0
9343,688,415,1622.0,16220,18251,7.0,4,4,2,239,23.9,1,0,1,0,1,221,22.1,1,4,3,3,7.0,17836,15532,1553.2,-415,-688,0
9344,2933,1905,1839.5,18395,16701,6.6,11,11,13,206,20.6,1,1,0,1,0,167,16.7,0,6,6,6,6.2,14796,15462,1546.2,-1905,-2933,0
9345,-2467,-1494,1572.7,15727,15909,6.2,6,6,4,171,17.1,1,0,0,1,0,202,20.2,0,13,12,12,7.0,17403,18194,1819.4,1494,2467,0
9346,755,436,1583.2,15832,18431,7.2,4,4,3,257,25.7,0,0,0,1,1,217,21.7,2,4,3,3,7.0,17995,15077,1507.7,-436,-755,1
9347,4378,3157,1854.9,18549,19419,7.2,10,10,12,203,20.3,1,1,1,0,0,214,21.4,0,2,2,2,6.6,16262,14171,1417.1,-3157,-4378,1
9348,-1302,-90,1658.9,16589,17707,6.8,8,8,5,221,22.1,1,1,1,0,0,207,20.7,0,14,10,10,7.0,17797,17891,1789.1,90,1302,0
9349,-145,850,1494.5,14945,17524,6.8,5,5,4,168,16.8,0,0,1,0,1,233,23.3,1,2,2,2,6.6,16674,15090,1509.0,-850,145,1
9350,4305,3750,1927.9,19279,19873,7.6,9,9,6,230,23.0,1,0,1,0,1,182,18.2,1,4,4,4,6.4,16123,14974,1497.4,-3750,-4305,1
9351,-3162,-23,1587.1,15871,16394,6.6,5,5,5,200,20.0,0,0,0,1,0,195,19.5,0,15,11,11,6.4,16417,19033,1903.3,23,3162,1
9352,1726,-196,1879.0,18790,18604,7.2,8,8,7,224,22.4,2,1,0,1,0,195,19.5,0,13,9,9,7.2,18800,17064,1706.4,196,-1726,1
9353,350,689,1661.6,16616,17642,7.0,9,9,8,182,18.2,1,0,1,0,1,206,20.6,1,5,7,7,6.8,16953,16266,1626.6,-689,-350,0
9354,-2760,-2274,1570.1,15701,16610,6.8,5,5,7,186,18.6,0,0,0,1,1,247,24.7,1,9,9,9,7.2,18884,18461,1846.1,2274,2760,1
9355,805,1723,1755.6,17556,18967,7.2,9,9,9,214,21.4,0,0,0,1,1,230,23.0,1,12,7,7,6.8,17244,16751,1675.1,-1723,-805,0
9356,-3754,-2371,1359.1,13591,16284,6.6,1,1,1,201,20.1,1,1,0,1,0,256,25.6,0,6,8,8,7.2,18655,17345,1734.5,2371,3754,0
9357,2216,949,1763.7,17637,18484,7.0,10,10,8,198,19.8,1,1,1,0,0,236,23.6,1,2,4,4,6.8,17535,15421,1542.1,-949,-2216,1
9358,3135,1888,1704.7,17047,19573,7.0,7,7,4,224,22.4,0,0,1,0,1,201,20.1,1,1,2,2,6.8,17685,13912,1391.2,-1888,-3135,1
9359,1855,1520,1782.1,17821,18702,7.2,9,9,14,215,21.5,2,1,0,1,0,233,23.3,0,4,5,5,6.6,17182,15966,1596.6,-1520,-1855,0
9360,-451,591,1569.4,15694,18079,7.0,5,5,7,209,20.9,0,0,1,0,1,241,24.1,1,5,4,4,7.0,17488,16145,1614.5,-591,451,0
9361,-1939,-2911,1664.0,16640,16726,6.6,8,8,8,222,22.2,0,0,1,0,1,233,23.3,2,15,9,9,7.4,19637,18579,1857.9,2911,1939,0
9362,584,370,1623.5,16235,18651,7.0,4,4,4,260,26.0,1,1,0,1,0,221,22.1,0,7,3,3,7.0,18281,15651,1565.1,-370,-584,1
9363,-2911,-286,1442.3,14423,17518,7.2,3,3,2,188,18.8,1,0,0,1,0,201,20.1,0,12,9,9,6.8,17804,17334,1733.4,286,2911,0
9364,-194,-1106,1591.1,15911,17205,6.6,6,6,4,224,22.4,0,0,0,1,0,193,19.3,0,7,6,6,7.2,18311,16105,1610.5,1106,194,0
9365,-3082,-646,1423.2,14232,17038,6.8,3,3,3,186,18.6,0,0,0,1,1,208,20.8,1,14,9,9,6.8,17684,17314,1731.4,646,3082,0
9366,-1480,-1366,1542.9,15429,16825,6.6,5,5,2,227,22.7,0,0,1,0,0,218,21.8,0,10,8,8,6.8,18191,16909,1690.9,1366,1480,0
9367,-2289,-277,1434.9,14349,17864,7.0,2,2,1,199,19.9,0,0,0,1,1,246,24.6,1,4,5,5,7.2,18141,16638,1663.8,277,2289,0
9368,-920,-1562,1787.7,17877,17302,6.8,10,10,15,186,18.6,1,1,0,1,0,231,23.1,1,9,12,12,7.2,18864,18797,1879.7,1562,920,1
9369,-1912,-19,1596.8,15968,15868,6.4,8,8,8,145,14.5,0,0,0,1,1,191,19.1,1,13,10,10,6.6,15887,17880,1788.0,19,1912,1
9370,-546,-104,1793.1,17931,18404,7.0,7,7,5,210,21.0,2,1,1,0,0,217,21.7,0,13,8,8,7.0,18508,18477,1847.7,104,546,1
9371,188,-498,1708.2,17082,18101,7.2,9,9,10,223,22.3,0,0,0,1,1,215,21.5,1,11,7,7,7.0,18599,16894,1689.4,498,-188,0
9372,-142,-1193,1714.7,17147,18525,7.0,7,7,6,205,20.5,1,1,0,1,0,242,24.2,1,2,8,8,7.4,19718,17289,1728.9,1193,142,0
9373,3054,2510,1833.8,18338,18468,7.0,12,12,14,211,21.1,0,0,1,0,1,190,19.0,1,2,4,4,6.6,15958,15284,1528.4,-2510,-3054,1
9374,-2572,-2642,1536.7,15367,17109,6.6,4,4,3,214,21.4,1,1,0,1,0,198,19.8,1,12,9,9,7.0,19751,17939,1793.9,2642,2572,0
9375,-1147,-1842,1440.8,14408,16534,6.6,2,2,3,212,21.2,1,1,1,0,0,218,21.8,0,4,4,4,6.8,18376,15555,1555.5,1842,1147,1
9376,-274,-406,1499.1,14991,17977,6.8,5,5,6,193,19.3,0,0,1,0,1,217,21.7,1,3,4,4,7.0,18383,15265,1526.5,406,274,1
9377,2237,1009,1614.4,16144,17907,7.0,5,5,6,226,22.6,1,0,0,1,0,226,22.6,0,1,1,1,6.8,16898,13907,1390.7,-1009,-2237,1
9378,-2666,-1972,1518.6,15186,16381,6.8,6,6,6,204,20.4,0,0,1,0,1,218,21.8,1,14,8,8,7.0,18353,17852,1785.2,1972,2666,0
9379,1782,1234,1707.2,17072,19087,7.0,7,7,11,227,22.7,1,1,1,0,0,212,21.2,0,1,3,3,7.0,17853,15290,1529.0,-1234,-1782,1
9380,-2545,-1960,1538.1,15381,16972,6.6,2,2,2,249,24.9,1,1,1,0,0,243,24.3,1,6,6,6,7.0,18932,17926,1792.6,1960,2545,0
9381,-1817,-1854,1361.0,13610,16594,6.6,0,0,0,199,19.9,1,1,0,1,0,238,23.8,0,1,3,3,7.0,18448,15427,1542.7,1854,1817,1
9382,443,-1176,1653.5,16535,17582,7.0,7,7,9,230,23.0,0,0,1,0,0,216,21.6,0,3,4,4,7.0,18758,16092,1609.2,1176,-443,1
9383,-3472,-3059,1514.5,15145,16768,6.6,3,3,4,200,20.0,0,0,0,1,0,227,22.7,1,6,11,11,7.4,19827,18617,1861.7,3059,3472,0
9384,-2594,-1150,1568.6,15686,17245,6.8,8,8,4,195,19.5,0,0,0,1,0,236,23.6,0,9,8,8,7.0,18395,18280,1828.0,1150,2594,0
9385,1138,-7,1737.9,17379,18458,7.0,10,10,14,200,20.0,1,1,1,0,0,246,24.6,0,3,5,5,7.0,18465,16241,1624.1,7,-1138,1
9386,-2224,-2008,1805.1,18051,17921,6.8,10,10,12,201,20.1,0,0,1,0,1,226,22.6,1,13,15,15,7.4,19929,20275,2027.5,2008,2224,0
9387,597,559,1607.5,16075,19032,7.2,3,3,3,251,25.1,1,1,0,1,0,244,24.4,0,3,2,2,7.0,18473,15478,1547.8,-559,-597,1
9388,-630,-865,1485.4,14854,16846,7.0,3,3,6,212,21.2,2,1,1,0,0,203,20.3,0,2,3,3,7.0,17711,15484,1548.4,865,630,1
9389,669,-483,1577.0,15770,17426,7.0,4,4,5,229,22.9,1,1,1,0,0,261,26.1,0,1,2,2,7.0,17909,15101,1510.1,483,-669,1
9390,-1464,-1575,1630.8,16308,17911,7.2,7,7,8,199,19.9,0,0,0,1,0,250,25.0,0,3,8,8,7.4,19486,17772,1777.2,1575,1464,1
9391,-37,1144,1500.8,15008,18344,7.0,3,3,4,211,21.1,1,1,0,1,0,221,22.1,0,3,3,3,6.8,17200,15045,1504.5,-1144,37,0
9392,-719,825,1523.8,15238,17288,6.8,5,5,5,184,18.4,0,0,0,1,0,211,21.1,0,4,5,5,6.8,16463,15957,1595.7,-825,719,1
9393,-483,-442,1553.4,15534,18339,7.0,4,4,2,223,22.3,2,1,1,0,0,266,26.6,0,5,4,4,7.2,18781,16017,1601.7,442,483,1
9394,-164,343,1670.7,16707,17154,6.6,8,8,6,217,21.7,1,1,1,0,0,174,17.4,0,12,8,8,6.8,16811,16871,1687.1,-343,164,0
9395,1266,612,1720.0,17200,18695,7.0,3,3,5,237,23.7,0,0,0,1,1,239,23.9,1,3,4,4,7.0,18083,15934,1593.4,-612,-1266,0
9396,-4299,-3010,1483.0,14830,17313,6.6,3,3,3,221,22.1,0,0,0,1,0,228,22.8,0,17,11,11,7.4,20323,19129,1912.9,3010,4299,0
9397,1156,168,1662.0,16620,16713,6.8,6,6,7,212,21.2,1,1,1,0,0,200,20.0,1,6,6,6,6.6,16545,15464,1546.4,-168,-1156,1
9398,3878,3016,1761.1,17611,18390,7.0,9,9,12,232,23.2,2,1,1,0,0,205,20.5,0,4,2,2,6.4,15374,13733,1373.3,-3016,-3878,1
9399,1717,775,1790.8,17908,17505,7.0,9,9,12,220,22.0,1,1,0,1,0,212,21.2,1,9,7,7,6.6,16730,16191,1619.1,-775,-1717,1
9400,2037,2483,1779.1,17791,19243,7.0,7,7,9,244,24.4,1,1,1,0,0,209,20.9,0,5,5,5,6.6,16760,15754,1575.4,-2483,-2037,1
9401,-1098,-966,1550.9,15509,18064,7.0,2,2,3,235,23.5,0,0,0,1,1,204,20.4,2,4,6,6,7.2,19030,16607,1660.7,966,1098,0
9402,-794,-951,1630.4,16304,17893,6.8,6,6,4,209,20.9,0,0,1,0,0,220,22.0,0,3,5,5,7.2,18844,17098,1709.8,951,794,1
9403,611,290,1659.4,16594,18266,7.0,7,7,14,217,21.7,1,1,1,0,0,239,23.9,0,1,3,3,6.8,17976,15983,1598.3,-290,-611,0
9404,-2749,-3335,1473.2,14732,16332,6.6,4,4,3,186,18.6,0,0,0,1,1,222,22.2,1,6,7,7,7.6,19667,17481,1748.1,3335,2749,0
9405,-417,-1028,1714.9,17149,17767,6.8,9,9,5,211,21.1,1,0,0,1,1,215,21.5,1,6,8,8,7.0,18795,17566,1756.6,1028,417,1
9406,4119,2320,1840.8,18408,20063,7.4,7,7,9,250,25.0,0,0,1,0,1,234,23.4,2,1,1,1,6.8,17743,14289,1428.9,-2320,-4119,1
9407,-3051,-2114,1421.1,14211,17270,6.6,0,0,0,232,23.2,0,0,0,1,1,250,25.0,2,3,5,5,7.2,19384,17262,1726.2,2114,3051,0
9408,-451,-1374,1569.8,15698,18088,7.0,3,3,4,253,25.3,2,1,1,0,0,255,25.5,0,1,2,2,7.2,19462,16149,1614.9,1374,451,1
9409,-916,-1466,1595.6,15956,17062,6.6,7,7,8,200,20.0,1,1,1,0,0,204,20.4,0,6,8,8,7.2,18528,16872,1687.2,1466,916,0
9410,7039,4860,2028.9,20289,20144,7.2,12,12,24,245,24.5,1,1,1,0,0,152,15.2,0,1,1,1,6.4,15284,13250,1325.0,-4860,-7039,1
9411,-2581,-1304,1694.8,16948,17861,7.0,7,7,5,207,20.7,0,0,0,1,1,252,25.2,1,12,12,12,7.2,19165,19529,1952.9,1304,2581,1
9412,-688,-230,1590.0,15900,17743,7.0,4,4,7,187,18.7,0,0,0,1,1,236,23.6,1,4,5,5,6.8,17973,16588,1658.8,230,688,0
9413,-2802,-1606,1569.0,15690,18165,6.8,4,4,3,223,22.3,0,0,0,1,1,227,22.7,2,16,10,10,7.4,19771,18492,1849.2,1606,2802,0
9414,1496,1664,1701.8,17018,20337,7.4,5,5,5,262,26.2,2,1,1,0,0,253,25.3,0,2,3,3,7.2,18673,15522,1552.2,-1664,-1496,1
9415,2778,1130,1963.9,19639,19616,7.2,10,10,12,241,24.1,2,1,1,0,0,240,24.0,0,8,6,6,7.2,18486,16861,1686.1,-1130,-2778,1
9416,-612,-167,1601.9,16019,17728,6.6,6,6,6,193,19.3,1,1,1,0,0,218,21.8,0,8,6,6,7.0,17895,16631,1663.1,167,612,1
9417,-3207,-1327,1452.5,14525,18541,7.0,2,2,3,214,21.4,0,0,0,1,1,241,24.1,1,9,9,9,7.2,19868,17732,1773.2,1327,3207,0
9418,-2698,-2458,1493.1,14931,16059,6.4,4,4,7,199,19.9,1,1,0,1,0,239,23.9,1,11,6,6,7.0,18517,17629,1762.9,2458,2698,0
9419,6921,4411,2054.0,20540,20655,7.6,10,10,7,256,25.6,2,1,1,0,0,186,18.6,0,1,2,2,6.6,16244,13619,1361.9,-4411,-6921,1
9420,773,320,1489.5,14895,17420,6.8,2,2,3,236,23.6,0,0,1,0,1,212,21.2,1,0,1,1,6.8,17100,14122,1412.2,-320,-773,1
9421,-4788,-2570,1458.4,14584,16269,6.4,2,2,3,198,19.8,0,0,0,1,1,214,21.4,1,20,14,14,7.2,18839,19372,1937.2,2570,4788,0
9422,603,-461,1575.7,15757,17869,6.8,5,5,3,229,22.9,0,0,1,0,1,246,24.6,1,0,2,2,7.0,18330,15154,1515.4,461,-603,1
9423,435,564,1647.7,16477,18750,7.2,7,7,5,198,19.8,0,0,1,0,1,258,25.8,1,2,4,4,7.0,18186,16042,1604.2,-564,-435,0
9424,384,872,1504.8,15048,16614,6.4,5,5,5,182,18.2,0,0,1,0,1,229,22.9,1,2,2,2,6.6,15742,14664,1466.4,-872,-384,0
9425,2348,1047,1719.7,17197,18431,7.2,7,7,10,224,22.4,1,1,1,0,0,206,20.6,0,4,4,4,6.6,17384,14849,1484.9,-1047,-2348,1
9426,314,611,1695.6,16956,18758,6.8,7,7,7,223,22.3,1,0,0,1,1,235,23.5,1,7,7,7,7.2,18147,16642,1664.2,-611,-314,0
9427,-5089,-4890,1495.8,14958,16928,6.6,4,4,3,184,18.4,0,0,1,0,0,243,24.3,1,7,11,11,7.8,21818,20047,2004.7,4890,5089,0
9428,-1682,-1153,1700.6,17006,18416,7.2,5,5,5,245,24.5,1,1,0,1,0,260,26.0,0,12,9,9,7.2,19569,18688,1868.8,1153,1682,0
9429,3128,2919,1986.6,19866,20339,7.6,11,11,14,202,20.2,0,0,1,0,0,202,20.2,0,5,7,7,6.8,17420,16738,1673.8,-2919,-3128,1
9430,-1862,-1326,1572.0,15720,17660,6.8,6,6,3,187,18.7,0,0,1,0,0,240,24.0,1,6,7,7,7.2,18986,17582,1758.2,1326,1862,0
9431,-1415,-1826,1793.8,17938,18477,7.0,10,10,7,150,15.0,0,0,0,1,0,196,19.6,0,7,13,13,7.6,20303,19353,1935.3,1826,1415,0
9432,1125,-141,1719.7,17197,18196,7.2,7,7,6,238,23.8,0,0,1,0,0,205,20.5,0,6,6,6,7.0,18337,16072,1607.2,141,-1125,0
9433,-3049,-2220,1434.3,14343,16877,6.6,3,3,4,209,20.9,0,0,0,1,0,241,24.1,0,9,7,7,7.2,19097,17392,1739.2,2220,3049,1
9434,-1422,-861,1448.5,14485,17588,6.8,2,2,0,233,23.3,0,0,0,1,1,235,23.5,1,7,6,6,7.0,18449,15907,1590.7,861,1422,0
9435,2135,1254,1767.1,17671,18649,7.0,6,6,6,250,25.0,0,0,0,1,1,231,23.1,1,4,3,3,7.0,17395,15536,1553.6,-1254,-2135,1
9436,-2763,-1881,1543.0,15430,16509,6.8,4,4,6,207,20.7,0,0,0,1,0,218,21.8,0,13,10,10,7.0,18390,18193,1819.3,1881,2763,0
9437,-1247,-2320,1507.2,15072,17479,7.0,3,3,3,233,23.3,1,0,1,0,1,222,22.2,1,6,5,5,7.4,19799,16319,1631.9,2320,1247,0
9438,-4898,-3736,1381.5,13815,16570,6.8,1,1,1,219,21.9,2,1,0,1,0,261,26.1,0,13,10,10,7.4,20306,18713,1871.3,3736,4898,0
9439,-758,-516,1708.0,17080,18513,7.0,7,7,5,219,21.9,0,0,0,1,1,209,20.9,1,10,12,12,7.2,19029,17838,1783.8,516,758,0
9440,2481,2112,1710.3,17103,19263,7.0,7,7,7,221,22.1,1,1,0,1,0,210,21.0,0,2,2,2,7.0,17151,14622,1462.2,-2112,-2481,1
9441,1250,-226,1831.2,18312,18057,6.8,10,10,10,239,23.9,1,1,1,0,0,206,20.6,1,5,7,7,6.8,18283,17062,1706.2,226,-1250,0
9442,961,1114,1592.4,15924,17965,7.0,7,7,2,211,21.1,1,1,1,0,0,199,19.9,0,3,4,4,6.6,16851,14963,1496.3,-1114,-961,1
9443,-1740,-46,1512.2,15122,17880,6.8,4,4,3,216,21.6,0,0,0,1,0,195,19.5,0,7,7,7,7.0,17926,16862,1686.2,46,1740,0
9444,1531,1680,1836.1,18361,18709,7.0,11,11,14,234,23.4,1,0,0,1,1,207,20.7,1,13,7,7,6.8,17029,16830,1683.0,-1680,-1531,0
9445,-209,-732,1588.8,15888,17305,6.8,4,4,3,229,22.9,0,0,1,0,1,232,23.2,1,8,6,6,6.8,18037,16097,1609.7,732,209,1
9446,-646,-960,1571.7,15717,16971,6.6,5,5,6,196,19.6,1,0,0,1,1,222,22.2,1,8,8,8,6.8,17931,16363,1636.3,960,646,0
9447,4003,2755,1915.3,19153,20631,7.4,9,9,11,262,26.2,0,0,1,0,1,225,22.5,1,3,3,3,7.2,17876,15150,1515.0,-2755,-4003,1
9448,2063,1430,1753.0,17530,18078,6.8,9,9,7,238,23.8,1,0,0,1,0,189,18.9,0,3,6,6,6.8,16648,15467,1546.7,-1430,-2063,1
9449,5191,4111,1838.9,18389,18618,7.0,10,10,9,227,22.7,0,0,1,0,0,162,16.2,0,3,3,3,6.2,14507,13198,1319.8,-4111,-5191,1
9450,2389,892,1738.1,17381,18931,7.2,7,7,8,258,25.8,0,0,1,0,1,216,21.6,1,2,2,2,7.0,18039,14992,1499.2,-892,-2389,0
9451,-1516,-441,1509.1,15091,18237,7.2,4,4,6,215,21.5,0,0,0,1,1,267,26.7,1,3,3,3,7.0,18678,16607,1660.7,441,1516,1
9452,-2575,-982,1509.7,15097,18355,7.0,2,2,1,223,22.3,0,0,0,1,1,226,22.6,1,9,8,8,7.2,19337,17672,1767.2,982,2575,0
9453,1471,806,1627.2,16272,18613,7.0,7,7,6,232,23.2,1,1,1,0,0,239,23.9,0,3,3,3,6.8,17807,14801,1480.1,-806,-1471,1
9454,-702,746,1661.8,16618,17861,7.0,6,6,6,206,20.6,2,1,0,1,0,206,20.6,0,11,8,8,6.4,17115,17320,1732.0,-746,702,1
9455,-1635,-1544,1482.6,14826,16327,6.6,2,2,1,222,22.2,0,0,0,1,1,210,21.0,2,12,8,8,6.8,17871,16461,1646.1,1544,1635,0
9456,5462,3677,1935.4,19354,20036,7.2,11,11,8,251,25.1,2,1,1,0,0,192,19.2,0,2,2,2,6.8,16359,13892,1389.2,-3677,-5462,1
9457,2615,2028,1738.0,17380,18705,6.8,7,7,12,232,23.2,0,0,1,0,0,181,18.1,0,3,4,4,6.6,16677,14765,1476.5,-2028,-2615,1
9458,790,83,1695.2,16952,19223,7.2,5,5,9,239,23.9,0,0,1,0,0,251,25.1,0,3,3,3,7.2,19140,16162,1616.2,-83,-790,1
9459,1193,1453,1631.6,16316,17968,6.6,4,4,11,241,24.1,0,0,1,0,0,208,20.8,0,5,5,5,6.4,16515,15123,1512.3,-1453,-1193,1
9460,-4785,-3229,1360.8,13608,16690,6.6,0,0,0,229,22.9,0,0,0,1,1,239,23.9,2,11,8,8,7.2,19919,18393,1839.3,3229,4785,0
9461,-3055,-2672,1622.7,16227,16987,6.6,8,8,9,197,19.7,1,1,1,0,0,214,21.4,0,15,14,14,7.2,19659,19282,1928.2,2672,3055,0
9462,-1655,-1008,1628.5,16285,16278,6.4,8,8,5,183,18.3,1,1,1,0,0,189,18.9,0,9,10,10,6.6,17286,17940,1794.0,1008,1655,1
9463,1259,550,1940.7,19407,19360,7.4,15,15,19,217,21.7,1,1,1,0,0,193,19.3,0,11,10,10,7.0,18810,18148,1814.8,-550,-1259,1
9464,-737,667,1720.8,17208,18713,7.2,8,8,10,231,23.1,0,0,0,1,0,239,23.9,0,10,8,8,6.8,18046,17945,1794.5,-667,737,0
9465,-255,-545,1591.5,15915,18778,7.2,2,2,1,245,24.5,1,0,1,0,1,197,19.7,1,7,5,5,7.2,19323,16170,1617.0,545,255,0
9466,2194,1814,1901.2,19012,18944,7.2,13,13,12,210,21.0,0,0,1,0,0,195,19.5,0,9,6,6,6.8,17130,16818,1681.8,-1814,-2194,1
9467,5245,2754,2086.1,20861,18819,7.0,13,13,14,213,21.3,1,0,1,0,0,195,19.5,0,7,5,5,6.4,16065,15616,1561.6,-2754,-5245,1
9468,-290,-1061,1605.1,16051,16995,6.8,5,5,5,235,23.5,0,0,1,0,1,245,24.5,1,7,5,5,6.8,18056,16341,1634.1,1061,290,0
9469,-115,480,1638.0,16380,18331,6.8,5,5,9,229,22.9,1,1,0,1,0,225,22.5,1,3,3,3,7.0,17851,16495,1649.5,-480,115,0
9470,-634,-1526,1542.0,15420,16188,6.6,4,4,4,185,18.5,1,0,1,0,1,236,23.6,1,4,4,4,6.8,17714,16054,1605.4,1526,634,0
9471,3461,1985,1832.0,18320,18926,7.0,8,8,11,244,24.4,1,1,1,0,0,217,21.7,0,2,4,4,6.6,16941,14859,1485.9,-1985,-3461,1
9472,867,420,1660.4,16604,17994,7.0,6,6,5,240,24.0,2,1,1,0,0,205,20.5,0,3,6,6,6.8,17574,15737,1573.7,-420,-867,1
9473,-215,155,1561.0,15610,18203,7.0,4,4,5,184,18.4,0,0,0,1,0,221,22.1,0,5,5,5,7.0,18048,15825,1582.5,-155,215,0
9474,1515,1112,1740.3,17403,18532,7.0,10,10,8,181,18.1,0,0,1,0,1,231,23.1,1,7,5,5,7.0,17420,15888,1588.8,-1112,-1515,0
9475,-114,433,1603.0,16030,17738,6.8,7,7,7,180,18.0,1,1,0,1,0,233,23.3,0,4,5,5,6.8,17305,16144,1614.4,-433,114,1
9476,-1942,-407,1475.6,14756,17221,6.8,2,2,2,217,21.7,0,0,0,1,1,212,21.2,1,6,6,6,6.6,17628,16698,1669.8,407,1942,0
9477,-3906,-2509,1415.6,14156,16075,6.6,4,4,3,177,17.7,0,0,0,1,0,233,23.3,0,7,7,7,7.2,18584,18062,1806.2,2509,3906,0
9478,-498,-861,1692.7,16927,17042,6.8,7,7,7,223,22.3,0,0,1,0,0,228,22.8,0,7,8,8,7.0,17903,17425,1742.5,861,498,0
9479,2208,-313,1736.5,17365,17243,6.8,7,7,11,223,22.3,1,1,1,0,0,192,19.2,0,6,3,3,6.8,17556,15157,1515.7,313,-2208,1
9480,-1667,-654,1522.6,15226,17774,6.8,4,4,2,168,16.8,0,0,1,0,0,227,22.7,0,6,5,5,6.8,18428,16893,1689.3,654,1667,1
9481,1110,974,1712.3,17123,17730,6.8,8,8,7,190,19.0,0,0,0,1,1,161,16.1,1,9,7,7,6.8,16756,16013,1601.3,-974,-1110,0
9482,-1984,-715,1466.3,14663,17795,6.8,3,3,2,206,20.6,1,1,0,1,0,205,20.5,0,9,7,7,7.0,18510,16647,1664.7,715,1984,0
9483,1692,1998,1789.7,17897,19344,7.2,9,9,8,217,21.7,1,0,1,0,1,206,20.6,1,8,6,6,7.0,17346,16205,1620.5,-1998,-1692,0
9484,-5710,-4952,1341.8,13418,13877,5.8,2,2,2,175,17.5,0,0,0,1,1,213,21.3,2,15,11,11,7.2,18829,19128,1912.8,4952,5710,0
9485,806,371,1592.8,15928,17872,6.8,6,6,7,195,19.5,1,0,0,1,1,200,20.0,1,7,6,6,6.8,17501,15122,1512.2,-371,-806,0
9486,-3620,-2690,1511.1,15111,17710,6.8,3,3,2,210,21.0,1,0,0,1,1,236,23.6,1,9,12,12,7.2,20400,18731,1873.1,2690,3620,0
9487,3056,1805,1710.1,17101,18836,7.0,8,8,8,237,23.7,0,0,1,0,0,194,19.4,0,2,2,2,6.6,17031,14045,1404.5,-1805,-3056,1
9488,2562,3016,1719.4,17194,19279,7.2,8,8,10,200,20.0,1,1,0,1,0,184,18.4,0,4,5,5,6.4,16263,14632,1463.2,-3016,-2562,1
9489,824,521,1656.5,16565,17877,7.0,6,6,2,214,21.4,1,0,1,0,1,212,21.2,1,2,5,5,6.8,17356,15741,1574.1,-521,-824,1
9490,-1074,-1632,1694.3,16943,17157,6.8,8,8,10,208,20.8,1,1,0,1,0,229,22.9,1,10,10,10,7.0,18789,18017,1801.7,1632,1074,0
9491,1975,802,1756.8,17568,19108,7.2,7,7,8,241,24.1,1,1,1,0,0,229,22.9,0,5,4,4,7.0,18306,15593,1559.3,-802,-1975,1
9492,86,467,1725.0,17250,18763,7.2,6,6,10,206,20.6,0,0,0,1,1,197,19.7,2,9,8,8,7.0,18296,17164,1716.4,-467,-86,0
9493,1928,257,1655.9,16559,17552,7.0,4,4,5,216,21.6,1,0,1,0,1,248,24.8,1,1,2,2,6.6,17295,14631,1463.1,-257,-1928,1
9494,-982,-1614,1435.1,14351,17173,6.6,1,1,0,218,21.8,0,0,0,1,1,219,21.9,1,2,3,3,7.4,18787,15333,1533.3,1614,982,0
9495,-1751,-2530,1473.5,14735,16525,6.6,2,2,4,236,23.6,0,0,1,0,0,223,22.3,0,6,5,5,7.0,19055,16486,1648.6,2530,1751,0
9496,3828,2447,1807.0,18070,19270,7.2,9,9,17,235,23.5,2,1,1,0,0,214,21.4,0,0,1,1,6.6,16823,14242,1424.2,-2447,-3828,1
9497,423,-315,1544.9,15449,17026,6.8,4,4,5,206,20.6,1,1,1,0,0,254,25.4,0,1,3,3,6.6,17341,15026,1502.6,315,-423,0
9498,1839,312,1758.1,17581,18639,7.0,8,8,6,243,24.3,0,0,1,0,1,221,22.1,1,2,5,5,7.2,18327,15742,1574.2,-312,-1839,1
9499,-875,-363,1550.5,15505,18109,6.8,4,4,3,215,21.5,1,0,0,1,1,232,23.2,1,4,6,6,7.2,18472,16380,1638.0,363,875,0
9500,375,296,1687.3,16873,17879,6.8,8,8,12,215,21.5,0,0,1,0,1,202,20.2,1,14,8,8,7.0,17583,16498,1649.8,-296,-375,1
9501,-4095,-1033,1475.5,14755,15569,6.2,4,4,7,213,21.3,0,0,0,1,1,199,19.9,1,19,10,10,6.6,16602,18850,1885.0,1033,4095,0
9502,2273,1714,1808.1,18081,18813,7.0,10,10,11,207,20.7,0,0,1,0,0,220,22.0,0,10,6,6,6.8,17099,15808,1580.8,-1714,-2273,1
9503,-1892,-580,1579.1,15791,17342,7.0,5,5,7,192,19.2,0,0,0,1,0,205,20.5,0,12,9,9,7.2,17922,17683,1768.3,580,1892,1
9504,-3137,-2097,1348.0,13480,16396,6.4,1,1,0,215,21.5,1,1,0,1,0,233,23.3,0,10,6,6,7.0,18493,16617,1661.7,2097,3137,0
9505,2401,727,1794.6,17946,18778,7.2,8,8,10,204,20.4,0,0,1,0,0,187,18.7,0,5,7,7,6.8,18051,15545,1554.5,-727,-2401,1
9506,292,1026,1775.4,17754,18278,7.0,10,10,10,195,19.5,1,1,0,1,0,190,19.0,1,12,10,10,6.8,17252,17462,1746.2,-1026,-292,1
9507,-1460,-1134,1617.2,16172,17632,6.8,4,4,3,221,22.1,0,0,0,1,1,223,22.3,1,15,9,9,7.2,18766,17632,1763.2,1134,1460,1
9508,-507,343,1482.8,14828,18414,7.2,2,2,0,237,23.7,0,0,1,0,1,260,26.0,1,3,2,2,7.0,18071,15335,1533.5,-343,507,0
9509,-3242,-950,1658.9,16589,18188,7.0,7,7,5,188,18.8,0,0,0,1,1,253,25.3,1,11,10,10,7.2,19138,19831,1983.1,950,3242,1
9510,-1079,233,1552.1,15521,17703,7.0,3,3,5,210,21.0,0,0,0,1,1,215,21.5,1,14,7,7,7.0,17470,16600,1660.0,-233,1079,1
9511,1873,1987,1619.8,16198,17866,6.8,6,6,9,226,22.6,1,1,1,0,0,179,17.9,0,4,3,3,6.4,15879,14325,1432.5,-1987,-1873,1
9512,-4596,-2815,1312.5,13125,15273,6.2,1,1,1,167,16.7,0,0,0,1,1,243,24.3,1,11,10,10,7.2,18088,17721,1772.1,2815,4596,0
9513,1322,148,1606.5,16065,17018,6.8,7,7,10,200,20.0,1,1,0,1,0,213,21.3,0,2,3,3,6.6,16870,14743,1474.3,-148,-1322,1
9514,566,-57,1694.0,16940,17909,7.2,6,6,5,246,24.6,0,0,1,0,0,219,21.9,0,11,7,7,7.2,17966,16374,1637.4,57,-566,1
9515,-134,-1518,1765.5,17655,16585,6.4,7,7,9,203,20.3,1,0,1,0,1,217,21.7,1,16,9,9,7.0,18103,17789,1778.9,1518,134,0
9516,-724,1250,1670.7,16707,17380,6.8,8,8,9,193,19.3,1,1,1,0,0,216,21.6,0,7,6,6,6.4,16130,17431,1743.1,-1250,724,0
9517,-3709,-1635,1521.4,15214,17796,7.0,6,6,5,171,17.1,0,0,0,1,0,228,22.8,0,10,11,11,7.2,19431,18923,1892.3,1635,3709,0
9518,4675,3054,1983.5,19835,19690,7.4,12,12,13,223,22.3,0,0,1,0,1,169,16.9,1,5,5,5,6.8,16636,15160,1516.0,-3054,-4675,1
9519,-1222,-874,1428.9,14289,17513,6.8,1,1,3,246,24.6,0,0,0,1,1,248,24.8,2,3,3,3,6.8,18387,15511,1551.1,874,1222,1
9520,2487,1963,1684.6,16846,19790,7.4,8,8,8,224,22.4,1,1,1,0,0,223,22.3,0,1,2,2,6.8,17827,14359,1435.9,-1963,-2487,0
9521,-4858,-1631,1548.8,15488,17274,6.8,6,6,3,196,19.6,1,0,0,1,1,214,21.4,1,15,12,12,6.8,18905,20346,2034.6,1631,4858,0
9522,-1678,-959,1685.5,16855,17721,6.8,7,7,8,218,21.8,0,0,1,0,1,232,23.2,1,14,10,10,7.0,18680,18533,1853.3,959,1678,1
9523,785,1439,1666.0,16660,19188,7.0,5,5,4,217,21.7,1,1,0,1,0,200,20.0,0,6,5,5,6.8,17749,15875,1587.5,-1439,-785,1
9524,2819,3222,1861.1,18611,20169,7.6,10,10,9,225,22.5,1,1,1,0,0,211,21.1,0,6,5,5,6.8,16947,15792,1579.2,-3222,-2819,0
9525,363,-533,1823.3,18233,19767,7.4,8,8,5,256,25.6,1,0,0,1,1,239,23.9,1,13,8,8,7.6,20300,17870,1787.0,533,-363,0
9526,930,2011,1661.6,16616,17450,6.6,6,6,10,215,21.5,1,0,1,0,0,168,16.8,0,7,5,5,6.2,15439,15686,1568.6,-2011,-930,0
9527,-621,-23,1610.7,16107,17763,7.2,6,6,8,231,23.1,0,0,0,1,1,216,21.6,1,9,7,7,6.8,17786,16728,1672.8,23,621,1
9528,111,-199,1667.4,16674,17188,6.8,7,7,12,204,20.4,0,0,1,0,1,221,22.1,2,5,5,5,7.0,17387,16563,1656.3,199,-111,1
9529,2644,1400,1667.1,16671,17285,6.8,7,7,12,216,21.6,1,1,1,0,0,228,22.8,1,1,2,2,6.4,15885,14027,1402.7,-1400,-2644,1
9530,1704,2023,1726.1,17261,18577,7.0,9,9,6,219,21.9,1,1,0,1,0,182,18.2,0,8,6,6,6.6,16554,15557,1555.7,-2023,-1704,1
9531,2881,2005,1688.6,16886,18724,7.2,6,6,4,242,24.2,2,1,0,1,0,186,18.6,0,2,2,2,6.8,16719,14005,1400.5,-2005,-2881,1
9532,1063,1153,1822.6,18226,18871,7.2,10,10,7,211,21.1,2,1,1,0,0,229,22.9,0,8,7,7,7.0,17718,17163,1716.3,-1153,-1063,0
9533,649,343,1813.6,18136,18077,7.0,11,11,13,194,19.4,1,1,1,0,0,239,23.9,0,8,6,6,7.0,17734,17487,1748.7,-343,-649,1
9534,-132,-1473,1471.2,14712,17631,7.0,1,1,0,253,25.3,1,0,1,0,1,264,26.4,1,0,0,0,7.0,19104,14844,1484.4,1473,132,0
9535,-1250,-1034,1642.0,16420,18391,7.0,7,7,4,224,22.4,1,0,1,0,1,239,23.9,1,6,8,8,7.2,19425,17670,1767.0,1034,1250,1
9536,-1213,848,1767.8,17678,17263,6.8,9,9,9,190,19.0,0,0,0,1,1,182,18.2,1,19,10,10,6.6,16415,18891,1889.1,-848,1213,1
9537,1386,679,1712.6,17126,17604,6.8,9,9,10,195,19.5,0,0,0,1,1,202,20.2,1,4,7,7,6.6,16925,15740,1574.0,-679,-1386,0
9538,-5120,-4011,1500.1,15001,16275,6.6,4,4,4,205,20.5,0,0,0,1,0,233,23.3,1,16,14,14,7.4,20286,20121,2012.1,4011,5120,0
9539,-2219,-677,1541.6,15416,18403,7.2,4,4,2,214,21.4,0,0,1,0,1,237,23.7,2,7,6,6,7.2,19080,17635,1763.5,677,2219,0
9540,-2399,-2317,1517.7,15177,16094,6.6,5,5,3,206,20.6,0,0,1,0,1,243,24.3,1,7,8,8,7.0,18411,17576,1757.6,2317,2399,0
9541,20,-1382,1585.3,15853,18455,6.8,4,4,2,229,22.9,0,0,1,0,1,232,23.2,1,3,4,4,7.4,19837,15833,1583.3,1382,-20,0
9542,834,861,1751.3,17513,18498,7.0,8,8,10,234,23.4,1,1,0,1,0,215,21.5,0,7,5,5,6.8,17637,16679,1667.9,-861,-834,0
9543,-1208,-213,1634.5,16345,17692,7.0,8,8,9,206,20.6,0,0,0,1,1,223,22.3,2,9,8,8,7.0,17905,17553,1755.3,213,1208,0
9544,-2907,-3389,1482.6,14826,16490,6.8,5,5,6,176,17.6,0,0,0,1,1,229,22.9,1,2,9,9,7.4,19879,17733,1773.3,3389,2907,0
9545,-635,-1449,1644.0,16440,17181,6.8,7,7,7,197,19.7,0,0,1,0,1,246,24.6,1,8,6,6,7.0,18630,17075,1707.5,1449,635,0
9546,1749,1270,1657.1,16571,18893,7.2,4,4,4,258,25.8,1,1,1,0,0,232,23.2,0,3,3,3,6.6,17623,14822,1482.2,-1270,-1749,1
9547,-2760,-1949,1592.8,15928,17242,6.8,4,4,10,204,20.4,0,0,0,1,1,233,23.3,1,13,10,10,7.2,19191,18688,1868.8,1949,2760,0
9548,-695,-2159,1775.9,17759,18043,7.2,7,7,11,246,24.6,1,0,1,0,0,214,21.4,0,6,10,10,7.4,20202,18454,1845.4,2159,695,0
9549,-1171,-854,1399.5,13995,17605,7.0,2,2,1,176,17.6,0,0,0,1,1,218,21.8,1,6,4,4,7.0,18459,15166,1516.6,854,1171,1
9550,-1001,-543,1660.7,16607,17949,7.0,5,5,5,223,22.3,1,0,1,0,1,229,22.9,1,10,8,8,7.0,18492,17608,1760.8,543,1001,1
9551,7154,6032,2217.3,22173,20408,7.4,19,19,22,234,23.4,1,1,0,1,0,189,18.9,1,5,4,4,6.0,14376,15019,1501.9,-6032,-7154,1
9552,-3063,-2014,1411.4,14114,17331,6.8,3,3,1,215,21.5,0,0,0,1,1,227,22.7,1,12,7,7,7.4,19345,17177,1717.7,2014,3063,0
9553,3917,2196,1870.4,18704,20796,7.6,6,6,4,260,26.0,2,1,0,1,0,216,21.6,0,1,3,3,7.0,18600,14787,1478.7,-2196,-3917,1
9554,3586,3431,1823.6,18236,19626,7.2,6,6,8,234,23.4,0,0,1,0,0,221,22.1,0,4,3,3,6.6,16195,14650,1465.0,-3431,-3586,1
9555,-2205,-1308,1543.7,15437,17811,7.0,5,5,4,195,19.5,0,0,0,1,1,270,27.0,1,6,7,7,7.2,19119,17642,1764.2,1308,2205,0
9556,-3572,-1330,1584.2,15842,17223,6.6,7,7,7,216,21.6,1,1,0,1,0,225,22.5,0,10,10,10,7.0,18553,19414,1941.4,1330,3572,0
9557,896,-140,1647.6,16476,17137,6.6,4,4,5,225,22.5,1,1,0,1,0,227,22.7,1,1,4,4,6.8,17277,15580,1558.0,140,-896,1
9558,399,-182,1707.5,17075,17360,7.0,8,8,9,198,19.8,1,0,0,1,1,219,21.9,1,6,7,7,7.0,17542,16676,1667.6,182,-399,1
9559,2980,1865,1832.7,18327,18553,7.2,10,10,6,219,21.9,1,1,1,0,0,233,23.3,0,3,5,5,6.8,16688,15347,1534.7,-1865,-2980,1
9560,-2228,-745,1543.2,15432,17869,7.0,5,5,6,225,22.5,0,0,0,1,1,247,24.7,1,8,8,8,7.0,18614,17660,1766.0,745,2228,0
9561,-1456,-251,1451.0,14510,17801,6.8,2,2,3,247,24.7,0,0,0,1,1,252,25.2,2,5,3,3,7.0,18052,15966,1596.6,251,1456,0
9562,-2709,-1468,1442.6,14426,17051,6.6,2,2,1,210,21.0,1,1,0,1,0,239,23.9,0,9,8,8,7.0,18519,17135,1713.5,1468,2709,0
9563,4648,2498,1963.2,19632,18732,7.0,11,11,9,222,22.2,1,1,0,1,0,181,18.1,0,7,5,5,6.4,16234,14984,1498.4,-2498,-4648,1
9564,-37,-100,1792.3,17923,17698,7.0,9,9,17,189,18.9,1,1,0,1,0,202,20.2,0,9,8,8,7.0,17798,17960,1796.0,100,37,1
9565,1772,1255,1629.7,16297,17730,6.8,4,4,3,237,23.7,0,0,1,0,0,202,20.2,0,4,4,4,6.6,16475,14525,1452.5,-1255,-1772,1
9566,6773,5215,2002.6,20026,19142,7.2,9,9,9,246,24.6,0,0,1,0,1,148,14.8,1,4,3,3,6.2,13927,13253,1325.3,-5215,-6773,1
9567,-299,-1889,1592.6,15926,16415,6.6,5,5,3,247,24.7,1,1,1,0,0,230,23.0,0,4,4,4,7.0,18304,16225,1622.5,1889,299,0
9568,-2227,-1077,1557.9,15579,18054,6.8,4,4,5,203,20.3,1,1,0,1,0,254,25.4,1,6,8,8,7.2,19131,17806,1780.6,1077,2227,1
9569,-1429,1040,1527.0,15270,18043,7.0,3,3,4,235,23.5,0,0,0,1,0,204,20.4,0,8,7,7,6.4,17003,16699,1669.9,-1040,1429,1
9570,-2519,-1610,1599.4,15994,18031,7.0,4,4,4,229,22.9,1,1,0,1,0,238,23.8,0,15,10,10,7.2,19641,18513,1851.3,1610,2519,0
9571,1117,472,1606.4,16064,18651,7.2,3,3,3,247,24.7,0,0,1,0,1,229,22.9,2,0,3,3,6.8,18179,14947,1494.7,-472,-1117,0
9572,700,1221,1679.6,16796,16424,6.6,8,8,12,185,18.5,1,1,1,0,0,175,17.5,0,14,8,8,6.2,15203,16096,1609.6,-1221,-700,1
9573,-977,-2180,1555.3,15553,15768,6.6,5,5,4,203,20.3,0,0,0,1,1,222,22.2,2,5,7,7,7.0,17948,16530,1653.0,2180,977,1
9574,-6265,-3518,1483.8,14838,15075,6.0,4,4,4,180,18.0,0,0,0,1,0,194,19.4,1,24,17,17,7.0,18593,21103,2110.3,3518,6265,0
9575,-154,663,1550.6,15506,17801,6.6,4,4,4,229,22.9,0,0,0,1,1,222,22.2,1,7,4,4,6.6,17138,15660,1566.0,-663,154,1
9576,-1114,-398,1653.1,16531,19310,7.4,6,6,3,226,22.6,0,0,0,1,1,199,19.9,1,10,10,10,7.4,19708,17645,1764.5,398,1114,0
9577,-2111,-2875,1600.0,16000,16324,6.4,7,7,9,190,19.0,0,0,1,0,0,221,22.1,0,11,12,12,7.2,19199,18111,1811.1,2875,2111,0
9578,-2082,-2125,1628.1,16281,17569,6.8,6,6,5,209,20.9,0,0,0,1,1,206,20.6,1,9,11,11,7.4,19694,18363,1836.3,2125,2082,0
9579,153,-519,1744.2,17442,17426,6.8,7,7,7,236,23.6,1,1,1,0,0,226,22.6,0,8,8,8,6.8,17945,17289,1728.9,519,-153,1
9580,2830,1589,1869.2,18692,19767,7.4,10,10,12,248,24.8,1,0,1,0,0,210,21.0,0,4,6,6,6.8,18178,15862,1586.2,-1589,-2830,1
9581,1761,2297,1702.8,17028,18519,7.0,5,5,4,235,23.5,1,1,0,1,0,177,17.7,1,9,6,6,6.6,16222,15267,1526.7,-2297,-1761,1
9582,-2153,-1344,1378.7,13787,17848,6.8,0,0,0,225,22.5,1,1,0,1,0,237,23.7,0,3,3,3,7.2,19192,15940,1594.0,1344,2153,0
9583,4594,2745,1795.6,17956,18251,7.0,5,5,3,271,27.1,2,1,0,1,0,187,18.7,0,6,2,2,6.4,15506,13362,1336.2,-2745,-4594,1
9584,-781,-1559,1547.6,15476,17429,6.8,2,2,6,237,23.7,1,1,0,1,0,227,22.7,1,3,5,5,7.2,18988,16257,1625.7,1559,781,0
9585,455,1305,1587.5,15875,18309,6.8,4,4,3,234,23.4,2,1,0,1,0,233,23.3,0,6,4,4,6.4,17004,15420,1542.0,-1305,-455,1
9586,-493,-986,1703.0,17030,17359,6.8,8,8,9,206,20.6,2,1,1,0,0,186,18.6,0,13,9,9,7.2,18345,17523,1752.3,986,493,1
9587,-2418,-2255,1471.9,14719,16759,6.6,3,3,1,214,21.4,0,0,0,1,0,240,24.0,0,7,6,6,7.0,19014,17137,1713.7,2255,2418,0
9588,241,307,1761.7,17617,17519,6.6,7,7,8,199,19.9,1,0,0,1,1,214,21.4,1,7,4,4,6.6,17212,17376,1737.6,-307,-241,1
9589,1023,1754,1645.7,16457,18669,7.0,5,5,6,229,22.9,1,0,1,0,0,219,21.9,0,7,4,4,6.6,16915,15434,1543.4,-1754,-1023,0
9590,-75,-1566,1588.5,15885,16674,6.6,5,5,9,203,20.3,0,0,1,0,1,211,21.1,2,1,6,6,7.0,18240,15960,1596.0,1566,75,0
9591,3799,2856,1910.7,19107,20103,7.4,10,10,10,230,23.0,1,0,1,0,0,210,21.0,0,3,4,4,6.8,17247,15308,1530.8,-2856,-3799,1
9592,1114,-1294,1650.7,16507,16273,6.4,7,7,10,212,21.2,0,0,0,1,0,221,22.1,0,5,4,4,6.8,17567,15393,1539.3,1294,-1114,1
9593,1585,1348,1653.8,16538,18707,7.2,6,6,11,235,23.5,1,1,0,1,0,189,18.9,0,4,4,4,6.6,17359,14953,1495.3,-1348,-1585,1
9594,-2968,-3336,1506.7,15067,15937,6.6,3,3,3,186,18.6,0,0,0,1,1,214,21.4,1,11,10,10,7.4,19273,18035,1803.5,3336,2968,0
9595,-1624,-3004,1657.1,16571,15773,6.4,7,7,11,178,17.8,0,0,1,0,0,207,20.7,0,15,13,13,7.2,18777,18195,1819.5,3004,1624,0
9596,-1347,-1433,1653.0,16530,19242,7.4,5,5,6,231,23.1,0,0,0,1,1,231,23.1,1,6,8,8,7.6,20675,17877,1787.7,1433,1347,0
9597,36,-234,1623.9,16239,18439,7.0,6,6,9,203,20.3,1,1,0,1,0,224,22.4,0,3,6,6,7.2,18673,16203,1620.3,234,-36,1
9598,115,-256,1662.4,16624,18473,6.8,6,6,7,208,20.8,0,0,1,0,1,239,23.9,2,6,4,4,7.0,18729,16509,1650.9,256,-115,0
9599,-3280,-2301,1589.0,15890,16536,6.4,7,7,7,201,20.1,1,1,0,1,0,223,22.3,1,14,11,11,7.4,18837,19170,1917.0,2301,3280,0
9600,2842,1659,1895.7,18957,19663,7.4,13,13,23,222,22.2,0,0,1,0,1,238,23.8,1,7,4,4,6.8,18004,16115,1611.5,-1659,-2842,1
9601,3223,2804,1830.7,18307,19247,7.2,11,11,10,228,22.8,1,1,0,1,0,198,19.8,0,3,5,5,6.6,16443,15084,1508.4,-2804,-3223,1
9602,1447,1753,1639.4,16394,20016,7.4,2,2,2,264,26.4,2,1,0,1,0,227,22.7,0,1,3,3,6.8,18263,14947,1494.7,-1753,-1447,1
9603,-2483,-1696,1509.6,15096,15306,6.2,3,3,3,212,21.2,1,0,0,1,1,144,14.4,1,16,12,12,6.6,17002,17579,1757.9,1696,2483,1
9604,662,33,1520.0,15200,17127,6.8,3,3,5,230,23.0,1,1,1,0,0,202,20.2,0,3,3,3,6.6,17094,14538,1453.8,-33,-662,1
9605,-2212,-1666,1468.4,14684,16985,6.8,3,3,3,217,21.7,1,1,0,1,0,258,25.8,0,4,5,5,7.2,18651,16896,1689.6,1666,2212,1
9606,-412,22,1622.8,16228,16387,6.6,8,8,7,194,19.4,1,1,1,0,0,208,20.8,0,9,8,8,6.6,16365,16640,1664.0,-22,412,1
9607,1645,1489,1810.1,18101,19775,7.2,9,9,10,213,21.3,1,1,1,0,0,187,18.7,0,5,7,7,6.8,18286,16456,1645.6,-1489,-1645,1
9608,6744,5355,2105.5,21055,19573,7.2,14,14,15,219,21.9,1,0,1,0,1,166,16.6,1,3,3,3,6.0,14218,14311,1431.1,-5355,-6744,0
9609,-2215,-1879,1393.3,13933,16078,6.4,4,4,2,199,19.9,0,0,1,0,1,212,21.2,2,6,5,5,6.8,17957,16148,1614.8,1879,2215,0
9610,3611,2847,1949.7,19497,18445,7.2,11,11,13,221,22.1,1,0,1,0,0,165,16.5,0,9,7,7,6.4,15598,15886,1588.6,-2847,-3611,1
9611,-297,548,1523.6,15236,18474,7.2,3,3,1,236,23.6,0,0,0,1,1,205,20.5,1,4,4,4,7.0,17926,15533,1553.3,-548,297,1
9612,1928,1297,1670.0,16700,18574,7.2,5,5,5,242,24.2,1,1,1,0,0,243,24.3,0,1,3,3,6.6,17277,14772,1477.2,-1297,-1928,0
9613,2663,864,1650.6,16506,17981,7.0,5,5,11,213,21.3,2,1,1,0,0,224,22.4,0,0,1,1,6.6,17117,13843,1384.3,-864,-2663,1
9614,1086,756,1648.2,16482,16880,6.6,7,7,11,222,22.2,1,1,1,0,0,212,21.2,0,6,4,4,6.4,16124,15396,1539.6,-756,-1086,1
9615,764,-29,1569.4,15694,17920,7.0,3,3,2,241,24.1,0,0,0,1,1,221,22.1,1,1,4,4,7.0,17949,14930,1493.0,29,-764,1
9616,-1216,-629,1627.6,16276,17562,7.0,7,7,9,195,19.5,1,0,1,0,0,210,21.0,0,10,8,8,7.0,18191,17492,1749.2,629,1216,1
9617,-1572,-208,1833.1,18331,18445,7.0,12,12,14,181,18.1,1,0,0,1,1,228,22.8,1,17,14,14,7.0,18653,19903,1990.3,208,1572,0
9618,2547,1386,1734.7,17347,18131,7.0,9,9,10,230,23.0,1,1,1,0,0,208,20.8,0,7,3,3,6.6,16745,14800,1480.0,-1386,-2547,1
9619,-1931,-299,1509.0,15090,18031,7.0,0,0,0,238,23.8,0,0,0,1,1,220,22.0,1,13,9,9,7.2,18330,17021,1702.1,299,1931,0
9620,-333,-359,1779.9,17799,18078,7.0,10,10,17,190,19.0,1,0,1,0,1,241,24.1,1,7,8,8,7.2,18437,18132,1813.2,359,333,1
9621,-3531,-2649,1569.4,15694,16853,6.6,4,4,6,202,20.2,0,0,1,0,1,265,26.5,1,8,8,8,7.2,19502,19225,1922.5,2649,3531,0
9622,3425,3823,1726.9,17269,19988,7.2,7,7,8,244,24.4,0,0,1,0,1,228,22.8,1,0,0,0,6.6,16165,13844,1384.4,-3823,-3425,1
9623,619,35,1666.2,16662,18914,7.0,6,6,3,237,23.7,1,1,0,1,0,212,21.2,0,7,6,6,7.2,18879,16043,1604.3,-35,-619,1
9624,-689,-266,1729.2,17292,18087,7.0,5,5,4,238,23.8,0,0,1,0,1,214,21.4,1,18,9,9,7.0,18353,17981,1798.1,266,689,0
9625,-2395,-2173,1477.2,14772,17784,6.8,2,2,4,214,21.4,1,0,0,1,1,258,25.8,1,5,5,5,7.4,19957,17167,1716.7,2173,2395,0
9626,-1082,-1819,1515.7,15157,16829,6.8,2,2,1,228,22.8,1,0,1,0,1,229,22.9,1,4,8,8,7.0,18648,16239,1623.9,1819,1082,0
9627,-467,-86,1612.4,16124,17018,6.8,7,7,8,192,19.2,0,0,1,0,1,211,21.1,2,8,6,6,6.8,17104,16591,1659.1,86,467,1
9628,3135,2366,1788.1,17881,19560,7.2,7,7,11,257,25.7,1,0,0,1,0,201,20.1,0,7,5,5,6.6,17194,14746,1474.6,-2366,-3135,1
9629,1209,1019,1767.6,17676,17633,6.8,10,10,12,186,18.6,2,1,1,0,0,189,18.9,0,7,9,9,6.8,16614,16467,1646.7,-1019,-1209,1
9630,-1462,-1833,1580.9,15809,17675,6.8,3,3,3,214,21.4,1,1,0,1,0,232,23.2,1,8,5,5,7.4,19508,17271,1727.1,1833,1462,0
9631,-60,10,1696.0,16960,17503,6.8,7,7,5,215,21.5,1,1,1,0,0,222,22.2,1,7,4,4,6.8,17493,17020,1702.0,-10,60,0
9632,-6,-1746,1537.2,15372,17983,6.8,3,3,4,234,23.4,0,0,1,0,1,236,23.6,1,0,4,4,7.2,19729,15378,1537.8,1746,6,0
9633,-233,-754,1652.7,16527,16884,6.6,8,8,7,194,19.4,1,1,1,0,0,197,19.7,1,12,9,9,6.8,17638,16760,1676.0,754,233,0
9634,4232,1501,1777.4,17774,18689,6.8,6,6,9,226,22.6,0,0,1,0,0,218,21.8,0,0,0,0,7.0,17188,13542,1354.2,-1501,-4232,1
9635,-283,-484,1607.4,16074,17776,7.0,3,3,3,237,23.7,1,0,0,1,0,220,22.0,0,6,7,7,7.2,18260,16357,1635.7,484,283,1
9636,1518,1208,1561.2,15612,17678,7.0,4,4,5,234,23.4,2,1,0,1,0,213,21.3,0,2,1,1,6.8,16470,14094,1409.4,-1208,-1518,0
9637,-4236,-4211,1675.9,16759,15499,6.4,10,10,7,163,16.3,0,0,1,0,1,187,18.7,1,15,16,16,7.4,19710,20995,2099.5,4211,4236,0
9638,-224,-1942,1491.1,14911,16715,6.8,3,3,5,228,22.8,1,1,1,0,0,248,24.8,0,2,2,2,7.2,18657,15135,1513.5,1942,224,0
9639,-53,559,1698.0,16980,18629,6.8,8,8,14,218,21.8,1,1,0,1,0,240,24.0,0,4,6,6,7.0,18070,17033,1703.3,-559,53,1
9640,969,1563,1577.6,15776,17726,7.0,3,3,5,261,26.1,0,0,1,0,1,207,20.7,1,5,4,4,6.8,16163,14807,1480.7,-1563,-969,0
9641,-2090,-916,1496.1,14961,17673,6.8,4,4,2,215,21.5,0,0,0,1,1,239,23.9,1,7,7,7,7.0,18589,17051,1705.1,916,2090,0
9642,687,510,1603.1,16031,18664,7.0,4,4,6,223,22.3,1,1,0,1,0,254,25.4,0,1,3,3,6.6,18154,15344,1534.4,-510,-687,1
9643,-152,-537,1631.3,16313,18652,7.0,5,5,4,242,24.2,1,1,0,1,0,213,21.3,0,5,5,5,7.2,19189,16465,1646.5,537,152,1
9644,-68,963,1596.4,15964,18133,6.8,6,6,7,217,21.7,1,0,1,0,1,198,19.8,1,9,5,5,6.8,17170,16032,1603.2,-963,68,0
9645,2368,1767,2054.1,20541,19687,7.4,13,13,12,260,26.0,1,1,0,1,0,169,16.9,0,16,9,9,6.8,17920,18173,1817.3,-1767,-2368,1
9646,2791,1911,1741.5,17415,16774,6.8,8,8,8,232,23.2,1,1,0,1,0,205,20.5,0,8,4,4,6.2,14863,14624,1462.4,-1911,-2791,0
9647,-2636,-1390,1687.8,16878,17994,7.0,6,6,5,185,18.5,1,1,0,1,0,227,22.7,1,9,10,10,7.4,19384,19514,1951.4,1390,2636,0
9648,324,-409,1590.1,15901,16965,6.8,5,5,5,213,21.3,1,1,1,0,0,207,20.7,0,6,6,6,6.6,17374,15577,1557.7,409,-324,1
9649,-572,35,1604.0,16040,17697,6.8,4,4,6,235,23.5,1,1,1,0,0,221,22.1,0,13,6,6,7.0,17662,16612,1661.2,-35,572,1
9650,2793,3324,1814.0,18140,20250,7.2,9,9,11,204,20.4,1,1,0,1,0,222,22.2,0,3,4,4,6.8,16926,15347,1534.7,-3324,-2793,1
9651,354,736,1722.9,17229,18401,7.0,11,11,9,191,19.1,1,1,1,0,0,202,20.2,0,6,6,6,6.8,17665,16875,1687.5,-736,-354,1
9652,73,-806,1591.6,15916,17531,6.8,5,5,5,237,23.7,1,0,1,0,1,238,23.8,1,4,4,4,7.0,18337,15843,1584.3,806,-73,1
9653,-1039,827,1545.2,15452,18378,7.0,6,6,8,191,19.1,1,1,1,0,0,215,21.5,1,4,4,4,6.8,17551,16491,1649.1,-827,1039,0
9654,-1189,-1741,1599.9,15999,17524,6.8,5,5,4,203,20.3,0,0,0,1,1,224,22.4,1,5,9,9,7.2,19265,17188,1718.8,1741,1189,1
9655,-3656,-2866,1439.9,14399,17167,6.6,3,3,3,221,22.1,0,0,0,1,0,232,23.2,0,4,6,6,7.4,20033,18055,1805.5,2866,3656,0
9656,-4357,-4959,1344.9,13449,16281,6.6,1,1,2,205,20.5,1,1,0,1,0,226,22.6,0,9,7,7,7.6,21240,17806,1780.6,4959,4357,0
9657,-3248,-1706,1387.6,13876,16521,6.6,3,3,2,175,17.5,1,1,0,1,0,194,19.4,0,8,9,9,7.0,18227,17124,1712.4,1706,3248,0
9658,-3587,-2861,1577.6,15776,16537,6.8,5,5,3,209,20.9,0,0,1,0,1,197,19.7,2,10,12,12,7.2,19398,19363,1936.3,2861,3587,0
9659,-35,317,1528.2,15282,17671,7.0,4,4,2,232,23.2,1,1,1,0,0,206,20.6,0,4,3,3,6.8,17354,15317,1531.7,-317,35,0
9660,-3903,-2516,1425.8,14258,16594,6.6,2,2,3,198,19.8,1,1,0,1,0,261,26.1,0,8,7,7,7.2,19110,18161,1816.1,2516,3903,0
9661,-4885,-2721,1431.6,14316,16505,6.6,2,2,1,214,21.4,0,0,0,1,1,249,24.9,2,12,11,11,7.4,19226,19201,1920.1,2721,4885,0
9662,36,-928,1548.2,15482,17584,6.8,3,3,3,243,24.3,0,0,1,0,1,226,22.6,2,1,4,4,7.2,18512,15446,1544.6,928,-36,1
9663,1678,1857,1640.2,16402,18713,7.0,5,5,6,250,25.0,0,0,1,0,1,173,17.3,1,3,4,4,6.6,16856,14724,1472.4,-1857,-1678,0
9664,2830,1605,1882.2,18822,18319,7.0,10,10,8,224,22.4,1,1,1,0,0,195,19.5,1,5,7,7,6.6,16714,15992,1599.2,-1605,-2830,0
9665,1741,675,1770.2,17702,18597,7.2,11,11,6,216,21.6,0,0,1,0,0,211,21.1,0,2,4,4,6.8,17922,15961,1596.1,-675,-1741,1
9666,-183,257,1617.8,16178,19240,7.0,3,3,2,258,25.8,0,0,0,1,1,226,22.6,1,5,6,6,7.2,18983,16361,1636.1,-257,183,0
9667,485,858,1589.7,15897,18190,7.0,5,5,5,226,22.6,0,0,0,1,0,238,23.8,0,3,3,3,6.8,17332,15412,1541.2,-858,-485,0
9668,131,1207,1624.8,16248,19928,7.4,6,6,5,204,20.4,0,0,0,1,0,211,21.1,0,4,6,6,7.0,18721,16117,1611.7,-1207,-131,1
9669,-1234,26,1579.7,15797,18289,6.8,3,3,4,226,22.6,1,0,0,1,1,222,22.2,1,8,7,7,7.0,18263,17031,1703.1,-26,1234,0
9670,-596,774,1567.8,15678,17696,6.8,5,5,3,211,21.1,0,0,0,1,0,223,22.3,0,9,6,6,6.8,16922,16274,1627.4,-774,596,1
9671,-1493,-1266,1600.6,16006,17612,6.8,6,6,7,233,23.3,1,1,1,0,0,247,24.7,0,11,8,8,7.0,18878,17499,1749.9,1266,1493,1
9672,-283,84,1659.0,16590,18656,7.0,5,5,3,251,25.1,1,1,0,1,0,208,20.8,0,8,7,7,7.2,18572,16873,1687.3,-84,283,1
9673,-798,-1418,1493.9,14939,15632,6.6,4,4,5,189,18.9,1,0,0,1,1,210,21.0,1,13,6,6,6.8,17050,15737,1573.7,1418,798,0
9674,-240,-694,1678.7,16787,18246,7.0,5,5,6,248,24.8,1,1,0,1,0,216,21.6,1,8,6,6,7.2,18940,17027,1702.7,694,240,0
9675,1994,230,1738.8,17388,19549,7.2,6,6,4,250,25.0,0,0,0,1,1,205,20.5,1,2,6,6,7.2,19319,15394,1539.4,-230,-1994,1
9676,-539,-852,1486.8,14868,17736,7.0,2,2,1,257,25.7,0,0,1,0,0,243,24.3,1,4,3,3,7.2,18588,15407,1540.7,852,539,0
9677,-703,-1216,1567.6,15676,17248,6.8,3,3,3,267,26.7,0,0,0,1,1,224,22.4,1,8,6,6,6.8,18464,16379,1637.9,1216,703,0
9678,-2647,-1872,1423.0,14230,17035,6.6,2,2,1,232,23.2,0,0,0,1,1,254,25.4,2,6,6,6,7.0,18907,16877,1687.7,1872,2647,0
9679,384,-465,1698.1,16981,17309,6.8,5,5,10,214,21.4,0,0,0,1,1,224,22.4,2,2,3,3,7.0,17774,16597,1659.7,465,-384,1
9680,1057,-143,1637.4,16374,15811,6.6,9,9,13,152,15.2,0,0,1,0,1,196,19.6,1,6,7,7,6.6,15954,15317,1531.7,143,-1057,0
9681,1687,2040,1722.7,17227,18842,7.0,7,7,6,218,21.8,0,0,1,0,1,205,20.5,1,7,6,6,6.8,16802,15540,1554.0,-2040,-1687,0
9682,2088,1774,1663.1,16631,19270,7.2,7,7,4,234,23.4,0,0,1,0,1,209,20.9,1,3,2,2,6.8,17496,14543,1454.3,-1774,-2088,1
9683,-149,645,1588.8,15888,18144,6.8,5,5,4,218,21.8,0,0,0,1,1,204,20.4,1,4,5,5,6.6,17499,16037,1603.7,-645,149,0
9684,-1434,-1422,1568.8,15688,17439,6.8,3,3,4,239,23.9,0,0,0,1,0,237,23.7,1,5,6,6,7.0,18861,17122,1712.2,1422,1434,0
9685,-922,-1305,1646.2,16462,17215,7.0,5,5,6,223,22.3,0,0,1,0,1,227,22.7,2,11,9,9,7.2,18520,17384,1738.4,1305,922,0
9686,-2408,-2325,1454.8,14548,17158,6.6,3,3,3,204,20.4,2,1,0,1,0,253,25.3,0,5,7,7,7.2,19483,16956,1695.6,2325,2408,0
9687,1851,2008,1812.8,18128,18825,7.2,11,11,8,205,20.5,1,1,0,1,0,211,21.1,0,9,5,5,6.8,16817,16277,1627.7,-2008,-1851,1
9688,-3051,-2198,1516.2,15162,17438,6.8,4,4,3,220,22.0,0,0,0,1,1,250,25.0,2,8,9,9,7.4,19636,18213,1821.3,2198,3051,1
9689,-1233,-1450,1476.7,14767,16585,6.6,2,2,2,230,23.0,0,0,1,0,1,193,19.3,1,7,6,6,6.8,18035,16000,1600.0,1450,1233,1
9690,3390,2090,1738.4,17384,18198,7.0,11,11,11,202,20.2,1,1,1,0,0,201,20.1,0,4,2,2,6.6,16108,13994,1399.4,-2090,-3390,0
9691,1656,1298,1615.9,16159,16943,6.6,6,6,7,208,20.8,1,0,0,1,0,200,20.0,0,4,4,4,6.4,15645,14503,1450.3,-1298,-1656,0
9692,-2264,-964,1304.6,13046,15452,6.2,1,1,0,197,19.7,0,0,0,1,0,222,22.2,0,2,4,4,6.6,16416,15310,1531.0,964,2264,0
9693,-2483,-1894,1545.9,15459,18187,7.0,1,1,1,243,24.3,0,0,0,1,1,254,25.4,2,7,6,6,7.4,20081,17942,1794.2,1894,2483,0
9694,-4582,-3594,1388.6,13886,14445,6.0,4,4,3,178,17.8,0,0,0,1,1,210,21.0,2,6,7,7,6.8,18039,18468,1846.8,3594,4582,0
9695,-1938,-1993,1592.8,15928,17865,6.8,6,6,4,206,20.6,1,0,0,1,1,244,24.4,1,8,9,9,7.2,19858,17866,1786.6,1993,1938,0
9696,-668,-300,1468.7,14687,17701,6.8,2,2,1,234,23.4,1,0,1,0,0,255,25.5,0,2,2,2,6.8,18001,15355,1535.5,300,668,0
9697,954,1154,1714.6,17146,19051,7.0,5,5,4,240,24.0,1,0,1,0,1,212,21.2,1,8,6,6,7.0,17897,16192,1619.2,-1154,-954,1
9698,5468,5522,1981.4,19814,20713,7.6,13,13,15,224,22.4,1,1,1,0,0,197,19.7,0,3,3,3,6.2,15191,14346,1434.6,-5522,-5468,1
9699,209,1647,1794.5,17945,19818,7.4,10,10,8,206,20.6,0,0,0,1,1,196,19.6,1,3,8,8,6.8,18171,17736,1773.6,-1647,-209,0
9700,2352,1002,1664.6,16646,18530,7.2,6,6,7,226,22.6,1,0,0,1,1,210,21.0,1,2,2,2,6.8,17528,14294,1429.4,-1002,-2352,0
9701,1538,1118,1760.4,17604,17925,6.8,9,9,12,194,19.4,0,0,1,0,1,168,16.8,1,7,7,7,6.8,16807,16066,1606.6,-1118,-1538,0
9702,-490,-217,1608.9,16089,17265,6.8,7,7,5,198,19.8,0,0,0,1,1,229,22.9,1,4,5,5,6.8,17482,16579,1657.9,217,490,0
9703,-4625,-3447,1554.4,15544,15313,6.2,6,6,9,176,17.6,1,1,0,1,0,239,23.9,1,17,14,14,7.2,18760,20169,2016.9,3447,4625,0
9704,-3478,-2027,1743.4,17434,17974,7.0,9,9,11,188,18.8,0,0,0,1,1,196,19.6,1,21,16,16,7.4,20001,20912,2091.2,2027,3478,0
9705,405,487,1594.5,15945,18619,7.2,4,4,5,204,20.4,0,0,1,0,0,236,23.6,0,2,3,3,7.0,18132,15540,1554.0,-487,-405,0
9706,-560,476,1569.2,15692,17807,7.0,3,3,2,234,23.4,0,0,0,1,1,199,19.9,1,4,7,7,6.8,17331,16252,1625.2,-476,560,0
9707,2278,2188,1746.9,17469,18286,7.2,9,9,8,206,20.6,1,1,1,0,0,174,17.4,0,11,6,6,6.4,16098,15191,1519.1,-2188,-2278,1
9708,-2665,-900,1631.4,16314,16894,6.8,4,4,4,250,25.0,0,0,1,0,1,200,20.0,2,14,11,11,7.0,17794,18979,1897.9,900,2665,0
9709,1049,-291,1629.9,16299,17994,7.0,6,6,10,234,23.4,0,0,1,0,0,240,24.0,0,1,3,3,7.0,18285,15250,1525.0,291,-1049,1
9710,-2270,-2033,1584.4,15844,16971,6.6,5,5,10,209,20.9,1,1,0,1,0,243,24.3,0,9,7,7,7.2,19004,18114,1811.4,2033,2270,0
9711,295,630,1585.6,15856,18029,7.0,5,5,5,224,22.4,0,0,0,1,0,173,17.3,0,6,7,7,6.8,17399,15561,1556.1,-630,-295,0
9712,-2162,-2253,1596.7,15967,17065,6.6,6,6,5,217,21.7,0,0,1,0,0,224,22.4,0,9,9,9,7.2,19318,18129,1812.9,2253,2162,0
9713,194,143,1523.6,15236,17761,6.8,4,4,6,196,19.6,0,0,1,0,1,254,25.4,1,3,2,2,6.8,17618,15042,1504.2,-143,-194,0
9714,-5519,-5521,1294.1,12941,15085,6.4,1,1,2,178,17.8,0,0,0,1,1,253,25.3,2,10,9,9,7.6,20606,18460,1846.0,5521,5519,0
9715,332,-200,1751.3,17513,16367,6.6,10,10,17,174,17.4,1,1,0,1,0,209,20.9,0,13,8,8,6.4,16567,17181,1718.1,200,-332,1
9716,1039,1629,1670.0,16700,19019,7.0,7,7,3,218,21.8,2,1,0,1,0,248,24.8,0,3,4,4,7.0,17390,15661,1566.1,-1629,-1039,1
9717,3107,2223,1803.8,18038,17959,7.0,7,7,15,241,24.1,0,0,1,0,1,154,15.4,1,6,5,5,6.4,15736,14931,1493.1,-2223,-3107,0
9718,-2183,-2010,1549.1,15491,15893,6.4,5,5,5,194,19.4,0,0,0,1,0,224,22.4,0,6,10,10,6.8,17903,17674,1767.4,2010,2183,1
9719,-4191,-2861,1609.0,16090,16407,6.6,7,7,9,182,18.2,0,0,0,1,1,219,21.9,1,26,13,13,7.4,19268,20281,2028.1,2861,4191,0
9720,1072,1587,1720.4,17204,18534,7.0,8,8,6,236,23.6,1,1,0,1,0,222,22.2,0,7,7,7,6.6,16947,16132,1613.2,-1587,-1072,1
9721,-1920,-363,1503.2,15032,18187,6.8,3,3,2,207,20.7,2,1,1,0,0,246,24.6,0,8,6,6,7.0,18550,16952,1695.2,363,1920,1
9722,377,-597,1773.9,17739,16482,6.6,8,8,8,215,21.5,0,0,1,0,1,197,19.7,2,12,11,11,6.8,17079,17362,1736.2,597,-377,0
9723,-1529,82,1689.4,16894,17233,6.6,8,8,11,203,20.3,1,1,1,0,0,232,23.2,1,11,9,9,6.8,17151,18423,1842.3,-82,1529,0
9724,-2150,-1318,1494.4,14944,17906,6.8,2,2,2,237,23.7,0,0,0,1,1,241,24.1,1,11,6,6,7.2,19224,17094,1709.4,1318,2150,0
9725,-1585,-2306,1462.3,14623,16060,6.4,3,3,3,200,20.0,0,0,1,0,1,253,25.3,1,6,4,4,6.8,18366,16208,1620.8,2306,1585,0
9726,-3315,-1641,1527.8,15278,17274,6.8,5,5,2,219,21.9,0,0,0,1,0,227,22.7,1,7,9,9,7.2,18915,18593,1859.3,1641,3315,0
9727,2361,1802,1712.6,17126,19205,7.0,5,5,6,249,24.9,0,0,1,0,1,230,23.0,2,2,2,2,6.8,17403,14765,1476.5,-1802,-2361,0
9728,-2846,-2039,1549.4,15494,17574,6.8,4,4,4,211,21.1,1,1,0,1,0,213,21.3,0,12,10,10,7.4,19613,18340,1834.0,2039,2846,0
9729,406,782,1690.4,16904,18744,7.2,6,6,3,245,24.5,1,0,1,0,1,210,21.0,1,9,6,6,6.8,17962,16498,1649.8,-782,-406,1
9730,2045,1938,1721.4,17214,18948,7.2,6,6,8,244,24.4,0,0,0,1,1,220,22.0,1,5,4,4,6.8,17010,15169,1516.9,-1938,-2045,1
9731,209,-6,1635.2,16352,18600,7.0,6,6,8,230,23.0,0,0,1,0,0,243,24.3,1,6,4,4,7.0,18606,16143,1614.3,6,-209,1
9732,-2688,-1172,1469.6,14696,16517,6.6,4,4,4,202,20.2,0,0,0,1,1,212,21.2,1,5,7,7,7.0,17689,17384,1738.4,1172,2688,0
9733,-982,-1613,1539.2,15392,17929,7.0,4,4,3,222,22.2,0,0,1,0,1,234,23.4,1,3,5,5,7.4,19542,16374,1637.4,1613,982,1
9734,1468,1205,1592.8,15928,19109,7.4,3,3,3,266,26.6,1,1,1,0,0,228,22.8,0,2,1,1,6.8,17904,14460,1446.0,-1205,-1468,1
9735,3910,3400,1841.7,18417,19926,7.2,9,9,6,231,23.1,0,0,1,0,1,206,20.6,2,3,4,4,6.6,16526,14507,1450.7,-3400,-3910,1
9736,-1607,-48,1498.1,14981,18767,7.0,2,2,1,222,22.2,0,0,0,1,1,259,25.9,1,6,5,5,7.2,18815,16588,1658.8,48,1607,1
9737,-144,1497,1599.4,15994,17724,6.8,5,5,4,225,22.5,1,0,0,1,0,183,18.3,0,12,7,7,6.4,16227,16138,1613.8,-1497,144,1
9738,1472,1838,1842.0,18420,19041,7.0,11,11,13,218,21.8,0,0,0,1,0,209,20.9,0,9,8,8,6.8,17203,16948,1694.8,-1838,-1472,1
9739,1053,1304,1742.1,17421,19606,7.2,7,7,6,241,24.1,0,0,0,1,1,223,22.3,2,4,6,6,7.2,18302,16368,1636.8,-1304,-1053,0
9740,-5751,-4242,1367.1,13671,16878,6.8,2,2,2,202,20.2,0,0,0,1,1,259,25.9,1,12,11,11,7.6,21120,19422,1942.2,4242,5751,0
9741,1092,1401,1754.4,17544,18604,7.0,6,6,9,230,23.0,1,0,0,1,0,258,25.8,0,9,5,5,6.8,17203,16452,1645.2,-1401,-1092,1
9742,-2268,-1810,1558.9,15589,18306,7.0,4,4,6,219,21.9,1,1,0,1,0,261,26.1,0,8,8,8,7.4,20116,17857,1785.7,1810,2268,0
9743,1868,1041,1670.2,16702,18943,7.2,6,6,10,234,23.4,0,0,0,1,1,230,23.0,1,1,1,1,7.0,17902,14834,1483.4,-1041,-1868,1
9744,3608,3085,1821.1,18211,20198,7.4,10,10,12,209,20.9,2,1,0,1,0,183,18.3,0,3,3,3,6.8,17113,14603,1460.3,-3085,-3608,1
9745,-3116,-1994,1464.0,14640,17333,6.6,4,4,3,224,22.4,0,0,0,1,1,215,21.5,1,14,9,9,7.2,19327,17756,1775.6,1994,3116,0
9746,-706,-306,1621.1,16211,18576,7.2,6,6,4,207,20.7,1,1,1,0,0,239,23.9,0,5,7,7,7.0,18882,16917,1691.7,306,706,1
9747,1402,-566,1651.7,16517,17161,6.4,6,6,7,219,21.9,0,0,1,0,1,206,20.6,1,3,5,5,7.0,17727,15115,1511.5,566,-1402,0
9748,139,260,1572.3,15723,19631,7.2,2,2,2,246,24.6,2,1,1,0,0,253,25.3,0,2,3,3,7.4,19371,15584,1558.4,-260,-139,1
9749,-1481,-1877,1499.3,14993,17018,6.6,2,2,3,241,24.1,0,0,0,1,1,226,22.6,1,5,5,5,7.2,18895,16474,1647.4,1877,1481,0
9750,4417,2933,1957.6,19576,18210,7.2,12,12,12,236,23.6,1,1,0,1,0,198,19.8,0,9,5,5,6.2,15277,15159,1515.9,-2933,-4417,1
9751,-784,754,1521.7,15217,18056,7.0,5,5,6,195,19.5,0,0,0,1,1,238,23.8,1,5,4,4,6.6,17302,16001,1600.1,-754,784,1
9752,243,-31,1550.2,15502,17716,7.0,4,4,5,223,22.3,0,0,0,1,1,214,21.4,1,5,3,3,6.8,17747,15259,1525.9,31,-243,1
9753,-2302,-702,1512.5,15125,17495,6.8,4,4,2,200,20.0,1,1,0,1,0,207,20.7,0,9,7,7,6.8,18197,17427,1742.7,702,2302,0
9754,-1018,-981,1584.5,15845,16561,6.6,6,6,3,195,19.5,0,0,0,1,0,213,21.3,0,7,9,9,7.2,17542,16863,1686.3,981,1018,1
9755,-350,49,1643.3,16433,18215,7.0,6,6,8,229,22.9,0,0,0,1,0,224,22.4,0,4,6,6,7.0,18166,16783,1678.3,-49,350,1
9756,5240,2335,1882.4,18824,19996,7.2,9,9,11,237,23.7,1,1,1,0,0,217,21.7,0,0,1,1,7.0,17661,13584,1358.4,-2335,-5240,1
9757,1447,-149,1636.0,16360,17624,6.8,6,6,4,234,23.4,1,1,1,0,0,214,21.4,0,2,4,4,7.0,17773,14913,1491.3,149,-1447,1
9758,-1187,-1137,1512.8,15128,15881,6.2,6,6,8,172,17.2,1,1,0,1,0,179,17.9,0,9,8,8,6.8,17018,16315,1631.5,1137,1187,0
9759,2214,1305,1831.7,18317,19636,7.2,11,11,6,229,22.9,1,0,1,0,0,204,20.4,0,8,7,7,7.0,18331,16103,1610.3,-1305,-2214,1
9760,174,1511,1624.8,16248,18567,7.0,6,6,4,220,22.0,1,1,0,1,0,211,21.1,0,7,6,6,6.6,17056,16074,1607.4,-1511,-174,0
9761,-967,-1216,1587.1,15871,17457,6.8,4,4,3,234,23.4,0,0,1,0,1,214,21.4,1,8,7,7,7.2,18673,16838,1683.8,1216,967,0
9762,2178,1829,1777.9,17779,19282,7.2,9,9,10,220,22.0,1,1,1,0,0,244,24.4,0,2,4,4,6.8,17453,15601,1560.1,-1829,-2178,1
9763,-860,214,1678.5,16785,17837,6.8,8,8,9,186,18.6,0,0,0,1,1,236,23.6,1,7,5,5,6.6,17623,17645,1764.5,-214,860,0
9764,-700,83,1552.4,15524,17366,6.8,5,5,3,182,18.2,2,1,1,0,0,194,19.4,0,7,6,6,6.8,17283,16224,1622.4,-83,700,1
9765,813,1232,1659.2,16592,18393,7.0,6,6,7,221,22.1,0,0,1,0,0,195,19.5,0,8,7,7,7.0,17161,15779,1577.9,-1232,-813,1
9766,7791,6458,1914.8,19148,18457,7.0,7,7,9,232,23.2,2,1,1,0,0,137,13.7,0,0,0,0,5.6,11999,11357,1135.7,-6458,-7791,1
9767,2429,2405,1733.7,17337,18952,7.0,8,8,7,228,22.8,0,0,0,1,1,198,19.8,1,5,5,5,6.6,16547,14908,1490.8,-2405,-2429,0
9768,-954,-1007,1600.3,16003,17152,6.6,5,5,7,213,21.3,0,0,0,1,1,261,26.1,1,14,6,6,7.0,18159,16957,1695.7,1007,954,1
9769,2279,2409,1737.0,17370,19627,7.4,8,8,9,249,24.9,1,0,1,0,1,229,22.9,1,7,3,3,7.0,17218,15091,1509.1,-2409,-2279,1
9770,2203,1534,1803.6,18036,19849,7.4,10,10,5,243,24.3,0,0,1,0,1,193,19.3,1,5,5,5,7.0,18315,15833,1583.3,-1534,-2203,1
9771,-1244,-548,1471.1,14711,18380,7.0,3,3,2,209,20.9,1,1,1,0,0,234,23.4,1,6,5,5,7.2,18928,15955,1595.5,548,1244,1
9772,142,-58,1646.8,16468,17897,6.8,7,7,5,224,22.4,2,1,0,1,0,209,20.9,0,6,4,4,7.0,17955,16326,1632.6,58,-142,0
9773,-974,-815,1528.5,15285,16734,6.8,4,4,2,194,19.4,0,0,1,0,1,184,18.4,1,12,9,9,6.6,17549,16259,1625.9,815,974,0
9774,267,553,1715.1,17151,18598,7.0,10,10,5,195,19.5,1,1,0,1,0,234,23.4,0,5,6,6,6.8,18045,16884,1688.4,-553,-267,0
9775,2095,628,1795.1,17951,17346,6.6,10,10,12,211,21.1,0,0,1,0,0,171,17.1,0,4,7,7,6.8,16718,15856,1585.6,-628,-2095,1
9776,-3142,-2289,1591.7,15917,17466,6.8,6,6,4,200,20.0,0,0,0,1,0,243,24.3,0,8,9,9,7.4,19755,19059,1905.9,2289,3142,0
9777,381,865,1739.9,17399,17937,7.0,8,8,11,245,24.5,1,1,1,0,0,237,23.7,0,9,8,8,6.4,17072,17018,1701.8,-865,-381,0
9778,2392,1200,1763.9,17639,18319,7.2,7,7,7,247,24.7,1,1,1,0,0,214,21.4,0,3,3,3,6.8,17119,15247,1524.7,-1200,-2392,1
9779,157,1673,1718.3,17183,18197,7.0,11,11,6,208,20.8,0,0,1,0,1,188,18.8,1,14,10,10,6.8,16524,17026,1702.6,-1673,-157,0
9780,690,664,1713.0,17130,17703,6.8,8,8,7,221,22.1,0,0,1,0,0,208,20.8,0,14,8,8,6.8,17039,16440,1644.0,-664,-690,0
9781,-905,-2229,1592.0,15920,17106,6.6,4,4,6,229,22.9,0,0,0,1,1,224,22.4,2,12,6,6,7.0,19335,16825,1682.5,2229,905,0
9782,-1272,-1634,1781.8,17818,17651,6.8,10,10,10,204,20.4,0,0,1,0,0,258,25.8,0,9,9,9,7.2,19285,19090,1909.0,1634,1272,0
9783,656,526,1595.6,15956,18145,6.8,3,3,3,215,21.5,2,1,0,1,0,212,21.2,0,5,3,3,6.8,17619,15300,1530.0,-526,-656,0
9784,977,134,1558.2,15582,15958,6.4,4,4,7,238,23.8,0,0,1,0,1,204,20.4,1,7,4,4,6.4,15824,14605,1460.5,-134,-977,1
9785,-2249,-1547,1648.6,16486,18609,7.0,5,5,5,244,24.4,2,1,1,0,0,214,21.4,0,12,10,10,7.4,20156,18735,1873.5,1547,2249,0
9786,189,-99,1569.2,15692,17598,6.8,6,6,9,217,21.7,1,1,0,1,0,244,24.4,0,2,3,3,6.6,17697,15503,1550.3,99,-189,1
9787,-3089,-3265,1423.2,14232,15999,6.6,4,4,5,197,19.7,0,0,1,0,1,251,25.1,1,7,8,8,7.2,19264,17321,1732.1,3265,3089,0
9788,1025,-1153,1813.3,18133,17764,7.0,7,7,10,215,21.5,1,0,1,0,1,218,21.8,1,5,8,8,6.8,18917,17108,1710.8,1153,-1025,1
9789,7600,1865,2320.5,23205,17846,7.0,22,22,29,208,20.8,1,0,0,1,0,171,17.1,0,9,6,6,6.4,15981,15605,1560.5,-1865,-7600,1
9790,-1075,378,1556.4,15564,18158,7.0,4,4,6,214,21.4,2,1,0,1,0,240,24.0,0,11,6,6,7.0,17780,16639,1663.9,-378,1075,1
9791,98,161,1497.7,14977,17698,7.0,3,3,3,223,22.3,1,1,1,0,0,224,22.4,0,4,3,3,6.8,17537,14879,1487.9,-161,-98,1
9792,-1911,-2325,1626.3,16263,16732,6.8,5,5,7,198,19.8,0,0,0,1,1,220,22.0,1,7,10,10,7.2,19057,18174,1817.4,2325,1911,0
9793,4458,3839,1847.7,18477,19323,7.2,7,7,7,275,27.5,1,1,0,1,0,188,18.8,0,4,2,2,6.2,15484,14019,1401.9,-3839,-4458,1
9794,-375,-752,1648.4,16484,17470,7.0,7,7,11,202,20.2,2,1,1,0,0,219,21.9,0,5,7,7,7.2,18222,16859,1685.9,752,375,0
9795,7,-659,1516.7,15167,18214,6.8,2,2,2,244,24.4,1,0,1,0,0,242,24.2,0,3,2,2,7.2,18873,15160,1516.0,659,-7,0
9796,-1534,-167,1600.7,16007,18083,7.2,5,5,5,207,20.7,0,0,0,1,1,196,19.6,2,9,8,8,6.8,18250,17541,1754.1,167,1534,0
9797,1882,1490,1809.3,18093,18394,7.0,8,8,8,231,23.1,0,0,0,1,0,203,20.3,0,8,6,6,6.8,16904,16211,1621.1,-1490,-1882,1
9798,2382,2614,1858.8,18588,19735,7.2,10,10,10,225,22.5,0,0,0,1,0,192,19.2,0,7,8,8,6.8,17121,16206,1620.6,-2614,-2382,1
9799,2751,1464,1685.3,16853,18255,7.0,8,8,8,226,22.6,1,1,1,0,0,199,19.9,0,0,1,1,6.8,16791,14102,1410.2,-1464,-2751,1
9800,-451,336,1632.3,16323,18362,7.2,7,7,9,213,21.3,0,0,0,1,1,219,21.9,1,10,7,7,6.8,18026,16774,1677.4,-336,451,1
9801,-1213,-1013,1506.3,15063,17979,6.8,4,4,2,206,20.6,0,0,0,1,1,253,25.3,1,2,6,6,7.0,18992,16276,1627.6,1013,1213,1
9802,-3291,-2502,1492.9,14929,15842,6.2,4,4,10,223,22.3,0,0,1,0,1,248,24.8,2,8,7,7,7.2,18344,18220,1822.0,2502,3291,0
9803,2031,1967,1711.9,17119,18962,7.2,6,6,5,233,23.3,2,1,1,0,0,209,20.9,0,3,3,3,6.8,16995,15088,1508.8,-1967,-2031,1
9804,1618,-74,1904.9,19049,17924,7.0,9,9,10,202,20.2,2,1,0,1,0,209,20.9,0,8,7,7,6.8,17998,17431,1743.1,74,-1618,0
9805,3682,1284,1945.2,19452,18579,7.0,14,14,26,209,20.9,1,1,1,0,0,207,20.7,0,6,5,5,6.6,17295,15770,1577.0,-1284,-3682,0
9806,-5870,-3642,1398.1,13981,16277,6.6,1,1,0,220,22.0,1,0,0,1,0,234,23.4,0,18,12,12,7.4,19919,19851,1985.1,3642,5870,0
9807,-3531,-3889,1541.8,15418,15315,6.4,7,7,7,203,20.3,0,0,1,0,1,215,21.5,2,15,11,11,7.4,19204,18949,1894.9,3889,3531,0
9808,2360,2396,1763.6,17636,19458,7.2,8,8,9,218,21.8,1,1,0,1,0,188,18.8,0,4,5,5,6.6,17062,15276,1527.6,-2396,-2360,1
9809,326,85,1702.6,17026,18215,7.2,6,6,8,229,22.9,1,1,0,1,0,217,21.7,0,6,7,7,6.8,18130,16700,1670.0,-85,-326,1
9810,2148,1700,1708.4,17084,18781,7.2,8,8,10,219,21.9,1,1,0,1,0,217,21.7,0,2,3,3,6.4,17081,14936,1493.6,-1700,-2148,0
9811,-2930,-2779,1450.1,14501,16545,6.6,3,3,3,195,19.5,0,0,0,1,1,239,23.9,1,5,7,7,7.2,19324,17431,1743.1,2779,2930,0
9812,-1300,-652,1574.5,15745,17654,6.8,4,4,7,236,23.6,0,0,0,1,1,252,25.2,1,10,5,5,7.2,18306,17045,1704.5,652,1300,1
9813,88,413,1657.1,16571,18777,7.0,5,5,6,220,22.0,1,1,1,0,0,202,20.2,0,7,7,7,7.0,18364,16483,1648.3,-413,-88,1
9814,631,-265,1722.4,17224,18105,6.8,5,5,7,229,22.9,0,0,1,0,1,218,21.8,1,6,7,7,7.2,18370,16593,1659.3,265,-631,0
9815,4619,2904,1851.8,18518,19380,7.4,9,9,14,224,22.4,0,0,1,0,1,205,20.5,1,2,1,1,6.6,16476,13899,1389.9,-2904,-4619,1
9816,-1516,391,1715.5,17155,18632,7.2,5,5,5,224,22.4,0,0,0,1,1,228,22.8,1,12,11,11,7.0,18241,18671,1867.1,-391,1516,0
9817,699,18,1604.6,16046,17207,6.8,5,5,6,234,23.4,1,1,0,1,0,199,19.9,0,6,5,5,6.6,17189,15347,1534.7,-18,-699,1
9818,2587,1971,1698.6,16986,18376,7.0,6,6,6,226,22.6,0,0,1,0,1,208,20.8,1,4,3,3,6.6,16405,14399,1439.9,-1971,-2587,0
9819,-180,-890,1636.8,16368,18857,7.0,4,4,5,216,21.6,1,0,1,0,1,224,22.4,1,5,6,6,7.4,19747,16548,1654.8,890,180,1
9820,-3051,-2123,1530.2,15302,16647,6.8,4,4,4,210,21.0,0,0,1,0,1,215,21.5,1,12,10,10,7.0,18770,18353,1835.3,2123,3051,0
9821,-2021,-768,1536.7,15367,18799,7.2,5,5,3,217,21.7,1,1,0,1,0,238,23.8,0,7,6,6,7.4,19567,17388,1738.8,768,2021,0
9822,-673,-1332,1517.8,15178,17707,6.8,2,2,4,236,23.6,1,1,0,1,0,252,25.2,1,5,3,3,7.2,19039,15851,1585.1,1332,673,0
9823,-5059,-5247,1382.4,13824,14814,6.2,4,4,3,167,16.7,0,0,0,1,1,235,23.5,2,9,7,7,7.6,20061,18883,1888.3,5247,5059,0
9824,-2604,-1096,1591.9,15919,16956,6.8,7,7,8,200,20.0,0,0,0,1,0,183,18.3,0,10,11,11,7.0,18052,18523,1852.3,1096,2604,0
9825,-844,737,1662.7,16627,18559,7.0,5,5,2,229,22.9,1,0,0,1,0,206,20.6,0,14,11,11,7.0,17822,17471,1747.1,-737,844,0
9826,-1935,-1534,1403.2,14032,16940,6.4,1,1,2,220,22.0,1,1,0,1,0,231,23.1,0,5,5,5,7.2,18474,15967,1596.7,1534,1935,0
9827,3886,1777,1878.7,18787,17878,7.0,13,13,17,193,19.3,1,1,1,0,0,175,17.5,0,5,5,5,6.6,16101,14901,1490.1,-1777,-3886,1
9828,-977,-1320,1520.5,15205,16968,6.6,2,2,3,248,24.8,0,0,1,0,0,186,18.6,0,8,5,5,7.0,18288,16182,1618.2,1320,977,0
9829,-1990,-3002,1565.1,15651,16945,6.8,4,4,4,201,20.1,1,1,1,0,0,226,22.6,0,6,8,8,7.4,19947,17641,1764.1,3002,1990,0
9830,2809,1740,1737.6,17376,18907,7.0,7,7,6,238,23.8,0,0,1,0,0,234,23.4,1,3,2,2,6.6,17167,14567,1456.7,-1740,-2809,0
9831,-3084,-3141,1578.8,15788,17331,6.6,4,4,5,223,22.3,1,1,0,1,0,230,23.0,0,9,11,11,7.6,20472,18872,1887.2,3141,3084,0
9832,-162,-553,1568.8,15688,16920,6.6,4,4,4,226,22.6,0,0,1,0,0,233,23.3,0,10,6,6,7.0,17473,15850,1585.0,553,162,0
9833,-780,107,1537.4,15374,17943,6.8,4,4,2,223,22.3,1,0,0,1,1,231,23.1,1,6,6,6,7.2,17836,16154,1615.4,-107,780,1
9834,-2958,-1733,1341.8,13418,16047,6.4,2,2,0,189,18.9,1,0,0,1,1,220,22.0,1,5,5,5,7.0,17780,16376,1637.6,1733,2958,0
9835,-6754,-5726,1217.8,12178,10098,4.6,4,4,4,120,12.0,0,0,0,1,0,203,20.3,0,14,11,11,6.4,15824,18932,1893.2,5726,6754,0
9836,-2111,-1573,1598.4,15984,16282,6.6,8,8,8,206,20.6,0,0,1,0,0,208,20.8,1,14,10,10,6.8,17855,18095,1809.5,1573,2111,1
9837,-1194,-1133,1590.8,15908,18487,7.4,3,3,3,220,22.0,0,0,0,1,1,255,25.5,1,4,5,5,7.2,19620,17102,1710.2,1133,1194,1
9838,-3562,-2590,1524.0,15240,17500,7.0,6,6,6,162,16.2,0,0,1,0,1,221,22.1,1,8,11,11,7.4,20090,18802,1880.2,2590,3562,0
9839,-626,61,1494.3,14943,17710,6.8,3,3,3,223,22.3,1,1,0,1,0,233,23.3,0,8,4,4,6.8,17649,15569,1556.9,-61,626,1
9840,-1848,-617,1563.4,15634,18046,7.2,4,4,7,235,23.5,0,0,0,1,1,256,25.6,1,9,6,6,7.2,18663,17482,1748.2,617,1848,1
9841,374,1465,1707.1,17071,19207,7.2,6,6,10,245,24.5,1,1,0,1,0,209,20.9,0,10,7,7,6.8,17742,16697,1669.7,-1465,-374,1
9842,-1614,-418,1572.6,15726,17885,7.2,4,4,7,222,22.2,1,0,0,1,1,239,23.9,1,9,7,7,7.0,18303,17340,1734.0,418,1614,1
9843,-162,1520,1524.9,15249,19121,7.2,3,3,4,240,24.0,0,0,0,1,1,248,24.8,2,3,2,2,6.8,17601,15411,1541.1,-1520,162,0
9844,583,439,1605.5,16055,18838,7.0,6,6,8,208,20.8,1,1,0,1,0,259,25.9,0,1,2,2,7.2,18399,15472,1547.2,-439,-583,1
9845,-4676,-3551,1344.6,13446,15500,6.4,2,2,1,190,19.0,0,0,0,1,1,243,24.3,2,9,8,8,7.2,19051,18122,1812.2,3551,4676,0
9846,428,400,1590.3,15903,17640,7.0,4,4,5,239,23.9,1,1,1,0,0,217,21.7,0,6,4,4,6.8,17240,15475,1547.5,-400,-428,0
9847,893,256,1694.0,16940,18098,7.2,9,9,7,203,20.3,0,0,1,0,1,228,22.8,1,5,5,5,7.0,17842,16047,1604.7,-256,-893,0
9848,1632,1767,1688.2,16882,18657,7.2,8,8,7,221,22.1,1,0,0,1,0,179,17.9,0,4,4,4,6.6,16890,15250,1525.0,-1767,-1632,1
9849,-1019,-1564,1589.4,15894,17808,7.0,6,6,3,212,21.2,0,0,0,1,1,229,22.9,1,4,7,7,7.2,19372,16913,1691.3,1564,1019,0
9850,1976,1778,1604.7,16047,18644,7.0,4,4,13,244,24.4,2,1,0,1,0,222,22.2,0,1,1,1,6.8,16866,14071,1407.1,-1778,-1976,1
9851,-2591,-1250,1470.9,14709,17092,6.6,4,4,2,217,21.7,0,0,0,1,1,236,23.6,1,10,8,8,7.2,18342,17300,1730.0,1250,2591,0
9852,-1314,-1708,1636.8,16368,17821,7.0,6,6,9,234,23.4,1,0,0,1,1,230,23.0,1,4,6,6,7.2,19529,17682,1768.2,1708,1314,1
9853,188,-676,1739.4,17394,17904,6.8,7,7,9,261,26.1,1,0,0,1,0,212,21.2,0,7,8,8,7.0,18580,17206,1720.6,676,-188,0
9854,175,-234,1595.0,15950,17303,6.8,6,6,7,196,19.6,1,1,0,1,0,221,22.1,0,4,6,6,6.8,17537,15775,1577.5,234,-175,1
9855,-880,179,1526.8,15268,17717,6.8,2,2,3,214,21.4,0,0,0,1,0,198,19.8,0,8,7,7,6.6,17538,16148,1614.8,-179,880,0
9856,4693,2968,1827.4,18274,19011,6.8,10,10,12,232,23.2,0,0,1,0,0,179,17.9,0,1,2,2,6.4,16043,13581,1358.1,-2968,-4693,1
9857,-645,-448,1599.3,15993,17528,6.8,5,5,6,206,20.6,0,0,1,0,1,197,19.7,1,9,7,7,6.8,17976,16638,1663.8,448,645,0
9858,-959,-1248,1485.7,14857,16510,6.8,3,3,7,226,22.6,1,1,1,0,0,195,19.5,1,3,6,6,6.8,17758,15816,1581.6,1248,959,0
9859,2527,1695,1850.3,18503,19717,7.4,9,9,11,250,25.0,1,1,1,0,0,210,21.0,0,9,4,4,7.0,18022,15976,1597.6,-1695,-2527,1
9860,-347,966,1744.2,17442,20005,7.2,8,8,11,210,21.0,1,0,0,1,0,218,21.8,0,10,7,7,7.2,19039,17789,1778.9,-966,347,1
9861,-5087,-4618,1447.8,14478,14665,6.2,4,4,5,171,17.1,0,0,0,1,0,199,19.9,0,12,13,13,7.2,19283,19565,1956.5,4618,5087,0
9862,1838,-689,1708.6,17086,17746,7.0,6,6,10,229,22.9,2,1,1,0,0,231,23.1,0,7,4,4,7.2,18435,15248,1524.8,689,-1838,1
9863,600,289,1807.5,18075,19324,7.2,5,5,6,233,23.3,1,0,0,1,1,224,22.4,1,6,7,7,7.0,19035,17475,1747.5,-289,-600,1
9864,725,1773,1596.5,15965,18534,7.0,5,5,5,208,20.8,1,1,1,0,0,202,20.2,1,5,4,4,6.8,16761,15240,1524.0,-1773,-725,1
9865,-1461,-69,1526.1,15261,18671,7.0,4,4,1,223,22.3,0,0,0,1,1,215,21.5,1,8,7,7,7.0,18740,16722,1672.2,69,1461,1
9866,670,1446,1460.3,14603,18478,7.0,1,1,0,232,23.2,1,1,0,1,0,197,19.7,0,5,2,2,6.8,17032,13933,1393.3,-1446,-670,1
9867,-1798,-674,1383.6,13836,17114,6.6,1,1,0,213,21.3,1,0,0,1,1,251,25.1,1,4,3,3,6.8,17788,15634,1563.4,674,1798,0
9868,3234,2427,1717.0,17170,19211,7.0,7,7,5,251,25.1,1,0,1,0,0,203,20.3,0,1,1,1,6.8,16784,13936,1393.6,-2427,-3234,1
9869,-2121,-1038,1619.8,16198,18249,7.0,9,9,12,165,16.5,1,1,0,1,0,187,18.7,1,7,12,12,7.4,19287,18319,1831.9,1038,2121,0
9870,1974,1712,1692.3,16923,19758,7.2,5,5,2,222,22.2,0,0,1,0,1,202,20.2,1,5,3,3,6.8,18046,14949,1494.9,-1712,-1974,1
9871,-727,343,1513.1,15131,18216,6.8,4,4,5,214,21.4,2,1,0,1,0,248,24.8,0,2,5,5,6.8,17873,15858,1585.8,-343,727,0
9872,756,1,1715.5,17155,18002,7.0,7,7,9,231,23.1,0,0,1,0,1,216,21.6,1,8,7,7,7.0,18001,16399,1639.9,-1,-756,1
9873,2639,2364,1857.3,18573,19391,7.2,12,12,13,207,20.7,0,0,1,0,0,197,19.7,0,6,6,6,6.6,17027,15934,1593.4,-2364,-2639,1
9874,2519,2469,1776.5,17765,18967,7.2,7,7,5,211,21.1,1,1,1,0,0,229,22.9,0,7,4,4,6.8,16498,15246,1524.6,-2469,-2519,1
9875,782,888,1623.8,16238,19255,7.2,6,6,8,233,23.3,1,1,0,1,0,206,20.6,0,3,4,4,7.0,18367,15456,1545.6,-888,-782,1
9876,-2416,-1877,1590.3,15903,18032,7.0,6,6,5,210,21.0,0,0,0,1,1,261,26.1,1,11,7,7,7.4,19909,18319,1831.9,1877,2416,0
9877,-839,-1085,1445.9,14459,17229,6.6,2,2,3,224,22.4,1,1,1,0,0,247,24.7,0,1,3,3,7.2,18314,15298,1529.8,1085,839,0
9878,927,-58,1626.6,16266,17321,7.0,6,6,5,207,20.7,0,0,1,0,1,201,20.1,1,4,6,6,6.8,17379,15339,1533.9,58,-927,1
